ABET	Imfundvo yalabadzala; I-ABET; 
ACH	i-ACH; 
AG	I-AG; 
ANC	i-ANC; 
APRIL	Mabasa; 
AU	i-AU; 
Africa	i-Afrika; 
Africa's	i-Afrika; 
African	um-Afrika; 
African-American	Um-Afrika longumMelika; 
Africans	ema-Afrika; 
Alexandra	Alxandra; 
America	iMelika; 
American	umMelika; 
Angola	i-Angola; 
Apr	Mab; 
April	Mabasa; 
Arab	Um-Arabhu; 
Arcadia	 i-Arcadia; 
Asian	Umuntfu wase-Eshiya; 
Audios	 lokulalelwako; tilalelwa; 
Auditor	Umhlolimabhuku; 
Auditor-General	Umhlolimabhuku Jikelele; 
Austria	i-Austria; 
Ave	 umgwaco; indlela; 
BBC	i-BBC; 
BRICS	i-BRICS; 
Baba	babe; 
Bantu	Bantfu; 
Bay	Lugu; 
Beginner's	Labacalako; 
Berlin	i-Berlin; 
Blatter	kuhamba budlabha; kushaya uphindzelela futsi ngalokunemsindvo; 
Bloemfontein	Bloemfotein; 
Boer	Libhunu; 
Brazil	i-Brazil; 
Britain	i-Britain; 
British	kwaseBritain; waseBritain; 
Burundi	i-Burundi; 
CEOs	bo-CEO; Tisebenti Letinkhulu; 
CNS	i-CNS; 
COP	i-COP; 
CPA	i-CPA; 
CPC	i-CPC; 
CPT	i-CPT; 
Canada	iCanada; 
Cannes	iCannes; 
Caribbean	iCaribbean; 
Castle	Incaba; 
Cedar	i-Cedar; 
Chairman	Umgcinisihlalo; Sihlalo; 
Chinese	Lishayina; 
Christmas	Khisimusi; 
Clerks	bomabhalane; 
Commissioner	nkomishana; 
Confederations	Imihlangano lemikhulu; 
Congo	iCongo; 
Cuba	iCuba; 
DBE	i-DBE; 
DECEMBER	INGONGONI; 
DG	i-DG; 
DRC	i-DRC; 
DSO	i-DSO; 
Dec	Ingo; 
December	 Ingongoni; Disemba; 
Deregister	kucisha kubhalisa; 
Dome	idomu; 
Dominican	Umfundisi weMkatolika; 
Dr	Dkt; 
Drakensberg	Lukhahlamba; iDrankensberg; 
Dutch	UmDashi; 
EFF	i-EFF; 
Emmanuel	Inkhosinatsi; 
England	iNgilandi; 
English	Singisi; 
Ethiopia	iTopiya ; 
Europe	iYurophu; 
European	umuntfu waseYurophu; 
Excellency	umhlonishwa; 
FEBRUARY	BHIMBIDVWANE; 
FRIDAY	LESIHLANU; 
Feb	Bhimb; 
February	Indlovana;  iNdlovana; 
Federal	inhlangane yemave; 
Filter	Sefa; 
Fort	Incaba; 
France	iFulansi; 
French	Sifulentji; 
Friday	lwesihlanu;  Lesihlanu; 
Fridays	boLesihlanu; 
GB	i-GB; 
GDP	iGDP; 
Gauteng	iGauteng; 
Gazette	Igazethi; 
German	iJalimane; 
Ghana	iGhana; 
Glossary	Iglosari; 
God	Nkulunkulu; 
Guardian	Umnakekeli; 
HIV-positive	kuba ne-HIV; 
Handbook	Incwajana; 
Harare	iHarare; 
Hawks	Bolohheya; 
Hon	Mhl; 
I'm	 ngi-; 
ICT	i-ICT; 
India	i-Indiya; 
Indian	Lindiya; kwaseNdiya; 
Infecting	 kutselela; kwendlulisela; 
Interjections	kuhlaba lulwimi; 
Islamic	Sisulumane; kwebuSulumane; 
JANUARY	BHIMBIDVWANE; 
JULY	KHOLWANE; 
JUNE	INHLABA; 
Jacob	Jakobhe; 
Jan	Bhimb; 
January	Bhimbidvwane; 
Japan	iJapane; 
Jewish	UmJuta;  kweSijuta; 
Johannesburg	eJozi; 
John	Jona; 
Joseph	Josefa; 
Jul	Kholwane; Khol; 
July	Kholwane; 
Jun	Inhlaba; 
Kenya	iKenya; 
Keyword	Ligama leliyinhloko; 
Kimberley	i-Kimberley; 
Korea	i-Korea; 
LinkedIn	Hlanganisiwe; 
London	iLandani; 
Lotteries	Emalothari; 
Lotto	Ilotho; 
MONDAY	UMSOMBULUKO; 
MP	Lilunga lasePhalamende; i-MP; 
MPs	Emalunga asePhalamende; ema-MP; 
MR	Mn; 
Madam	medemu; 
Mama	Make; 
Mandela's	kwaMandela; 
Manuel	Nkhosinatsi; 
Mayor	Umphatsidolobha; 
Meanwhile	 ngesikhatsi-; manje; 
Methodist	lokhona eWeseli; Iweseli; Umweseli; 
Mme	Make; 
Monday	uMsombuluko; 
Moscow	iMoscow; 
Moses	 Moses; Mozisi; 
Mpumalanga	iMpumalanga; 
Mr	Mn; 
Mrs	Nkt ; 
NCR	i-NCR; 
NOVEMBER	LWETI; 
Namibia	iNamibhiya; 
Natal	iNatal; 
Ndebele	UmNdebele; 
Nelspruit	INasipoti; 
Netherlands	iNethetlands; 
Newtown	iNewtown; 
Nigeria	iNigeria; 
Nigerian	Umuntfu waseNigeria; kwaseNigeria; 
Nkandla	iNkandla; 
Nov	Lw; 
November	Novemba;  Lweti; 
OCTOBER	IMPHALA; 
Oct	Imph; 
October	Okthoba; 
Offender's	 kwalowente licala; kwalowonile; 
Olympic	i-Olimpiki; 
Olympics	ema-Olimpiki; 
Oscar	Osacr; 
PACs	ema-PAC; 
PAP	i-PAP; 
PC	i-PC; 
Pan	i-Pan; 
Paris	iParis; 
Parliament's	Kwephalamende; 
Paul	Pawula; 
Pele	embili; 
Peter	Pita; 
Petersen	Peterson; 
Postpones	hlehlisa; 
Presidency	KwaMengameli; 
President's	KwameNgameli; 
Pretoria	i-Pretoria;  iPitoli; 
Prince	Inkhosana; 
Prof	Solwati; Phrof; 
Protector	Umvikeli; 
RSVP	phendvula; 
Registrar	Mabhalane; 
Rejoice	jabula; 
Riverside	iRiverside; 
Russia	iRashiya; 
Russian	umuntfu waseRashuya; 
Rustenburg	iRustenburg; 
SA	i-SA; 
SA-UK	i-SA-UK; 
SALSA	i-SALSA; 
SAPS	i-SAPS; 
SAX	i-SAX; 
SEPTEMBER	INYONI; 
SETA	i-SETA; 
Sasol	i-Sasol; 
Saturday	uMgcibelo;  Umgcibelo; 
Secretariat	Mabhalane; 
Secretaries	Bomabhalane; 
Secretaries-General	Mabhalane Jikelele; 
Self-Governance	Kutibusa; 
Senegal	iSenegal; 
Sep	Inyoni; 
Shanghai	iShanghai; 
Sharpeville	iSharpville; 
Skip	Yeca; 
Soweto	iSoweto; 
Sudan	iSudan; 
Sunday	Lisontfo; 
Surname	Sibongo; 
Swaziland	iSwaziland; 
Switchboard	Iswishibhodi; 
TUESDAY	LESIBILI; 
TV	i-TV; 
Temba	Themba; 
Thomas	Tomasi; 
Thursday	 Lesine; Lwesine; 
Transvaal	iNtalasifane; 
Tuesday	Lesibili;  Lwesibili; 
UCH	i-UCH; 
UK	i-UK; 
UN	i-UN; 
UNESCO	i-UNESCO; 
URL	i-URL; 
USA	iMelika; i-USA; 
Uganda	i-Uganda; 
Unsubscribe	Cisha kubhalisa; 
Venda	UmVenda; iVenda; 
Venice	i-Venice; 
WEDNESDAY	LESITSATFU; 
Wednesday	Lwesitsatfu;  Lesitsatfu; 
Wits	iWits; 
Witwatersrand	iWitwatersrand; 
Xhosa	Sichosa; UmChosa; 
York	iYork; 
Yvonne	Yuvonne; 
Zambia	iZambiya; 
Zimbabwe	iZimbabwe; 
Zimbabwean	umuntfu waseZimbabwe; kwaseZimbabwe; 
ability	likhono; 
able	khona; 
about	mayelana;  macondza;  -phatselene; 
above	etulu; 
above-mentioned	lokushiwo ngetulu; 
abroad	-ngesheya; 
absence	kungabikhona; 
absolute	mbamba; phelele;  lucobo; 
abuse	kuhlukumeta; 
abused	 hlukumetiwe; kuhlukumeta;  sebentiswe kabi ngalokungakafaneli; 
academia	temfundvo; 
academic	 -phatselene nemfundvo; kwemfundvo lephakeme; 
academics	 -phatselene nemfundvo; kwemfundvo lephakeme; 
academies	temfundvo; 
academy	sikhungo semfundvo lephakeme; 
accelerate	phangisa; 
accelerated	-phangisa; 
accelerating	phangisa; 
accept	emukela; 
acceptance	kwemukelwa;  kuvunywa; 
accepted	-mukelwe; 
accepting	-mukela; 
access	imvume; 
accessed	finyelelwa; 
accessibility	 kutfolakala; kufinyelela; 
accession	kutfola; 
accident	ingoti; 
accidents	tingoti; 
acclaim	kuncoma;  kudvumisa; 
acclaimed	kuncoma;  kudvumisa; 
accommodate	kwemukela;  kunika indzawo;  kuhlalisa; 
accommodated	kwemukela;  kunika indzawo;  kuhlalisa; 
accommodation	 indzawo yekuhlala; kubona; 
accompanied	kubakhona;  -lekelela;  -pheleketela; kuphekeleta; 
accompany	pheleketela;  yelekelela; 
accomplish	feza sifiso; 
accomplished	feza tifiso; 
accord	nika;  vumelana; 
accordance	kuvumelana; 
accorded	nika;  vumelana; 
according	mayelana; 
accordingly	ngalokunjalo; 
account	 incwadzi yesikweleti;  kulandzisa;  sikweleti; i-akhawunti; 
accountability	kutiphendvulela; 
accountants	bagcinimabhuku; 
accounted	kulandzisa;  landzisa; 
accounting	 kugcina emabhuku; kubalisisa; 
accounts	 landzisa;  ema-akhawunti;  incwadzi yetikweleti; tikweleti; 
accreditation	kufaneleka;  kuba neligunya; 
accredited	kufaneleka; kuba neligunya; 
accruals	kugcwalelana ndzawonye; 
accrued	ngeteka; 
accumulated	congelelekile; 
accuracy	 kunemba;  kushaya emhlolweni; kunakekela; 
accurate	-entiwe ngekunakekela; 
accused	ummangalelwa; 
achieved	phumelela; 
achievement	imphumelelo; 
achievements	timphumelelo; 
achieving	kuphumelela; 
acknowledge	vuma; 
acknowledged	vuma; 
acknowledges	kubonga; 
acquire	tfola; 
acquired	-tfola; 
acquisition	kutfola; 
act	umtsetfo;  sento;  dlala;  inkhundla yemdlalo; 
acted	sento;  -tsatsa sinyatselo;  dlalile;  tigaba temidlalo; 
acting	 libamba; kudlala; 
action	sento; 
actions	tenteko; 
active	khutsele; 
actively	ngemdlandla; 
activism	bushoshovu; 
activists	bashikashiki; 
activities	 lokwentiwako; imisebenti; 
activity	umsebenti;  lokwentiwako; 
actor	umdlali; 
actors	 badlali; balingisi; 
actress	umdlali lomsikati; 
acts	 tinkhundla temidlalo;  -dlalile; imitsetfo;  tento; 
actual	mbamba; -lucobo;  kona kona; 
actually	ecinisweni; mbambambamba; 
ad-hoc	kwesikhashana; 
adaptation	kwetayeta; 
add	 ngeta; hlanganisa; 
added	 -ngetile; -hlanganisile; 
adding	 -ngeta; hlanganisa; 
addition	kuhlanganisa; 
address	likheli; 
addressed	kwetfula inkhulumo; 
addresses	emakheli; 
addressing	kulungisa; 
adds	 ngeta; hlanganisa; 
adequate	kwenele; 
adequately	ngalokwenele; 
adhere	landzela; 
adherence	kulandzela; 
adjourn	misa; 
adjourned	kugcile;  kuphuma kwemhlangano; phumile; 
adjudication	sincumo;  sehlulelo; 
adjust	lungisa; 
adjusted	lungisa;  lungisiwe; 
adjustment	 kutilungiselela simo; kulungisa; 
adjustments	kulungisa; 
administer	phatsa;  lawula; 
administered	phatsa;  lawula; 
administering	 kulawula; kuphatsa; 
administration	 imphatfo; kuphatsa; 
administrations	 imphatfo; kuphatsa; 
administrative	kulawula;  kubaphatsa; 
administrator	umphatsi; 
administrators	baphatsi; baphatsihhovisi betikhungo; 
admissible	vumelekile; 
admission	kwemukela;  kwamukela;  kuvuma licala; 
admit	yemukela; 
admitted	emukela; 
adoption	kwemukela;  kufaka eswini; 
adoptive	kuyemukeleka; kufakeka eswini; 
adult	umuntfu lomdzala; 
adults	bantfu labadzala; 
advance	intfutfuko;  tfutfuka;  ngembili;  imali leniketwa ngembi kwesikhatsi; 
advanced	ezingeni lelisetulu;  ngembi kwesikhatsi; -sembili; 
advancement	 kuba sezingeni lelisetulu; lokuniketwa ngembi kwesikhatsi; 
advances	 tfutfuka;  timali letiniketwa ngembi kwesikhatsi; ngembili;  tintfutfuko; 
advancing	intfutfuko;  tfutfuka;  ngembili;  imali leniketwa ngembi kwesikhatsi; 
advantage	 kuba setfubeni; lusito; 
advantages	tinsitakalo;  buhle; kuba sematfubeni; 
advent	 kufika; kusungulwa;  kuvela; 
adverse	 sihibe; lokuyingoti; 
adversely	 kabuhlungu; kabi; 
adversity	bubi; bungoti; 
advertise	khangisa; 
advertised	khangiswe; 
advertisement	sikhangiso; 
advertising	kukhangisa; 
advice	seluleko; 
advise	 luleka; seluleko; 
advised	lulekiwe; 
adviser	umeluleki; 
advisers	beluleki; 
advisories	simemetelo;  sicapheliso;  beluleki; 
advisors	beluleki; 
advisory	simemetelo;  sicapheliso; 
advocacy	bumeli, kukhulumela; 
advocate	ummeli wasemajajini; 
advocates	bammeli basemajajini; mela; 
affairs	tindzaba; 
affect	tsintsa; 
affecting	tsintsa; 
affects	tsintsa; 
affidavit	sitatimende lesifungelwe; 
affirm	vuma; 
affirmation	sicinisekiso; 
affirming	vuma; 
afford	khona; 
afforded	khona; 
aforementioned	 cedza kushiwo; lokushiwo phambilini; 
aforesaid	 lokushiwo phambilini; locedza kushiwo; 
after	emuva; 
afternoon	 emva kwemadina; imphekabafati; 
again	futsi; 
against	 phambene; phambene; Melene; 
age	 iminyaka; sikhatsi;  umnyaka;  guga; 
aged	Loneminyaka yebudzala; gugile;  budzala; 
agencies	ema-ejensi; 
agency	i-ejensi; 
agenda	luhlu lwetinkhulumo temhlangano; 
agent	umenti;  sihhudlo;  sitfunywa sebhizinisi; 
agents	 titfunywa temabhizinisi; siguculi;  ema-ejenti;  tihhudlo; benti; 
ages	 tiguga;  iminyaka yebudzala; tikhatsi; 
aggregate	samba; 
ago	kadzeni;  sikhatsi lesendlulile; 
agree	vuma; 
agreed	 vumilene; -vumile; 
agreement	 kuvumelana; sivumelwano; 
agreements	 kuvumelana; tivumelwano; 
agrees	vumile; vuma; 
agriculture	tekulima; 
ahead	 ngembili; embili; 
aid	lusito; 
aids	tinsito;  ingculazi; sita; 
aim	inhloso;  cipha; 
aimed	tinhloso;  -hlose; -ciphile; 
aims	tinhloso;  cipha; 
air	umoya;  shayisa umoya; 
aircraft	imfulayimashini; 
airport	 inkhundla yetindizamshini; inkhundla yetindiza;  sikhumulo setindiza; 
airports	tikhumulo tetindizamshini;  tinkhundla tetindizamshini; 
albeit	nanoma; 
alcohol	tjwala; 
alert	caphela; 
align	condzanisa; 
aligned	-condzaniswe; 
alignment	kulinganisa; 
alike	fanana; 
alive	-nemlilo; phila; 
all	konkhe; 
allegation	tinsolo;  kusola; 
allegations	tinsolo; 
alleged	kuyasolwa; 
allegedly	kusoleka; 
alleviate	cedza; hhamula; 
alleviation	kucedza; 
alliance	imvumelwano;  lidlelandzawonye; 
allocate	nika; 
allocated	nikwe; 
allocation	kunikwa; 
allocations	kunikwa; 
allow	vumela; 
allowance	imali lencunyiwe; 
allowances	timali letincunyiwe tekwenta lokutsandzako; 
allowed	vumelekile;  vunyelwe; 
allowing	kuvumela;  vumela; 
allows	vumela; 
almost	cishe; 
alone	yedvwana; ngedvwava;  bodvwana; 
along	hambisana;  hamba nako;  hamba naye; 
alongside	eceleni; 
already	sekuvele kwentekile; sekunjalo; 
also	kanye; na; 
alter	ingucuko; kucula;  luntjintjo; 
alternate	ntjintjanisa; 
alternative	lenye indlela; 
although	nanoma kunjalo; 
always	ngaso sonkhe sikhatsi; 
am	ekuseni; 
ambassador	lincusa; 
ambassadors	emancusa; 
ambient	tungelete macala onkhe; 
ambit	umtungeletelo; umnyele; 
amended	-chibele; 
amending	-chibela; 
amendment	sichibelo; 
amendments	 tichibelo; tingucuko; 
amends	chibela; 
ammunition	tinhlavu;  tikhali; 
amnesty	 intsetselelo; shwele; 
among	emkhatsini; 
amongst	emkhatsini; 
amount	linani;  fikela; 
amounted	fikela; 
amounting	lingana;  fikela; 
amounts	emanani; 
an	i; 
analogue	lokufana nalokunye; 
analyse	 hlatiya; hlahlela; 
analysed	 hlatiya; hlahlela; 
analyses	 kucubungula; tinhlatiyo; luhlatiyo; 
analysing	 hlatiya; hlahlela; 
analysis	 kucubungula; kuhlahlela; luhlatiyo; 
ancestor	lidloti; 
ancestors	emadloti; 
ancient	 -kwasendvulo; endvulo;  -ndvulo; 
and	kanye; na; 
animal	silwane; 
animals	tilwane; 
animation	bopopayi; luchungechunge lwemibhalotitfombe;  indlela yekwenta bopopayi; 
annex	dla live; 
annexure	Seleko; 
anniversary	sikhatsi semnyaka sekukhumbula lokutsite; 
announce	memetela; 
announced	memetela; 
announcement	simemetelo; 
announcements	timemetelo; 
announces	memetela; 
annual	ngemnyaka;  kanye ngemnyaka;  nyakanye; 
annually	ngemnyaka; 
annum	ngenyanga; 
another	lokunye; 
answer	 umphumela; imphendvulo; 
answers	timphendvulo; 
antenatal	ekukhulelweni;  ngaphambi kwekubeleka; 
anthem	lihubo; 
anti-corruption	kungahambisani nenkhohlakalo;  kungevani nenkhohlakalo; 
anti-pass	kungatsandzi emapasi; kungahambisani nemapasi; 
anticipated	kuzindla/lindzelwe;  lindzelekile; 
any	lokunye;  noma ngabe yini;  noma ngabe ngubani; 
anyone	nanoma ngubani; 
anything	nanoma yini; 
apart	ngaphandle; 
apartheid	lubandlululo; 
apparent	kubonakala; -sobala; 
appeal	 khala;  cela;  kuphikisa sincumo; sikhalo; 
appealed	 khala; cela;  kuphikisa sincumo; 
appeals	tikhalo;  cela;  kuphikisa tincumo; ticelotikhalo; 
appear	vela;  chamuka;  bonakala; 
appearance	kubukeka;  kuchamuka; 
appeared	 velile; chamukile; bonakele; 
appearing	kubonakala;  kuvela;  kuchamuka; 
appears	vela;  chamuka;  bonakala; 
appendix	litfunjana;  sengetelo; 
applaud	kushaya tadla; 
applause	lihlombe; 
applicant	lofake sicelo; umfakisicelo; 
applicants	bafakisicelo; 
application	sicelo;  kusetjentiswa;  kusebentisa; 
applications	 ticelo;  kusetjentiswa; kusebentisa; tinhlelokwenta; 
applied	imphambosi yekwentela; fake sicelo;  -setjentisiwe; 
applies	faka sicelo; 
apply	faka sicelo; 
applying	kufaka sicelo; 
appoint	casha; 
appointed	-cashiwe; 
appointing	casha; 
appointment	 kucashwa;  kubekwa esikhundleni; simiso; kukhetfwa; 
appointments	 kubekwa esikhundleni; kukhetfwa; 
appoints	casha; 
appreciate	bonga;  dvumisa; 
appreciated	bonga;  dvumisa; 
appreciates	bonga;  dvumisa; 
appreciation	indvumiso; 
approach	 bona, sondzela; indlela; 
approached	 bona, sondzela; indlela; 
approaches	tindlela;  bona, sondzela; 
appropriate	 lekufanele;  -emukeleka; lokufanele; 
appropriated	fanela;  -emukeleka; fanele; 
appropriately	ngalokufanele; 
appropriation	 sabelo; kwaba; 
appropriations	 tabelo; kwaba; 
approval	imvumo; 
approve	vumela; 
approved	vumela; 
approximately	phose;  ngekusondzela; 
arbitration	sehlulelo; 
arbitrator	umehluleli; 
architects	tati tekwakhiwa kwetindlu; badvwebitakhiwo; 
architectural	kuba nelwati lwetebuciko; 
architecture	kumiswa kwetakhiwo tetindlu; 
archival	kulondvolota; 
archive	silondvolotimlandvo;  kulondvolota; silulu; 
archives	tilondvolotamlandvo; 
are	ba;  ti; 
area	 sifundzave; indzawo;  sifundza;  incenye; 
areas	 tifundza;  tindzawo;  tincenye; tindzawo; 
arena	inkhundla; 
argue	 phikisana; sekela; 
argued	 –phikisana;  phikisana; sekela;  phikisa; 
argument	bufakazi;  imphikiswano; 
arguments	bufakazi;  timphikiswano; 
arise	 vela; sukuma;  phakama; 
arises	vela;  sukuma;  phakama; 
arising	 kusukuma;  kuphamaka; kuvela; 
arm	umkhono; 
armed	hlome ngetikhali; 
arms	tikhali; 
arose	 -vuka; -sukuma;  -phakama; 
arrange	lungisa;  hlelembisa; 
arranged	-lungisiwe; -hlelembisiwe;  -hlelembisa; 
arrangement	 kuhlelwa; luhlelo; 
arrangements	 emalungiselo; kuhlelwa; 
arrest	bopha; 
arrested	-boshiwe; 
arrival	kufika; 
arrive	fika; 
arrived	fikile; 
art	buciko; 
artefacts	imihlobiso yetemlandvo; 
article	 indzaba ephephandzabeni;  imphahla; indzaba;  lucetu; 
articles	tindzaba;  timphahla;  tincetu; ema-athikili; 
articulate	phimisa; 
articulated	phimisile; 
artist	liciko; 
artistic	-ngebuciko;  -kwebuciko; 
artists	bosobuciko; 
arts	buciko; 
artwork	umdvwebo webuciko;  sitfombe sebuciko; 
artworks	titfombe tebuciko;  imidvwebo webuciko; 
as	njenga; 
ascertain	tfola; 
aside	eceleni; 
ask	buta; 
asked	buta; 
asking	kubuta; 
asks	buta; 
aspect	luhlangotsi; 
aspects	tinhlangotsi; 
aspiration	 kufutsa; sifiso; 
aspirations	tifiso;  kufutsa;  tintfo lofisa kuba nato; 
assault	 hlasela; kulimata; 
assembly	inhlangano;  libandla lesishayamtsetfo; 
assented	vumile;  kuvuma; 
assert	vuma; 
assess	 linganisa; hlola; 
assessed	 linganisa; hlola; 
assesses	 linganisa; hlola; 
assessing	 linganisa; hlola; 
assessment	luhlolo; 
assessments	tinhlolo; 
assessors	bahloli; 
asset	imphahla; 
assets	imphahla; 
assign	khetsa;  kunikwa umsebenti;  kunika umsebenti; 
assigned	khetfwa;  khetsiwe;  nikwe umsebenti; 
assignment	umsebenti; 
assistance	lusito; 
assistant	umsiti;  umelekeleli; 
assisted	 lekelela; Sita; 
assisting	 lekelela; Sita; 
assists	 lekelela; Sita; 
associate	 hambisana; lilunga; 
associated	 hambisana; emalunga; 
association	libandla; 
associations	tinhlangano; 
assume	cabanga;  tsatsa sengatsi; 
assumed	cabangile;  tsetse sengatsi; 
assumptions	imicabango; 
assurance	 sicinisekiso; siciniseko; 
assure	cinisekisa; 
assured	cinisekisiwe; 
astronomy	sifundvo setinkhanyeti; 
at	e; 
atmosphere	umkhatsi; 
atmospheric	simo; 
attach	dlani; 
attached	Tsekeletela; dlani;  fakiwe; 
attachment	lokufakiwe/lokuhambisana nako; 
attack	 -hlasela;  hlasela; dvumela;  kudvumela; 
attacks	 -hlasela;  hlasela; dvumela;  kudvumela; 
attained	tfola; 
attainment	 kugcina; kutfola; 
attempt	kulinga;  linga; 
attempted	kulinga;  linga; 
attempts	kulinga;  linga; 
attendance	kuba khona; 
attended	hlanganyela; 
attending	kubakhona; 
attention	kunakekela; 
attitude	simo;  simo sengcondvo; 
attitudes	simo;  timongcondvo; 
attorney	ummeli; 
attorneys	bameli; 
attract	dvonsa; 
attracted	heheka; 
attribute	luphawu;  lokuphawulako; 
attributed	kufaka ligalelo; 
audience	tibukeli;  tetsameli; 
audiences	tibukeli;  tetsameli; 
audio	silalelwa/lokulalelwako; 
audiovisual	silalelwabukelwa; 
audit	 hlola emabhuku; luhlolo;  hlola; 
audited	 hlola emabhuku; luhlolo;  hlola; 
auditing	 hlola emabhuku; luhlolo;  hlola; 
auditor	umhlolimabhuku; 
auditor-general	umhlolimabhuku jikelele; 
auditors	bahlolimabhuku; 
audits	 tinhlolo;  kuhlola emabhuku; tinhlola; 
august	Ingci; 
auspices	tinsito;  tilokotfo;  tigameko; 
authentic	konakona; 
author	umbhali; 
authorisation	 imvume; ligunya; 
authorise	nika imvume;  nika ligunya; 
authorities	 tiphatsimandla;  tati; emandla;  imibuso;  emagunya; 
authority	emandla;  ligunya;  umbuso;  Siphatsimandla; 
authorization	 imvume; ligunya; 
authorize	gunyata; nika imvume; 
authorized	nikwe imvume; gunyatiwe; 
authors	babhali; 
automated	kwentiwa ngemshini; 
automatically	ngekutentekela; kuvele nje kwenteke; 
availability	kuba khona; 
avenue	 umgwaco; indlela; 
avenues	tindlela;  imigwaco; 
aviation	luhambo emoyeni; 
avoid	balekela;  gwema; 
avoidance	kugwema; 
awaiting	kuma;  kulindza; 
award	umklomelo; 
awarded	klomelisa; imiklomelo; 
awarding	klomelisa; kuklomelisa; 
awards	imiklomelo; 
aware	-ati;  -caphele; 
awareness	kucaphela;  kucaphelisa; 
away	 kungabikhona; khashane; 
babies	tinswane; 
baby	luswane; 
back	 umhlane; ngemuva;  siphanga;  inhlanekela; 
backdrop	indvwangu yasesiteji; 
background	sisekelo;  sendlalelo; 
backgrounds	 tendlalelo; tendlalelo; tisekelo; 
backlog	lokusilele; 
backlogs	lokusilele; 
bad	kubi; 
bag	lisaka; 
bail	ibheyili; 
bake	bhaka; 
baking	bhaka; 
balance	 kulinganisa;  tinta;  imali lesele; kusimama; 
balanced	simeme; 
balances	 kulinganisa;  kusimama;  kulingana ;  tilinganisi;  tinta;  timali letisele; kusimama; embhalansi; 
ball	 libhola; ibhola;  sidzindzi selunyawo; 
band	 ibhendi; libhande; 
bank	libhange;  lusentse; 
banking	 kubasa ngemalahle; kubhanga; 
banks	tinsentse tetindlela; emabhange; 
baobab	umkhomo; umnkhomo; 
bargaining	kutsinga ngalokulula; 
barrier	sivimbelo; 
barriers	tivimbelo; 
base	sisekelo;  sitinto; 
based	sisekelo;  ticalo;  iminyombo;  tisekelo;  sitinto; 
baseline	sisekelo;  sicalo; 
basic	-lokusisekelo; 
basics	lokusisekelo; 
basis	sisekelo; 
basket	imantji; 
battle	imphi; 
bay	litheku; 
beach	lugu; 
beaches	lugu; 
bear	libhele; 
bearers	umphatsincwadzi; 
bears	emabhele; 
beautiful	 muhle; kuhle; 
beauty	buhle; 
became	kuba-; 
because	ngoba; 
becomes	kuba-; 
becoming	kuba-; 
bed	 sicu semfula; umbhedze; 
beds	 imibhedze; imifula; 
bee	inyosi; 
beer	bhiya; tjwala; 
before	embikwa-; 
began	calile; 
begin	cala; 
beginning	sicalo; 
begins	cala; 
begun	calile; 
behalf	egameni la; 
behaviour	kutiphatsa; 
behind	ngemuva; 
being	umuntfu;  kuba; 
beings	bantfu; 
belief	inkholo;  inkholelo; 
beliefs	 tinkholelo; tinkholo; 
believe	kholwa; 
believed	 kholwa; kholiwe; 
believes	tinkholelo; 
believing	kukholwa; 
belong	kuba-; 
belonging	kuba-; 
belongs	wase-; 
beloved	lotsandzekako;  labatsandzekako; 
below	ngaphasi; 
benchmark	lizinga lelibekiwe; 
beneficial	 sitako; nekusita; 
beneficiaries	bazuzi; 
beneficiary	umzuzi; 
benefited	 zuza; sitakele; 
benefits	tinzuzo; 
best	-kahle kakhulu; 
better	ncono; 
between	emkhatsini; 
beyond	ngetulu;  kwendlula; 
bidders	babhidi; 
bids	kubhida; bhida; 
biennale	minyakamibili; njalo ngeminyaka lemibili; 
big	-khulu; 
bigger	-khudlwana; 
biggest	-khulu kakhulu; 
bilateral	mikhakhamibili; 
bill	 i-akhawunti;  umlomo wenyoni;  umtsetfosivivinyo; tfumela; 
bills	 ema-akhawunti;  emabhili;  umtsetfosivivinyo; tincwadzisikweleti; tfumela;  imitsetfosivivinyo; 
bind	hlanganisa; 
binding	umphetfo; 
bingo	i-bingo; 
biodiversity	budlelwane betilwane netitjalo; tinhlobo tetitjalo netilwane; 
biological	ngekwemvelo; 
biome	titjalo netilwane letisendzaweni lengasahlali bantfu; 
birds	tinyoni; 
birth	kutalwa;  kubeleka; 
birthday	lusuku lwekutalwa; 
black	-mnyama; 
blacks	-mnyama; 
blind	 kutsikameteka kwekubona;  -ngaboni; phandla; 
block	siphakamisi;  litje lelichwa; 
blood	ingati; 
blue	 umbala loluhlata; sibhakabhaka;  yenta mhlophe; 
board	ibhodi;  libandla lekuphenya; 
boards	emabhodi; 
boasts	kutikhukhumeta; 
bodies	 imikhandlu; imitimba; 
bodily	ngekwemtimba; 
body	umtimba; 
bold	kuba nesibindzi;  kungesabi; 
bona	imphahla; 
bond	 sihlanganisi; inhlanganisela; ibhondi;  sikweleti sendlu; 
bonds	 tinhlanganisela; tikweleti tendlu;  tihlanganisi;  emabhondi; 
book	libhuku; 
books	tincwadzi; 
boost	faka emandla; 
border	 umgobo; umncele;  umkhawulo; 
borders	 imiphetfo; imigobo; imikhawulo;  uminyele; 
born	talwa; 
borne	kumelana; 
borrow	boleka; 
borrowing	kuboleka; 
boss	umphatsi; ibhosi; 
botanical	lwati ngetitjalo; 
both	kokubili; 
bottom	 lingaphansi; liphasi;  lingephasi; 
bought	tsenga; 
bound	phetsa; hlanganisa; 
boundaries	iminyele; 
boundary	umncele; 
box	libhokisi; 
boy	umfana; 
boys	bafana; 
brackets	bakaki; 
branch	 ligala; ligatja;  phambuka; 
branches	emagala;  phambuka;  emagatja; 
brand	luphawu;  umkhicito; 
brave	nesibindzi; 
bravery	buchawe; 
breach	 lufa; lisango;  kwephula umtsetfo noma sivumelane;  ingcamu; 
breadth	bubanti; 
break	ephula;  kuphula umtsetfo;  kubhodlabhodla; 
breakdown	 kwephuka; kuhlatiya; 
breakfast	 kudla kwasekuseni; kusukusula; 
breaking	kuhlephula sinkhwa; 
breakthrough	imphumelelo; 
bridge	libhuloho; 
bridging	 hlanganisa; kuhlanganisa; 
brief	 imininingwano leniketwa ummeli wasemajajini; niketa ummeli wasemajajini imininingwano; 
briefed	 kuniketa ummeli wasemajajini imininingwane; tifinyeto;  imininingwane leniketwa ummeli wasemajajini; -finyetiwe;  tjeliwe; 
briefly	kafishane; 
briefs	 ticondziso;  imiyalelo; chatsatela; imininingwane; 
bring	 letsa; kuletsa; 
bringing	 letsa; kuletsa; 
brings	letsa; 
broad	-banti; 
broad-based	sisekelo lesibanti;  umkhakha lobanti; 
broadband	 sheshisako; kusebenta ngekushesha; Umkhakhubanti; 
broadcast	kusakatwa; 
broadcaster	umsakati; 
broadcasters	basakati; 
broadcasting	kusakata; 
broaden	nweba; khulisa;  yenta kube banti; 
broadening	kukhulisa;  kwenta kube banti; kunwena; 
broader	-banti; 
broadly	ngalokubanti; 
brochure	incwajana lechazako; 
brochures	 incwajana lechazako; emabhrosha; 
brother	umnaka;  umnaketfu; 
brothers	banaka;  bobhuti; 
brought	letsile; 
brutal	 -ngesihluku; -nesihluku; 
brutality	 lunya;  sihluku; budlova; 
budget	ibhajethi;  liphakelo;  bhajetha; 
budgetary	 mayelana nemcombelelotimali; mayelana nelwabiwomali; 
budgeted	kwenta liphakelomali;  kwenta ibhajethi; kubhajetha; 
budgeting	kubhajetha; 
budgets	 liphakelo; emabhajethi; imicombelelomali; 
buffalo	inyatsi; 
build	 akha; yakha; 
build-up	kugcwalelana ndzawonye; 
buildings	takhiwo; 
built	 -akhiwe; yakha; 
bulk	ngebunyenti;  -ngebukhulu; bunyenti; 
burden	inkinga;  niketa inkinga; umtfwalo; 
buried	-ngcwatjwe; 
burning	kusha; 
bursaries	imifundzate; 
bursary	umfundzate; 
bury	ngcwaba; 
bus	ibhasi; 
business	ibhizinisi; 
businesses	emabhizimisi; emabhizinisi; 
busy	matasatasa; 
but	kodvwa;  kepha; 
buy	tsenga; 
by	nge-; 
cabinet	libandla letindvuna tembuso;  ikhabhinethi; 
calculate	bala; 
calculated	bala; 
calculating	bala; 
calculation	kubala; 
calendar	ikhalenda; 
call	lucingo;  bita; 
called	 shayelwe lucingo; shayele lucingo; bitiwe; 
calling	lubito; 
calls	tincingo; 
came	fikile; 
camp	ngenisa;  inkambu;  kamba; 
campaign	umkhankhaso; 
campaigns	imikhankhaso; 
camps	 tinkambu; kukhempa; ngenisa; 
campus	ikhempasi; indzawo yekuhlala esikolweni; 
campuses	tindzawo tekuhlala esikolweni; emakhempasi; 
can	likani; 
can't	angeke; -ngakhoni; 
cancel	 cisha; misa; khansela; cima;  bulala;  sula; 
cancellation	 kucisha;  kucima;  kwesula; kumisa; 
cancelled	 cimisiwe; khansela; -cishiwe;  misiwe;  suliwe;  cishiwe; 
cancer	 umdlopha;  ikhensa; umhlata; 
candidate	lohlolwako; 
candidates	 bamelilukhetfo;  emakhandidethi; bamelikukhetfwa; 
cannot	angeke; -ngakhoni; 
cant	angeke; 
can’t	-ngakhoni; 
cap	nikwa litfuba lekudlala;  emahlandla ekudlalela sive; 
capabilities	kukhona;  emakhono; 
capability	kukhona; 
capable	-nemandla; 
capacities	imitsamo; 
capacity	umtsamo; 
capacity-building	kutfutfukisa emakhono; 
cape	ingoni;  siphika; 
capita	ngekulingana; 
capital	 imali yekucala umsebenti;  imali yekucala ibhizinisi; inhlokodolobha; 
caps	 kunikwa litfuba lekudlala; emakepisi; emahlandla ekudlalela sive; 
capture	tfumba; 
captured	-tfunjiwe; kubanjwa; 
captures	tfumba; tfwebula; 
car	 imoti; imoto; 
carbon	ikhabhoni; 
cards	emakhadi; 
care	kunakekela;  nakekela; 
career	umsebenti; 
careers	imisebenti; 
careful	ngekunakekela; 
carefully	 ngekunakekela; ngekucophelela; 
cargo	umtfwalo; 
caring	kunakekela;  nakekela; 
carpet	imati; 
carried	tfwele-; tfwelwe-; 
carries	tfwala; 
carry	tfwala; 
carrying	tfwala; kwendlulisa inombolo; 
case	 libhokisi; licala; 
cases	emacala;  emabhokisi; 
cash	imali; 
cast	jikijela; 
catch	bamba; 
categories	 imikhakha; sigaba; 
category	sigaba;  luhlelo; 
cater	kwentela bantfu kudla; niketa lokudzingekako; 
catering	 kuniketa lokudzingekako; kwentela bantfu kudla; 
cattle	tinkhomo; 
cause	imbangela;  sisusa; 
caused	-bangelwe;  -suselwe; 
causes	timbangela; 
causing	bangela; 
cave	umhume; 
caves	imihume; imihhome; 
cease	yekela; 
ceases	yekela;  yekela; 
celebrated	-gubhe umkhosi; 
celebrates	-gubha umkhosi; 
celebrating	-gubha umkhosi; 
celebration	kugubha umkhosi; 
celebrations	imikhosi; 
cell	 iseli; lilahle; 
cells	emeli;  emaseli; tinhlayiya; 
cellular	iselula; 
census	lubalo; 
censuses	lubalo; lubalobantfu; 
cent	lisenti; 
centenary	umnyakalikhulu; 
center	 tinkhaba; tikhungo;  imikhatsi; 
central	emkhatsini; 
centre	sikhungo;  inkhaba;  umkhatsi; 
centres	 tinkhaba; tikhungo;  imikhatsi; 
centuries	 umnyakakhulu; emakhulu; iminyakalikhulu; 
century	 iminyaka lelikhulu;  umnyakakhulu; likhulu; 
ceremonial	ngekwemcimbi;  ngekwemgubho; 
ceremonies	imicimbi;  imigidvo; 
ceremony	umcimbi;  umgidvo; 
certain	kuciniseka; -nesiciniseko; 
certainly	ngekuciniseka; 
certainty	kuciniseka; 
certificate	sitifiketi; 
certificates	titifiketi; 
certification	kuvunywa ngekwemtsetfo;  kwenta kube semtsetfweni; 
certified	kuvunywa ngekwemtsetfo;  kwenta kube semtsetfweni; -lokucinisekisiwe; 
cession	sikhatsi salokutsite; 
chain	luketane; 
chair	 situlo; sihlalo; 
chaired	sihlalo;  kuba ngusihlalo; 
chairman	sihlalo; 
chairperson	sihlalo; 
chairpersons	bosihlalo; 
challenge	incabhayi;  insayeya;  -banga;  cela inselele;  kubanga; 
challenged	 tinsayeya; tinkinga;  -banga;  tincabhayi;  kubanga; 
challenges	-sukelwe;  kucela insayeya; kubanga;  tincabhayi;  kunika tinsayeya; 
challenging	kulukhuni;  kuphoca;  kuhlokolota;  kuyabita;  kunikwa insayeya; 
chamber	ligumbi; 
chambers	emagumbi;  emagumbi ekubambela umhlangano; 
champion	ingcwele; 
champions	boshampeni; 
championship	 bushampeni; bumpetsa; 
championships	bumpetsa’ bushampeni; 
chance	litfuba; ishansi; 
change	 ntjintja; ingucuko;  intjintji; 
changed	 -njtintjile; -gucukile; tintjintja;  ; 
changes	 tingucuko;  tintjintji; tingucuko;  kuntjintja; 
changing	 ntjintji; -gucuka;  -ntjintja; ntjintja; 
channel	umsele;  lawula; 
channels	ticondziso; imigudvukusakata;  imisele; 
chapter	sehluko; 
chapters	tehluko; 
character	similo;  umdlali;  umlingiswa; 
characterised	khombisa;  lingisa;  bonakala; 
characteristic	luphawu;  phatselene nesimilo;  -neluphawu; 
characteristics	timphawu;  imikhuba; 
characterize	lingisa; 
characterized	khombisa;  lingisa; bonakala; 
characters	 balingiswa;  timilo; badlali; 
charge	 imbadalo;  kubekwa licala;  gcwalisa; licala; 
charges	emacala;  tinkhokhelo;  tinhlawulo;  faka emandla; 
charter	lishadi lesivumelwano;  lishadi lesivumelwane; 
chartered	 lishadi lesivumelwane; kuvumelana; 
check	 vimba; kuvimba; 
checked	hlola; 
chemical	ikhemikhali; 
cheque	lisheke; 
chief	sikhulu;  shifu; 
child	umntfwana; 
childhood	buntfwana; 
children's	kwebantfwana; 
china	Ishayina; titja tesilumbi telibumba; 
choice	kukhetsa; 
choices	kukhetsa; 
choir	likwaya; 
choose	khetsa; 
chose	khetsa; 
chosen	-khetsiwe; 
chronic	kugula lokutsatsa sikhatsi lesidze kwleapheka; 
church	 libandla lelisontfo;  indlu yelisontfo; lisontfo; 
churches	 tindlu telisontfo;  emasontfo; emabandla elisontfo; emasontfo; 
cinemas	bobhayisikobho;  emasinema; 
circumstances	timeko; 
cite	samanisa; 
cited	-cashunwe; 
cities	emadolobhakati; 
citizen	sakhamuti; 
citizenry	simo sekuba sakhamuti; 
citizens	takhamuti; 
citizenship	buve; 
city	umutikati;  lidolobhakati; 
civic	kuhlalisana kwebantfu;  phatselene nelidolobha; 
civil	kuhlalisana kwebantfu; phatselene nebuve; 
claim	 sibito; banga;  bita; 
claimed	kufaka sicelonkhokhelo; banga;  bita; 
claims	 ticiniseko; ticelonkhokhelo; kutentisa;  tibito; 
clarification	kucacisa; 
clarify	cacisa; 
clarity	kucacisa; 
class	 sibaya; sigaba;  liklasi;  lizinga; 
classes	 tigaba;  emaklasi; emazinga; 
classic	kwelikhetselo; 
classical	-kwakadzeni; 
classics	kwelikhetselo; 
classification	luhlelo; 
classroom	 liklasi; ligumbi lekufundzela; 
clause	sigatjana; 
clauses	tigatjana; 
cleaning	kwenta kuhlobe; 
clear	 -balele; balela; 
clearance	sikhala; kususa; 
clearing	kususa; 
clearly	ngalokucacile; 
click	chafata;  ngwacabatfwa; 
client	umtsengi;  ummelwa; 
clients	 emaklayenti;  batsengi; emakhasimende; 
climate	simo selitulu; 
clinic	umtfolamphilo; 
clinical	kwelashwa; kuhlolisisa; 
clinics	imitfolamphilo;  emakliniki; 
close	dvute;  mbonya; 
closed	-valiwe; 
closely	dvutane; 
closer	 dvute kakhudlwana; sondzele; 
closing	kusondzela kakhulu; kuvala; 
closure	kwemukela;  kuvala; kuvaleka; 
closures	 tindzawo tekuvalela; kuvala; 
clothing	tembatfo;  kwekwembatsa; 
club	licembu; 
clubs	emacembu; 
cluster	licembu; 
co-operation	kubambisana;  inhlanganyela; 
co-operative	-nekubambisana; 
co-ordinate	hlanganisa; 
co-ordination	kuhambisana;  kuhlanganisa; 
co-production	kukhicita ngekubambisana; 
coach	 cecesha; ibhasi;  umeluleki;  umceceshi; 
coal	emalahle;  lilahle; 
coast	lugu; 
coastal	ngaselugwini; kwaselugwini; 
coat	boya; 
code	ikhodi; 
codes	emakhodi; 
coherent	 kuvakala; kubumbana; 
cohesion	kunamatselana;  kubumbana; kuhlangana;  kuvana; 
cohesive	kuhlangana; 
cold	 lichwa; umkhuhlane;  -bandza;  kubandza; 
collaborate	kubambisana;  kusebentisana; 
collaboration	kubambisana;  kusebentisana; 
collaborative	kubambisana;  kusebentisana; 
colleagues	bantfu losebenta nabo; 
collect	 -butsa; butsa;  gcogca; 
collected	-butsile;  -gcogcile; 
collecting	kugcogca;  kubutsa; 
collection	lokubutsiwe; 
collections	emagcogco; 
collective	ngekuvana;  ngekubumbana; 
collectively	ngekuvana;  ngekubumbana; 
colleges	emkolishi; emakolishi; 
colloquium	ingcungcutsela yetemfundvo;  inkhomfa yetemfundvo; 
colonies	 imihlambi; emave latfunjiwe;  titfunjwa; 
colour	umbala; 
coloured	-mabhadvubhadvu; 
colours	imibala; 
column	luhlu;  sicheme;  insika; 
combat	kulwa; vimba; 
combating	kulwa;  kuvimba; 
combination	 inhlanganisela;  kuhlanganisa; kwakhiwa; 
come	wota; 
comedy	umdlalohlaya; 
comes	wota; 
coming	kuta; 
command	umyalo;  kulayela; 
commas	bokhoma; 
commemorate	 gubha umkhosi; khumbula; 
commemorating	kukhumbula;  kugubha umkhosi; 
commemoration	sikhumbuto; 
commemorative	kugujelwa umkhosi wekukhunjulwa; kukhunjulwa; 
commence	kucala kwenta lokutsite;  kucala kusebenta; 
commenced	calile; 
commencement	kucala kwenta lokutsite;  kucala kusebenta; 
commencing	kucala kwenta lokutsite;  kucala kusebenta; 
commend	kuncoma; 
commendable	kuncomeka; 
commensurate	kuhambisana; 
comment	umbono; 
comments	imibono; 
commercial	 phatselene nekuhweba; sikhangiso; 
commission	ikhomishini; 
commissioned	ikhomishini; 
commissioner	umfungisi; 
commissioners	bafungisi;  emancusa; 
commissions	ikhomishini; 
commit	kutinikela; 
commitment	kutinikela; 
commitments	tibopho; kutinikela; 
commits	kutinikela; 
committed	kutinikela; 
committee	 ikomidi; likomiti; 
committee's	kwelikomidi; 
committees	emakomidi;  emakomiti; 
committing	kwenta licala; 
commodities	timphahla tekutsengiselana;  timphahla tekuhweba; 
commodity	 imphahla yekutsengiselana; imphahla yekuhweba; 
commonly	ngalokuvamile; 
commonwealth	inhlangano yetive; 
communal	kwemmango; kwawonkhe; 
communicate	chumana; 
communicated	-chumane; 
communication	kuchumana;  tekuchumana; 
communication-related	phatselene neluchumano;  phatselene nekuchumana; 
communications	kuchumana; 
communities	imimango;  bantfu emmangweni; 
community	umphakatsi;  ummango; 
community-based	kwemmango; emmangweni; 
companies	tinkampani; 
company	inkampani; 
comparability	kucatsaniseka; 
comparable	catsaniseka; 
comparative	kucatsaniseka; 
compare	linganisa; 
compared	linganisa; catsanisa; 
comparison	kucatsanisa;  kuchatsanisa; 
compassion	luvelo; 
compatriot	umkhaya; 
compatriots	bomkhaya; bantfu bakitsi; 
compelled	bopheleka; cindzeteleka; 
compelling	bophelela;  cindzetela; 
compensate	ncemphetela; 
compensation	sincesitelo; 
compete	 phikisana; chudzelana; 
competence	 kwati; likhono; 
competencies	 kwati; likhono; 
competency	 kwati; likhono; 
competent	 kuba nelikhono; kwati; 
competition	umncintiswano; 
competitive	kuncintisana;  kucudzelana; 
competitiveness	kuncintisana;  kucudzelana; 
compilation	kuhlanganisa; 
compile	gcogca; 
compiled	-gcogcwe; 
complainant	ummangali; 
complaint	sikhalo; 
complaints	tikhalo; 
complementary	gcwalisako; 
complete	-phelele;  -cedza; 
completed	-cedziwe;  -phetsiwe; 
completely	ngalokuphelele; 
completing	kucedza;  kucedzela; 
completion	kuphetsa;  kucedzela; 
compliance	kuhambisana; 
complied	hambisane; 
complies	hambisana; 
comply	hambisana; 
complying	hambisana; 
component	incenye; 
components	incenye leyakhako; 
composed	yakhiwe; 
composition	 kucamba;  indzaba; umsebenti;  kwakheka;  kwakhiwa; 
comprehensive	fake konkhe ekhatsi; khulu;  banti; 
comprehensively	kakhulu;  kabanti; 
comprise	fake ekhatsi; 
comprises	faka ekhatsi; 
comprising	kufaka ekhatsi; 
compromise	kwemukela;  emukela; 
compromised	kwemukela;  emukela; 
computer	ikhompuyutha;  ngcondvomshini; 
computers	Emakhompuyutha; bongcondvomshini;  bongcondvomshini; 
comrade	umbutfo; 
comrades	emabutfo; 
conceived	 mitsa; kumitsa; 
concentration	kutintisa ingcondvo; 
concept	umcondvo; 
concepts	imicondvo; 
concern	kukhatsateka; 
concerned	kukhatsateka; 
concerning	mayelana;  phatselene; 
concerns	phatsele; mayelana; 
concert	ikhonsathi; 
conciliation	kucolelana;  kubuyisana; 
conclude	phetsa; 
concluded	 phetsa; -phetsiwe; 
concludes	phetsa; 
conclusion	siphetfo;  kuphetsa; 
concrete	bonakalako; 
concurrence	kuhambisana; 
concurrent	ngasikhatsi sinye; 
condemned	sola;  jezisa; lahla; 
condemns	sola;  jezisa; lahla; 
condition	simo;  kugula;  umbandzela; 
conditional	ngekwembandzela; 
conditions	simo; 
condolences	kulilisa; 
condom	ikhondomu;  lijazi lemkhwenyane; 
condoms	emakhondomu;  emajazi lemkhwenyane; 
conducive	kukahle;  simo lesihle; 
conduct	 phatsa; kutiphatsa; 
conducted	 -phatfwe; -bhidiswe-; hambisa; kutiphatsa; 
conducting	 hambisa;  phatsa; bhidisa; kutiphatsa; 
conducts	 hambisa;  phatsa; bhidisa; kutiphatsa; 
confer	niketa;  phani; tfwesa; nika; 
conference	 inkhomfa; ikhomfa; 
conferences	tinkhomfa; tikhomfa; 
conferred	niketa; tfwesile;  nikile;  phile; 
confidence	 kutsembela; kutetsemba; 
confident	 -nekutetsemba; kutetsemba; 
confidential	 -kwemfihlo; lokuyimfihlo;  -yimfihlo; 
confidentiality	kuba nesifuba; 
confirm	cinisekisa;  vuma; 
confirmation	 kuciniswa; kucinisekisa; 
confirmed	cinisekisiwe; 
confirms	cinisekisa;  vuma; 
confiscation	kwemukwa; 
conflict	kungcubutana;  ingcabano; 
conflicts	 tincabano; kungcubutana; 
confront	kunika insayela;  kulwa;  kunika incabhayi; kubukana; 
congratulate	bongela; halalisela; 
congratulates	bongela; halalisela; 
congratulating	kuhalalisela;  kubongela; 
congratulations	kuhalalisela;  halala;  kubongela; 
congress	inhlangano; 
conjunction	sihlanganiso; 
connect	hlanganisa; 
connected	hlangene; 
connection	kuhlanganisa; 
conscience	 satela; nembeza; 
consciousness	-sesimeni sekuva; 
consecutive	-landzelanako; 
consensus	kuvumelana; 
consent	 vumela; imvume; 
consequence	umphumela; 
consequences	imiphumela; 
consequential	umphumela;  balulekile; 
consequently	ngako-ke;  ngenca yekutsi; 
conservation	konga;  kulondvolota; 
conserve	 vikela; kulondvolota;  londvolota; 
consider	 -cabanga; cabanga;  cabangisisa; 
considerable	 -khulu; balulekile;  bonakalako; 
considerably	ngalokubonakalako;  ngalokubalulekile; 
consideration	 umklomelo;  umcabango; kucabanga;  inkhokhelo; 
considerations	 imiklomelo; imicabango;  tinkhokhelo; 
considered	catjangelwe; catjangiwe; 
considering	 -cabanga; cabanga;  cabangisisa; 
considers	 -cabanga; cabanga;  cabangisisa; 
consist	 yakheke-; faka ekhatsi; entiwe; 
consistency	kungagucuki; kwenta intfo ngalokungenamkhawulo;  kwenta intfo ngalokuchubekako;  kutiya; 
consistent	kwenta intfo ngalokungenamkhawulo;  kwenta intfo ngalokuchubekako; 
consistently	ngalokungenamkhawulo; 
consisting	 -entiwe;  yakheke-; faka ekhatsi; 
consists	 yakheke-; faka ekhatsi; 
consolidate	hlanganisa; 
consolidated	hlanganisiwe; 
consolidation	kunhlanganisa; kuhlanganisa; 
constantly	njalo nje; 
constitute	yakha; 
constituted	yakha; 
constitutes	yakha; 
constitution	umtsetfosisekelo; 
constitutional	ngekwemtsetfosisekelo; 
constitutions	imitsetfosisekelo; 
constraints	titsibelo; 
construct	akha; yakha; 
constructed	 -akhile; yakhiwe;  yakhile; 
construction	kwakha;  kwakhiwa; 
constructive	kuyakha; 
construed	 humusha; hlatiya;  visisa; 
consult	chumana;  bonana; 
consultant	umeluleki; 
consultants	tiningalwati; 
consultation	 kubonana; kubonisana; 
consultations	 kubonana; kubonisana; 
consultative	 phatselene nekubonisana; mayelana nekubonisa; 
consulted	chumana;  bonana; 
consulting	chumana;  bonana; 
consumables	-dliwako; 
consumer	umtsengi; 
consumers	batsengi; basebentisimphahla; 
consumption	kusebentisa; 
contact	tsintsa;  kweyamana; 
contacts	bantfu lotsintsana nabo; 
contained	-cukatfwe; 
container	 kwekuphatsa; sicukatsi; 
containers	timumatsi; ticukatsi; 
containing	kucukatsa; 
contains	cukatsa; 
contemplated	catjangwe; 
contemporary	-kwanyalo; 
contempt	 indzelelo;  kweyana; kungahloniphi; 
content	lokucuketfwe; 
contents	lokucuketfwe;  umtsamo; 
context	 ingcikitsi; 
continent	sifundza;  livekati; 
continental	kwelivekati; welivekati; -yelivekati; 
continents	tifundza; emavekati; 
contingency	sehlakalo;  lokungahle kuvele; 
contingent	sehlakalo;  lokungahle kuvele; 
continuation	lokuchubekako; 
continue	chubeka; 
continued	-chubeka; 
continues	-chubeka; 
continuing	-chubeka; 
continuity	kuchebeka; 
continuous	kuyachubeka; sikhatsi lesisachubeka; 
continuously	ngalokuchubekako;  chubekako; 
contract	inkontileka;  nciphisa;  kufinyela; 
contracted	 kufaka kunkontileka; kunciphisa;  kufinyela; 
contracting	 kufaka kunkontileka; kunciphisa;  kufinyela; 
contractor	losebenta ngekontileka; 
contractors	bosokontileka;  labasebenta ngekontileka; 
contracts	 emakontileka; inkontileka; 
contractual	kwekontileka; 
contrary	ngalokuphikisako; lokuphikisako; 
contrast	umehluko;  kucatsanisa; 
contravenes	-phula;  phikisa; 
contravention	 kwephula; kuphikisa; 
contribute	 nikela;  faka ligalelo; nikela; faka sandla; 
contributed	 -nikela; fake ligalelo; nikele;  fake sandla; 
contributes	 nikela;  faka ligalelo;  faka sandla; emagalelo; 
contributing	 kufaka sandla;  kufaka ligalelo; kunikela; 
contribution	 kufaka sandla;  umnikelo; ligalelo; 
contributions	 kufaka sandla; emagalelo; iminikel; 
contributor	 umfakisandla;  lophako; umfakigalelo; umnikeli; 
contributors	basiti;  labanikelako; bafakigalelo;  bafakisandla; 
control	 kulawula;  phatsa; kuphatsa;  lawula; 
controlled	 kulawula;  phatsa; kuphatsa;  lawula; 
controlling	 kulawula; kuphatsa; 
controls	tilawuli;  kulawula; kuphatsa; 
convene	bita umhlangano; 
convened	bite umhlangano; 
convention	inhlangano;  lisiko;  sivumelwano; 
conventional	ngekwelisiko; 
conventions	tinhlangano;  tivumelwano;  emasiko; 
convergence	kuhlangana;  kubutsana; 
conversation	ingcoco; 
conversations	tingcoco; 
conversion	 kuphendvuka; ingucuko;  kugucula; 
convert	gucula; 
converted	 guculiwe; Gucukile; 
convey	kundlulisa; 
convict	siboshwa; 
convicted	kuboshwa; 
conviction	kulahlwa licala;  sehlulelo; kubekwa licala; 
convinced	kukholwa;  kwenetiseka; 
cookie	emakukisi; 
cooperation	kusebentisana; lubanjiswaso; 
cooperative	-kubambisana; 
cooperatives	emakoporasi; 
coordinate	kuhlangana;  chumanisa; 
coordinated	-hlanganisa; 
coordinating	kuhlanganisa; 
coordination	kuhlelembisa; 
cope	i-cope; 
copies	emakhophi; 
copy	ikhophi;  kopa; 
core	inhlitiyo; 
corner	 likona; likhona;  lijika; 
cornerstone	sisekelo; 
corporate	-hlangene; ikoporasi; 
corporation	ikoporasi; inhlangano; 
corporations	tinhlangano;  emakoporasi; 
corps	umbutfo wetemphi; 
correct	kulungile;  lungisa; 
correction	kulungisa; 
correctional	bulungiswa; 
corrections	tilungiso; 
correctly	ngalokunguko; 
correspondence	 luchumano; kuhambisana; 
corrupt	 khohlakala; -onakele; 
corruption	inkhohlakalo; 
cost	intsengo; 
cost-effective	konga imali;  kubita tindleko letincane; 
costs	tindleko;  tintsengo; 
could	kukhona kwenta lokutsite; nga-; 
council	umkhandlu; 
councillor	 lilunga lelibandla; likhansela; 
councillors	emakhansela;  emalunga lelibandla; 
councils	imikhandlu; 
counsel	 sicondziso; yeluleka; seluleko; 
counselling	kweluleka;  kweluleka ngekwengcondvo; 
count	bala; 
countdown	kubalela emuva; 
counterclaim	inkhulumu lephikisa yaphambilini; 
counterpart	zakwetfu; lokufana nalokunye; 
counterparts	bozakwetfu; lokufana nalokunye; 
countries	emave; 
country	live; 
country's	kwelive; 
countrywide	kuvelonkhe;  eveni lonkhe; 
couple	 bhanca; lokubili; 
coupled	kuhlangene;  bhanca; 
coupon	 sigcebhezana; lithikithi; ikhuphoni; 
courage	sibindzi; 
course	kwewusa;  tigaba tekudla; 
courses	 tigaba tekudla; tifundvo; 
court	inkantolo;  likhotho; 
court's	kwenkantolo; 
courtesy	kuhlonipha; 
courts	tinkantolo; 
cover	vala;  faka ekhatsi;  ikhava; 
coverage	kufinyelela; 
covered	khulunyiwe ngako; valiwe; 
covering	sikhumba;  sivikelo;  simbonyo; 
covers	 emakhava;  khuluma ngako; faka ekhatsi; 
covet	fisa; 
coveted	fisa; 
cradle	umbhedze wemntfwana; 
craft	umsebenti wetandla; 
crafter	umbati; 
crafters	babati;  labenta imisebenti yetandla; 
crafts	imisebenti yetandla; 
crater	ibhobo lenkhulu; 
create	akha; 
created	-akha; 
creates	-akha; 
creating	akha; 
creation	indalo; 
creative	-nelikhono lekuticambela; 
creativity	kuticambela; 
creator	umdali; 
creators	umdali; 
credibility	kukholeka;  kukholweka; kwetsembeka; 
credible	kohlweka;  mukeleka; tsembeka; 
credit	sikweledi;  sikwelede; 
creditor	umuntfu lokweletwako; unikisikweleti;  lokweletisako; lokweletwako; 
creditors	 labakweletwako; banikisikweleti; labakweletisako; 
credits	tikwelede;  nika sikweledi; 
creed	 lukholo; inkholelo; inkholo; 
crime	bugebengu; 
crimes	bugebengu; 
criminal	sigebengu; 
criminals	tigebengu; 
criteria	tindlela; 
criterion	simisomgomo; 
critical	 simo lesibucayi; balulekile; 
critically	 lokubucayi; ngalokubalulekile; 
crop	sivuno; 
crops	tilimo;  tivuno; 
cross	phambanisa;  siphambano;  kugoba; 
cross-border	 ngesheya kwemnyele; kulamanye emave; 
crucial	 baluleke kakhulu; balulekile; 
culminate	holela e-; 
culmination	 siphetfo; umphumela; 
cultural	-kwelisiko; 
culture	lisiko;  umhambo; 
cultures	emasiko; 
cup	inkomishi; 
curate	umsiti wemphristi; 
curator	umphatsi; 
curators	 umphatsibuciko; bagcinibuciko; 
currency	 luhlobo lwemali; imali yelive; 
current	 umsinga wagezi; umsinga; 
currently	 kwamanje; nyalo;  manje; 
curriculum	ikharikhulamu; 
curve	likhona;  lijika; 
custodian	umlondvoloti; 
custodians	balondvoloti; 
custody	 lilungelo lekugcina bantfwana; kuboshwa;  lilungelo lekugcina umntfwana; 
custom	lisiko; 
customary	ngekwelisiko; 
customer	umtsengi; 
customers	emakhasimende; 
customs	imihambo; 
cut	linceba;  linceba lekusikeka;  licatsa; 
cutting	lihlumela;  sitokwana; 
cycle	umjikeleto;  situngeletane; 
daily	onkhe emalanga; 
dam	lidamu; 
damage	 emadameshe; yona;  umonakalo;  limata;  bhidlita; 
damages	imonakalo;  limata; iminakalo;  bhidlita; 
dance	umdanso; 
dancers	badansi; 
dances	imidanso; 
danger	ingoti; 
dangerous	-nebungoti;  -yingoti; 
dark	 -mnyama;  -ntima;  bumnyama; kumnyama; 
data	 idatha; imininingwane; 
database	silululwati; 
databases	tilululwati; 
date	 faka lusuku; lusuku; 
dated	bhalwe lusuku lwamhlaka- kutikhipha kwebantfu; 
dawn	kusa;  ekuseni kakhulu; 
day	 lusuku; lilanga; 
days	emalanga; 
dead	 shonile;  -ndlule emhlabeni; -file; 
deadline	lusuku loluncunyiwe; umncamulajucu ; 
deaf	-ngeva etindlebeni; 
deal	 sivumelwano semsebenti; ibhizinisi; kubukana nalokutsite; 
dealer	umtsengisi; 
dealers	batsengisi; 
dealing	 kubukana nalokutsite; kucatulula ludzaba; 
deals	 tivumelwano;  kubukana nalokutsite;  tivumelwano temsebenti; emabhizinisi;  kucatulula ludzaba; 
dealt	 catululiwe; bukenwe nalokutsite; kubukana nalokutsite; 
dear	lotsandzekako; -tsandziwe; 
death	kufa; 
deaths	kufa; 
debate	 phikisana; inkhulumomphikiswano; 
debated	kukhulumakuphikisana; -phikisane; 
debates	tinkhulumomphikiswano; 
debt	sikweledi;  sikwelede; 
debtor's	kwalokweletako; 
debts	 tikwelede; tikweledi; 
decade	sikhatsi seminyaka lelishumi; 
decades	iminyakalishumi; iminyakashumi; 
deceased	-shonile; umufi; 
decent	lokukahle;  ngesitfunti; -ngekuhlonipha; 
decide	ncuma; 
decided	ncumile; khetsile; 
decides	ncuma; 
deciding	kuncuma; 
decision	sincumo; 
decision-making	kutsatfwa kwesincumo; 
decisions	tincumo; 
declaration	 simemetelo lesisemtsetfweni; simemetelo; 
declare	 memetela; -memetela; 
declared	memetele; -tfule; 
declares	 memetela;  -memetela; kufunga; 
decline	 umehlelo; yala; kwala; 
declined	-alile;  umehlelo;  walile; yala; 
declines	 yala;  umehlelo;  uyala; kwala; 
declining	 kuncipha;  kwehlela; kwala; 
decrease	kunciphisa;  nciphisa; 
decreased	kunciphisa;  nciphisa; 
decryption	 -enta kube lula; cacisa; 
dedicate	 busisa; nikela; 
dedicated	 -nikele; -busiswe; 
dedication	 kubusisa; kutinikela; 
deduct	susa; 
deducted	khipha; susa; 
deduction	kukhipha; 
deductions	kukhipha; 
deed	sento; 
deeds	tento;  ematayitela; 
deem	 linganisela; cabanga; 
deemed	 linganisela; cabanga; 
deems	 linganisela; cabanga; 
deep	shona; -julile; 
deepen	yenta kushone;  yenta kujule; 
deeper	kushona kakhudlwana;  julile kakhudlwana; 
deeply	kakhulu;  ngalokujulile; Ngalokushonako; 
default	liphutsa;  phutsa;  kwephula sivumelwano; kwephula umtsetfo; 
defect	sici; 
defence	kuvikela;  kuvimba; 
defend	vikela; 
defendant	ummangalelwa; 
defiance	kwedzelela; 
deficiencies	kungeneli; lokushodako; 
deficiency	 kweswela; kweswelakala; 
deficit	kushoda; 
deficits	kushoda; 
define	chaza; 
defined	-chazwe; 
defines	chaza; 
defining	chaza; 
definition	inchazelo; 
definitions	tinchazelo; 
degree	 lizingakushisa; lizinga; 
degrees	emadigri;  emazinga; emazinga;  emazingakushisa; 
delay	 kulibatisa; kubambeleleka;  libatisa; 
delayed	 kulibatisa; kubambeleleka;  libatisa; 
delays	 kulibatisa; kubambeleleka;  libatisa; 
delegate	sitfunywa;  niketa ligunya; 
delegated	kutfunywa;  niketa ligunya;  kunika umsebenti; 
delegates	 ematsimba;  niketa ligunya; titfunywa; 
delegation	libandla letitfunywa;  litsimba letitfunywa; 
delegations	ematsimba etitfunywa;  emabandla etitfunywa; 
deleted	cima; 
deletion	kususa; 
deliberate	 kubonisana; kucocisana; 
deliberately	ngemabomu; 
deliberations	tinkhulumiswano; 
delighted	kujabula; 
deliver	kubeleka; 
delivered	-tfulwe; 
delivering	kubeleka; hambisa; 
delivers	 kubeleka; kuletsa; 
delivery	kubeleka; 
demand	sidzingo;  dzinga; 
demands	 kufuna ngenkhani;  kudzingeka kakhulu; kufuna ngemandla; 
demarcation	kukanisa; 
democracy	intsandvo yelinyenti; 
democratic	-ngekwentsandvo yelinyenti;  -yentsandvo yelinyenti; 
democratically	ngekwentsandvo yelinyenti; 
demographic	 umkhakha webantfu; bantfu; 
demonstrate	khombisa;  bonisa; 
demonstrated	-bonisawe;  -khonjiswe; shuca; 
demonstrates	khombisa;  bonisa;  shuca; 
demonstration	 umbhikisho;  umshuco;  kubonisa; kukhombisa; 
denied	-phikile; -ala; 
dental	phatselene nematinyo; 
deny	ala;  phika; 
department	 ligala; litiko; 
department's	kwematiko; 
departmental	kwelitiko; 
departments	ematiko;  timphiko; 
departure	kuhamba; kusuka; 
depend	 kuya ngekutsi-; kusime ku-; 
dependant	umondliwa; 
dependants	bomondliwa; 
dependence	kuncika;  kuncika; kondliwa; 
dependency	live lelilawulwa ngulelinye; 
dependent	mondliwa; -phatselene nekutsembela;  loncikile; 
depending	kuncika; 
depends	kuncika;  kuya nge-; 
deploy	tfumela ngenhloso; 
deployed	tfumela ngenhloso; 
deployment	kuyiwa uyosebenta kulenye indzawo; 
deposit	 imali yesibambiso;  sitaki;  bambisa;  idiphozi; sibambiso; 
deposited	faka;  faka; Faka timali tesibambiso;  sitaki;  sibambiso;  bambisa;  faka timali tesibambiso; 
depository	lapho kugcinwa tintfo letitsite khona; 
deposits	 tibambiso; imali yesibambiso; emadiphozi;  bambisa;  timali tesibambiso; 
depth	kushona;  kujula; 
deputies	emasekela; 
deputy	lisekela; 
derive	susela; yakha; 
derived	suselwe; yakhiwe; 
descent	lokunesitfunti; lokukahle; 
describe	chaza;  dvweba; 
described	-chazwe; 
description	inchazelo; 
desert	lugwadvule; 
design	simo;  dvweba; 
designate	khetsa; 
designated	khetsiwe; 
designation	 kucoka; sikhundla; 
designed	simo;  luhlakasimo; -dvwetjiwe; 
designer	umhleli; 
designers	bahleli; 
designs	emadizayini;  tinhlakasimo; 
desirable	tsandzekako; 
desire	 fisa; funa; 
desired	funwako; -fiswako; 
despite	nanoma;  ngekunganaki; 
destination	indzawo loya kuyo; 
destiny	siphetfo;  indzawo loya kuyo; 
destroy	bhubhisa; 
destroyed	-bhubhiswe; 
destruction	kubhubhisa; 
detail	 umniningwano; imininingwane;  umniningwane;  ngalokuphelele; 
detailed	 kabanti; ngalokuphelele; 
details	imininingwano; 
detained	kugcinwa esitokisini, banjelelwa; 
detainees	tiboshwa; labagcinwe esitokisini; 
detection	 kubonwa; kutfolwa; 
detention	kuboshwa; 
determination	kutimisela; sincumo; 
determine	tfola;  ncuma; 
determined	kutimisela; 
determines	tfola;  ncuma; 
determining	tfola;  ncuma; 
develop	 tfutfuka; tfutfukisa; 
developed	-tfutfukiswe; 
developing	 tfutfuka; tfutfukisa; 
development	kutfutfuka;  intfutfuko; 
developmental	kwekutfutfukisa; 
developments	tintfutfuko; 
develops	 tfutfuka; tfutfukisa; 
device	 intfo yekwenta lokutsite; cabanga;  sisetjentiswa; 
devices	emasu; 
devolution	kwendlulisa emandla;  kusabalalisa emandla; 
diagnosis	imiphumela yeluhlolo;  kucubungula sifo; 
dialogue	 kukhulumisana; inkhulumomphendvulwano; 
dialogues	tinkhulumiswano;  tinkhulumomphendvulwano; 
diamond	 idayimane; idayimani; 
diamonds	emadayimane; 
diaspora	kusabalala; 
dictionary	sichazamagama; 
did	entile; 
didn't	akenti; 
die	fa; 
died	-fa; -file; 
dies	fani; emadayisi; 
difference	umehluko; 
differences	imehluko; 
different	-hlukene; 
differently	ngalokwehlukile; 
difficult	-lukhuni; 
difficulties	bulukhuni; 
difficulty	bulukhuni; 
digital	-kwetinombolo; 
dignified	lokunesitfunti; lokukahle; 
dignitaries	ticumama; ticukutfwane; 
dignity	sitfunti; 
dimension	bungako; 
dimensions	silinganisobungako; bungako; 
dinner	sidlo santsambama; 
diploma	idiploma; 
diplomatic	ngebuhlakani; 
direct	-ngco; 
directed	-condzisiwe; 
directing	kucondzisa; 
direction	 inkhombandlela; indlela; 
directions	ticondziso; 
directive	 imphambosi yekwentela; sicondziso; umyaleto; 
directives	ticondziso;  imiyaleto; 
directly	ngco; 
director	umcondzisi; 
director-general	umcondzisi Jikelele; 
directorate	luphiko; 
directors	bacondzisi; 
directs	kucondzisa; 
disabilities	kukhubateka; 
disability	kukhubateka; 
disadvantage	bubi; 
disadvantaged	bubi;  kuncishwa litfuba; 
disaster	inhlekelele; 
disasters	tinhlekelele; 
discharge	kukhululwa;  lubhici;  lahla;  khulula; 
discharged	kukhululwa;  khishwa;  lahliwe;  khulula;  khishiwe; 
disciplinary	kujeziswa; 
discipline	kutiphatsa kahle; 
disciplines	timphatfocatsa; kutiphatsa kahle; 
disclaimer	kuphika licala; umphikicala; 
disclose	kubeka ebaleni; beka ebaleni; 
disclosed	bekwe ebaleni; beke ebaleni; 
disclosure	kukhiphela imfihlo yakho ebaleni;  kubeka ludzaba ebaleni; 
discourse	inkhulumo; 
discover	tfola; 
discovered	-tfola; 
discovery	kutfola; 
discretion	kutibonela; 
discretionary	ngekucabanga; 
discrimination	lubandlululo;  kubandlulula; 
discuss	coca; 
discussed	-cocwe-; 
discussing	coca; 
discussion	kucoca;  ingcoco; 
discussions	tingcoco; 
disease	sifo; 
diseases	tifo; 
dismissal	kucosha; 
disparities	 kungafanani; kungalingani; 
display	 lakhombisako;  endlala; kukhombisa;  bukisa; 
displayed	kukhombisa; -bukiswe;  -endlalwe; -khonjiwe; 
displaying	 -khombisa; khombisa;  -kukhombisa; 
disposal	kulahla; 
dispose	lahla; 
disposed	lahla; 
dispossession	kutsatsela umuntfu lutfo lwakhe; emuka;  kwemuka umuntfu lutfo lwakhe; 
dispute	umbango;  banga; 
disputes	imibango; 
disqualified	 emukwe timfanelo; emukwe emandla ekufaneleka; vimbela;  yekelisiwe; 
dissatisfied	ngeneliseki; 
dissemination	kwendlulisela lwati kulabanye; sakata; 
dissolution	kucitsa; kuhlakata; 
dissolved	citsa;  ncibilika; 
distance	libanga; 
distant	-khashane; 
distinct	hluke kakhulu; cacile ; 
distinction	umehluko;  kuphumelela ngemalengiso; 
distinctions	kuphumelela ngemalengiso; imehluko; 
distinctive	hluke kakhulu; 
distinguished	cavile; hlukile; 
distribute	aba; 
distributed	-sabalaliswe; 
distribution	 kuhleleka; kwaba; 
district	sifundza;  sigodzi; 
districts	 tigodzi; tifundza; 
diversion	silibatiso;  siphambukiso; 
diversity	kwehlukahlukana; 
diverted	phambukisiwe; 
divide	susa ngekuphindzelela; 
divided	susa ngekuphindzelela; hlukanisa; 
dividend	intalo; 
dividends	bomahlukaniswa; tintalo;  tinombolo letisahlukaniswa; 
division	 kukhipha lokuphindziwe; kwehlukanisa; 
divisions	kwehlukanisa;  kukhipha ngalokuphindziwe; 
divorce	kwehlukana;  sehlukaniso; 
do	enta; 
doctor	dokotela;  dokodela; 
doctorate	budokotela; 
doctors	bodokotela;  bodokodela; 
document	umbhalo;  incwajana; 
documentation	imiculu; emadokhumenti; 
documented	-bhaliwe; 
documenting	kubhala; 
documents	imibhalo;  tincwajana; 
does	ngabe;  enta; 
doesn't	aka-; 
doing	enta; 
dollar	lidola; 
domain	umkhakha; 
domains	tindzawo;  imikhakha; 
domestic	kwasekhaya; 
dominant	linothi lesihlanu; 
domination	 kwengamela;  kuba banyenti kunalabanye;  kuba kunyenti kunalokunye;  kwengama; kubusa; 
don't	angenti;  ungenti; 
donation	umnikelo; 
donations	iminikelo; 
done	kwentiwe;  kwentekile; 
donor	umesekeli; 
donors	basekeli; 
door	umnyango; 
doors	iminyango; 
double	-phindziwe;  phindza kabili; 
doubt	kungabata; 
down	phasi;  tinsiba letincane;  sihluphe; 
download	tsatsela; 
downtown	enkhabeni yelidolobha; 
downturn	ingucuko lembi; 
draft	luhlaka; 
drafted	kwenta luhlaka; 
drafting	kwenta luhlaka; 
drama	umdlalo; 
dramatic	kwenta timanga; 
draw	kudlala ngekulingana;  dvweba; 
drawing	 umdvwebo; kudvweba; 
drawn	dvwebile; 
dream	liphupho; 
dreams	emaphupho; 
drew	-dvwebile;  -dvwetjwe;  -khiphe imali ebhange; -dvweba;  kutfola emagoli emdlalo lalinganoko; 
drink	sinatfo; 
drinking	kunatsa; 
drive	umgwaco;  shayela; kushayela; 
driven	-shiyelwe;  kushayelelwa; 
driver	umshayeli; 
driver's	kwemshayeli; 
drivers	bashayeli; 
driving	 kushayeka; kushayela; 
drop	 litfonsi; ehla; 
drug	umutsi; 
drugs	 tidzakamiva; imitsi; 
drum	sigubhu; 
dry	 yoma;  yomisa;  -omile; omile;  -yomile; 
dual	-ngakubili; 
due	fanele kwenteke; 
duly	 ngalokulindzelekile; ngalokufanele; 
duplicate	phindza kabili; kwenta intfo ngalokungenamkhawulo;  kwenta intfo ngalokuchubekako; 
duplication	kuphindzeka kabili; 
duration	 sikhatsi lesibekelwe umdlalo;  budze besikhatsi; sikhatsi; 
during	ngesikhatsi-; 
duties	 imitselo;  tibopho; imisebenti; 
duty	 umtselo; umsebenti;  sibopho; 
dynamic	kuntintjantjintja ngemandla; -ntjintjako; 
dynamics	-ntjintjako; kuntjintjintja ngemandla; 
e-mail	incwadzigezi; i-imeyili; 
each	loko naloko; 
earlier	 ngembi-; ngembi kwesikhatsi; 
earliest	masinyane; 
early	kusesenesikhatsi; 
earmarked	bekelwe lokutsite;  gcinelwe lokutsite; 
earned	-holwe; 
earning	umholo; 
earnings	 imali lengenako; imiholo; 
earth	 umhlabatsi;  hlanganisa intsambo yagezi nemhlabatsi; umhlaba; 
ease	kukhululeka; 
easier	lula kakhudlwana; 
easily	kalula; 
east	emphumalanga;  imphumalanga; 
eastern	ngasemphumalanga; 
easy	lula; 
economic	temnotfo; umnotfo; 
economically	 mayelana nemnotfo; ngekwemnotfo; 
economics	sifundvo setemnotfo; 
economies	iminotfo; 
economists	somnotfo; 
economy	umnotfo; 
ecosystem	indlela yemvelo; 
ecosystems	kuphilisana kwetitjalo netilwane;  tindlela temvelo; 
edge	 umphetfo welicembe;  umphetfo; umngcengcema; 
edit	hlela; 
editing	kuhlela; 
edition	umshicilelo; 
editor	umhleli; 
editors	bahleli; 
educate	fundzisa; 
educated	fundzisa; 
educating	fundzisa; 
education	 kufundzisa;  imfundvo; kufundza; 
educational	-nemfundziso; 
educator	umfundzisi; 
educators	bafundzisi; 
effect	umphumela; 
effected	faka;  kuba nemphumela; 
effective	 -sebentako; -sebenta ngemphumela; 
effectively	kahle;  ngemphumelelo; 
effectiveness	kuphumelela; 
effects	imiphumela; 
efficacy	emandla; 
efficiency	likhono;  kwenelisa; 
efficient	 -nelikhono; -sebenta kahle; 
efficiently	kuba nelikhono; 
effort	umtamo; 
efforts	imitamo; 
eight	siphohlongo; 
either	 ngetulu kwaloko; noma; 
elderly	 lomdzala; labadzala; 
elders	labadzala; 
elect	khetsa; 
elected	khetse-; 
election	lukhetfo; 
elections	tinkhetfo; 
electoral	kwelukhetfo;  phatselene nelukhetfo; 
electrical	kwagezi; 
electricity	gezi; 
electrification	gezi; 
electronically	ngagezi; 
elects	khetsa; 
element	 kuphakanyiswa; lilunga;  sitsako semvelo;  i-elementi; 
elements	imisuka; 
elevate	 phakamisa; beka esikhundleni lesiphakeme; 
eleven	lishumi nakunye; 
eligible	fanelekako; 
eliminated	-suswe;  hlungiwe; 
elimination	kukhipha; 
eloquently	kukhuluma kahle; kukhuluma ngalokushelelako; 
else	lokunye; 
elsewhere	lenye indzawo; 
email	liposi; 
emanating	suka;  vela; 
emancipation	kukhululwa; 
embark	cala; 
embarked	-calile; 
embarking	cala; 
embassies	emahhovisi emancusa; 
embassy	emancusa; 
embedded	fakwe ekhatsi; 
emblem	luphawu; 
embodiment	kuhlanganiswa; 
embrace	 emukela; mukela; gona; 
embraced	 mukelwe; -mukelwe;  mukele; 
embraces	 gona;  emukela; mukela; 
emerge	vela; 
emerged	vela; 
emergence	kuvela; 
emergency	 simo lesiphutfumako; lokuphutfumako; 
emergent	kubela; 
emerging	kuvela; 
eminent	dvumile;  phakeme; khulu; 
emission	kutfunyisa; kubhunyisa; kukhishwa; 
emissions	lokutfunyiswako; kukhishwa;  kubhunyisa; 
emoluments	 tinzunzo; tinkhokhelo; 
emotion	luvo;  lusinga; 
emotional	kuphakama kwemiva; 
emotions	 tinsinga; timvo; 
emphasis	kugcizelela; 
emphasise	gcizelela; 
emphasised	gcamisiwe;  gcizelele; 
emphasises	kugcizelela; 
employ	 -casha; casha; 
employed	-setjentiswe; -cashwe; 
employee	sisebenti; umsebenti; 
employees	tisebenti; 
employer	umcashi; 
employers	bacashi; 
employing	 -casha; casha; 
employment	 kucashwa; umsebenti; 
employs	 -casha; casha; 
empower	kuhlomisa emakhono; 
empowered	kuhlomisa emakhono; 
empowering	kuhlomisa emakhono; 
empowerment	kuhlomisa; 
empty	tfulula; 
emulate	landzela; fananisa; 
enable	enta kusebente;  nika emandla; 
enabled	enta kusebente;  nika emandla; 
enables	nika emandla;  kwenta kusebente; 
enabling	enta kusebente;  nika emandla; 
enacted	kushaya umtsetfo; 
enacting	kushaya umtsetfo; 
enactment	kushaya umtsetfo; 
enactments	kushaya umtsetfo; 
encourage	 gcugcutela; khutsata; 
encouraged	 khutsatiwe;  -khutsatwe; -gcugcutelekile; 
encourages	 gcugcutela; khutsata; 
encouraging	 gcugcutela; khutsata; 
end	siphetfo; 
endanger	kufaka engotini; 
endangered	kufaka engotini; 
endeavor	tama; 
endeavour	tama; 
endeavours	imitamo; 
ended	siphetfo; 
ending	kugcina; siphetfo;  kuphetsa; 
endorse	vuma; 
endorsed	vumile; 
endorsement	kuvuma; 
ends	tiphetfo; 
enduring	kubeketela; 
energy	emandla; 
enforced	-phocelela; 
enforcement	kucinisekisa; 
engage	hlanganyela; 
engaged	hlanganyele; 
engagement	setsembiso; 
engagements	tetsembiso; 
engaging	kuhlanganyela; 
engender	bangela; veta; 
engendering	bangela; veta; 
engine	injini; 
engineer	calisa; 
engineering	bunjiniyela; 
engineers	bonjinela; 
enhance	ngeta; 
enhanced	-entwe kwabancono; 
enhancement	kwenta kube ncono; 
enhancing	ngeta; 
enjoy	tfokota; jabula; 
enjoyed	tfokotile; jabulile; 
enormous	khulu; 
enough	ngalokwenele; 
enquiries	kuphenya; 
enquiry	luphenyo; 
enrol	bhalisa; 
enrolled	bhalisile; 
enrolment	kubhalisa; 
enshrined	londvolotekile; 
ensue	landzela; 
ensuing	landzela; 
ensure	ciniseka; 
ensured	ciniseka; 
ensures	ciniseka; 
ensuring	ciniseka; 
entail	faka ekhatsi; 
entails	faka ekhatsi;  kufaka ekhatsi; 
entered	-ngenile; 
entering	ngena; 
enterprise	ibhizinisi; 
enterprises	emabhizinisi; 
enters	ngena; 
entertainment	kunandzisa; 
entire	-phelele; 
entirely	ngalokuphelele; 
entities	tintfo; imitimba;  tinhlangano; 
entitled	nika lilungelo, kuba nelilungelo; 
entity	 intfo;  inhlangano; umtimba; 
entrance	indzawo yekungena; 
entrepreneur	somabhizinisi; 
entrepreneurial	kuba ngusomabhizinisi; 
entrepreneurs	bosomabhizinisi; 
entrepreneurship	ibhizinisi; 
entries	lokungenile; 
entrusted	kunika sibopho; 
entry	 singeniso; kungena; 
envelope	imvilophu; 
environment	bunjalondzawo;  bunjalo bendzawo imvelo; 
environmental	kwesimondzawo; 
environments	bunjalondzawo;  bunjalo bendzawo imvelo; 
envisaged	 lindzelwe; catjangwako; 
envisages	lindzele; 
epidemic	sifomcedzave;  lubhubhane; 
equal	-linganako; 
equality	kulingana; 
equally	ngalokulinganako; 
equipment	tintfo tekusebenta; 
equipped	kuba netisetjentiswa; 
equitable	linganako;  lungile; 
equity	bulungiswa; kulingana; 
equivalent	-linganako; 
era	sikhatsi; 
eradicate	cedza; 
eradicating	cedza; 
eradication	kususa; 
error	siphosiso; 
errors	tiphosiso; 
escape	 kuphunyuka; baleka; 
escapes	 kuphunyuka; baleka; 
especially	ikakhulu; kakhulukhulu; 
essence	imphandze yenkholo; 
essential	lokumcoka;  -balulekile; 
essentially	ngalokubalulekile; 
establish	sungula;  misa akha; 
established	-sungulwe; 
establishes	sungula; 
establishing	 -kusungula; sungula; 
establishment	lokusunguliwe;  lokumisiwe; 
establishments	lokusunguliwe;  lokumisiwe; 
estate	umhlaba;  lifa; 
estates	timphahla;  emafa; 
esteemed	hloniphekile; 
estimate	 linganisa; silinganiso; 
estimated	linganiswe; -linganiswe; 
estimates	 tilinganisa; tilinganiso; 
ethical	-kwenkhambo lenhle; inkambo lelungile; 
ethics	inkhambo lenhle; 
ethnic	 -kwebuve; kweluhlobo lwebuve; 
ethnicity	buve; 
ethos	inkholelo yemasiko; 
evaluate	hlola; 
evaluated	hlola; 
evaluating	hlola; 
evaluation	luhlolo; 
eve	sikhatsi lesingembi kwesehlakalo lesitsite; 
even	 -lingene; -linganako; 
evening	 kusihlwa; busuku; 
event	 sehlakalo; umdlalo; 
events	 tehlakalo; imidlalo; 
eventually	ekugcineni; 
ever	nanini; 
every	wonkhe; 
everybody	wonkhe umuntfu; 
everyone	wonkhe umuntfu; 
everything	yonkhe intfo; 
evidence	bufakazi; 
evident	kubonakala; 
evolve	sombuluka; 
evolved	ntjintjile; sombuluka; 
evolving	 ntjintja; kugucuka; 
exactly	 kona mbamba; ngco; 
examination	 kuhlola;  kuhlolwa; luhlolo; 
examinations	tinhlolo; 
examine	hlola; 
examined	hlola; 
example	sibonelo; 
examples	tibonelo; 
exams	Tinhlolo tekuphela kwemnyaka; 
exceed	engca; 
exceeded	ndlulele; engca; 
exceeding	kwendlula; 
exceeds	ndlulele; engca; 
excelled	kwenta kahle kakhulu; 
excellence	kwenta kahle kakhulu; kuhle kakhulu; 
excellent	kuhle kakhulu; 
except	shiya ngaphandle; 
exception	lokwehlukile;  siphambuka; 
exceptional	kuhle kakhulu; 
excess	lokungetulu; 
excessive	kuba ngetulu kwalokulindzelekile; 
exchange	 kuntjintjiselana; ntjintjanisa; 
exchanges	kuntjintjisa;  ntjintjiselana; kuntjintjiselana; 
excitement	kutsakasa; injabulo; 
exciting	kuyajabulisa; 
excluded	Vimbela;  kungafaki-; 
excludes	Vimbela;  kungafaki-; 
excluding	vimbela; 
exclusion	kungafaki ekhatsi; 
exclusions	kungafaki ekhatsi; 
exclusive	khetsekile; 
exclusively	ngalokukhetsekile; 
execute	bulala; enta;  bulala ngekwemtsetfo; 
executed	bulala;  bulawa ngekwemtsetfo; 
executing	bulala;  kubulala ngekwemtsetfo; 
execution	kubulala ngekwemtsetfo; kubulala; 
executive	sikhulu;  sigungu lesiphetse; 
executor	umabilifa; 
exempt	khipha emtsetfweni; khulula; colela; 
exempted	khulula; colelwe; khishwe emtsetfweni; 
exemption	kukhululwa; kukhishwa emtsetfweni;  kucolelwa; 
exemptions	kukhululwa;  kukhishwa emtsetfweni;  kucolelwa; 
exercise	 sebenta;  kutivivinya; umsebenti;  kutivocavoca;  -tivocavoce; 
exercised	 sebenta;  kusebentisa;  kutivivinya; umsebenti;  kutivocavoca;  -tivocavoce; 
exercises	 kushukumisa umtimba; imisebenti;  kutivocavoca; 
exercising	 kwenta umsebenti; kutivocavoca; kwenta umshukumo;  kushukuma; 
exhibition	umbukiso; 
exhibitions	imibukiso; 
exile	kudzingiswa; 
exist	phila; 
existed	phila; 
existence	 kuba khona; kuphila; 
existing	kuba khona; 
exists	phila; 
exit	kuphuma; 
expand	khulisa; 
expanded	khukhumuka; khula; 
expanding	 khulisa;  khula; khulisa; Khukhumuka; 
expansion	kukhulisa;  kwandza; 
expect	lindzela; 
expectation	lokulindzelekile;  kulindzela; 
expectations	lokulindzelekile;  kulindzela; 
expected	-lindzelwe; 
expedient	 zuzisako; fanelekile; 
expenditure	tindleko;  imali lesebentile; 
expense	tindleko; 
expenses	tindleko; 
expensive	-bitako; 
experience	lwati;  tfola lwati ngekutsintsana;  kuba nelwati; 
experienced	 kuhlangabetana nalokutsite;  kuba nelwati; kuba nesipiliyoni; 
experiences	tipiliyoni; 
experiencing	 tfola sipiliyoni; kutfola sipiliyoni; 
expertise	lwati lwebuciko; emakhono; 
experts	tati; 
expiration	kuphefumulela ngaphandle; 
expired	phelelwe sikhatsi; 
expiry	kuphelelwa sikhatsi; 
explain	chaza; 
explained	-chaziwe; 
explains	chaza; 
explanation	inchazelo; 
explanatory	inchazelo; 
explicit	cacicile; 
exploitation	kusetjentiswa ngalokungafanele; kusetjetiswa kabi; kusebentisa kabi; 
explore	 cwaninga; hlola;  hlola live; 
explored	kutfolisisa ngalokutsite; -cwaningiwe;  -hlolisisiwe; 
explores	tfolisisa;  hlolisisa; 
exploring	kucwaninga;  kutfolisisa; 
expo	umbukiso; 
export	 kutfumela; tfumela; 
exports	tekuhweba letitfunyelwako; 
expose	ngenisa; khiphela ebaleni; 
exposed	kubeka ebaleni; khishelwe ebaleni; 
exposure	kuba sebaleni; 
express	shano;  vakalisa; 
expressed	kukhuluma;  shano; -vakalise; 
expression	 sibonakaliso; kuveta;  sibalo; 
expressions	tinkhulumo; 
expressly	ngalokukhanyako; 
extend	 khulisa; yelula; 
extended	-khulisiwe;  -lulilwe; 
extending	 -elula; khulisa; 
extends	 -elula; khulisa; 
extension	sichibelo;  lokweluliwe; selulo; 
extensive	selulo sesilandziso; khulu; 
extent	lizinga lelitsite; 
external	kwangaphandle;  -ngaphandle; 
extra	 -ngetulu; lingetulu; 
extract	sicashunwa;  kukhipha litinyo;  lokukhishiwe; 
extraordinary	lokungakavami; 
extreme	lokwendlulele; -engcile; 
extremely	ngalokwendlulele; 
eye	 imbobo yenyalitsi; liso; 
eyes	emehlo; 
face	buso;  licele;  ebusweni bemhlaba; 
faced	buka;  -bukana;  bukene; 
faces	buso; 
facie	kubona kwekucala; 
facilitate	 lekelela; -enta kube lula; 
facilitated	 lekelela; -enta kube lula; chuba; 
facilitates	 lekelela; -enta kube lula; chuba; 
facilitating	-chuba;  sita;  chuba; 
facilitation	 kwenta kube lula; kuchuba; 
facilities	lokulekelelako; 
facility	insita; 
facing	kubukana; 
facsimile	ikhophi; 
fact	liciniso; 
factor	 imbangela; sizatfu; 
factors	 timbangela; tizatfu;  emafektha; tiphindzi; 
factory	imboni; 
facts	emaciniso; 
fail	hluleka; ngaphumeleli; 
failed	-kangaphumeleli;  hlulekile; 
failing	 kungaphumeleli; kwehluleka; 
fails	 kungaphumeleli; kwehluleka; 
failure	kwehluleka; 
failures	kwehluleka; 
fair	-pholile; kufanele;  kukahle;  -linganako; 
fairly	ngalokucotfo; kahle; 
fairness	bucotfo; 
faith	inkholo; 
fall	kuwa;  wani; 
fallen	wile; 
falling	kuwa; kwehla; 
falls	kuwa; 
familiar	-tayelekile; 
families	imindeni; 
family	umndeni; 
famous	-dvumile; 
fans	balandzeli; 
far	khashane; 
farewell	hamba kahle;  kuvalelisa; 
farm	lipulazi;  lima; 
farmer	umlimi; 
farmers	balimi; 
farming	kulima; 
farms	emapulazi; 
fast	tila; 
faster	masinyane kakhudlwana; 
father	babe; 
fathers	bobabe; 
fault	liphutsa;  siphosiso;  enta liphutsa; 
favorite	 intsandvokati; -tsandvwako; 
favour	umusa; 
favourable	tsandzekako; 
fax	ifeksi; 
faxed	ifeksi; 
fear	kwesaba; 
fears	kwesaba; 
feasibility	kwenteka; 
feature	luphawu;  letihamba embili; 
featured	fakiwe; ifakiwe; 
features	 timphawu; imibhalo; 
featuring	kukhombisa; 
federal	inhlangano yemave; 
federation	inhlanganisela; 
fee	imali;  inkhokhelo; 
feed	funta;  ondla; 
feedback	umbiko; 
feeds	kudla; 
feel	vani; iva; 
fees	timali; 
fell	wile; 
fellow	wakitsi; 
felt	vile; 
female	 lokusikati; umfati;  busikati;  -sikati; 
females	labasikati; 
festival	sibhimbi; 
festivals	tibhimbi; 
festive	umkhosi; 
fever	kushisa kwemtimba;  imfiva; 
few	-mbalwa; 
fewer	ncane; 
field	sibaya;  insimu; 
fields	imikhakha;  emasimu; 
fifth	kwesihlanu; 
fifty	emashumi lasihlanu; 
fight	kulwa; 
fighter	silwi; 
fighters	tilwi; 
fighting	kulwa; 
file	umlalati; 
filed	lola; 
files	emafayela; 
filing	 kulola; kufaka; 
fill	gcwalisa; 
filled	gcwalisiwe; 
film	lifilimu; 
filmmakers	bentimafilimu; 
filmmaking	kwenta emafilimu; 
films	emafilimu; 
final	umdlalo wemancamu; 
finalisation	kuphetsa; 
finalise	phetsa; 
finalised	phetsiwe; 
finalising	phetsa; 
finally	ekugcineni; 
finance	tetimali;  nika imali; 
financed	tetimali;  nika imali; 
finances	timali;  tetimali; 
financial	kwetimali; 
financially	ngekwetimali; 
financing	tetimali;  nika imali; 
find	tfola; 
finding	lokutfolakele; 
findings	lokutfolakele; 
finds	lokutfoliwe; 
fine	inhlawulo;  -busheleleti; 
fines	inhlawulo;  tinhlawulo; hlawula; 
finest	-busheleleti kakhulu;  kuhle kakhulu; 
fingerprints	sinyatseliso; 
fire	 mlilo; umlilo;  kusha; 
firearm	sibhamu; 
firearms	tibhamu; 
firmly	cinile; 
firms	-cinile; 
first	nginike kucala; 
firstly	kwekucala; 
fiscal	-phatselene nentsela;  -kwentsela; 
fish	inhlanti; 
fishing	kudoba; 
fit	-semphilweni lekahle; 
fitting	faka;  kala; 
five	sihlanu; 
five-year	iminyaka lesihlanu; 
fixed	lungisiwe; 
flag	 ifulegi; umjeko; 
flags	 imijeka; emafulegi; 
flagship	 umkhumbi wandvunankhulu; lokubalulekile; 
flame	lilangabi; 
flexibility	kutsamba;  kugobeka; 
flood	 khukhula; tikhukhula; 
floods	tikhukhula;  zamcolo; 
floor	 liphasi;  siyilo; sitezi; 
flora	 timila luhlata; titjalo; 
flow	kugeleta; 
flows	kugeleta; 
fly	imphungane;  ndiza; 
flying	kundiza; 
focus	bhekisa;  nakisisa; 
focused	kugcila;  -gcila; 
focuses	 nakisisa; gcila; 
focusing	-nakisisa;  nakisisa; kunaka; 
follow	landzela; 
followed	landzelwa; 
following	-landzelako; 
follows	landzela; 
food	kudla; 
foot	lunyawo; 
football	libhola; 
footsteps	tinyatselo; 
for	kwa-; 
force	 umfutfo; emandla;  cindzetela; 
forced	cindzetelwe; 
forces	 imifutfo; emandla;  cindzetela; 
forebears	labahamba embili; 
forefront	embili; 
foreign	-ngaphandle; 
foreigner	 umuntfu wangaphandle; umchamuki; 
foreigners	bachamuki;  bantfu bangaphandle; 
forensic	kuhlolwa kwelwati; 
forest	lihlatsi; 
forestry	kuhlanyelwa kwemahlatsi; 
forests	emahlatsi; 
forever	kute kube ngunaphakadze; 
forfeited	lahlekelwa; 
forfeiture	kwemukwa; 
forged	ntjontja;  fula; 
forget	khohlwa; 
form	simo;  libhentji;  lifomu;  bumba;  kwakheka; 
formal	hlelekile; -semtsetfweni; 
formally	ngalokuhlelekile; 
format	kuhleleka; 
formation	 kuhleleka kwebadlali;  kwakheka; kwakhiwa; 
formations	kuhleleka kwebadansi;  kuhleleka kwebadlali;  kwakheka; kwakhiwa; 
formed	-kwakhiwa; -bunjwa; 
former	-ngembili; 
formerly	ngalokuhlelekile; 
forms	bobunjwa; 
formula	ifomula;  umtsetfo lofinyetiwe; 
formulation	kwakha; 
forth	kune; 
forthcoming	lokutako; 
forthwith	masinyane; ngekungacitsi sikhatsi;  ngekushesha; 
forum	umhlangano; 
forums	imihlangano; 
forward	embili; 
forwarded	chutjelwe embili;  tfunyelwe; 
fossil	ematsambo lasagucuka ematje; insalela; 
foster	khutsata; 
fostering	kukhutsata; 
fought	kulwa; 
found	sungula; 
foundation	sisekelo; 
foundations	tisekelo; 
founded	-sungulwa; tfolakele; 
founder	umcambi; 
founding	 sungula; kutfola; 
four	kune; 
fourth	 kune; kwesine; 
frame	luhlaka; 
framework	luhlaka; 
frameworks	tinhlaka; 
franchise	 lilungelo lekukhetsa; lilungelo lekuhweba; 
fraternity	licembu; umkhakha webungcweti; 
fraud	 kukhwabanisa; inkhohlakalo; 
fraudulent	kukhwabanisa; -kukhwabanisa; 
free	khululekile; 
freed	khululiwe; 
freedom	inkhululeko;  kuhamba ngekukhululeka; 
freedoms	tinkhululeko; 
freely	ngekukhululeka; 
freight	lifulaha; 
fresh	kusha; 
friend	umngani; 
friendly	nemusa; 
friends	bangani; 
friendship	bungani; 
from	kubuya ku-; 
front	lingembili;  umsinga; 
fruit	 sitselo; titselo; 
fruitful	mphumelelo;  phumelele; 
fuel	emafutsa;  kwekubasa; 
fuels	emafutsa;  basela; 
fulfil	fezekisa; phumelelisa; 
fulfill	fezekisa; phumelelisa; 
fulfilling	fezekisa; phumelelisa; 
full	-gcwele; 
full-time	 ngaso sonkhe sikhatsi; ngalokuphelele; 
fully	ngalokuphelele; 
function	 sebenta; umsebenti; 
functional	kuyasebenta; 
functionality	kusebenta; 
functioning	 kumela inombolo; kusebenta; 
functions	imisebenti; 
fund	sikhwama; 
fundamental	sisekelo; 
fundamentally	balulekile; 
funded	kusitwa ngetimali; 
funding	kusita ngetimali; 
funds	timali; 
funeral	umngcwabo; 
furnish	 faka ifenisha; nika; 
furnished	 fakwe ifenisha; nikile; 
furniture	ifenisha; 
further	chubekako; 
furthermore	lokunye;  ngetulu kwaloko; 
future	 sikhatsi lesitako lesiyakufika; likusasa; 
gain	 zuza; imbuyiselo; 
gained	tfola;  zuza; 
gains	timbuyiselo; tinzuzo; 
galleries	emagalari; takhiwo sekukhombisa ngebuciko; 
gamble	kugembula; 
gambling	kugembula; 
game	 tinyamatane; umdlalo; 
games	 imidlalo yekuphindzaphindza nekwehlukanisa;  imidlalo yekuhlanganisa;  umdlalo; imidlalo; 
gap	ligebe; 
gaps	emagebe; 
garden	ingadze; 
gardens	tingadze; 
garnishee	kukhokha sikweleti ngekuyalelwa yinkantolo; 
gas	 igesi; umoya; 
gateway	lisango; 
gather	gcogca; coca; butsana;  hlanganisa; 
gathered	cociwe;  hlanganisiwe; butsa;  gcogciwe; 
gathering	 kugcogca;  kucoca; kuhlanganisa; 
gave	phile; 
gazette	igazethi; 
gear	ligiya; 
geared	kufaka umfutfo; 
gender	bulili; 
gender-based	kwebulili; 
general	jenene; 
generally	ngalokwetayelekile;  ngalokuvamile; 
generate	phehla; 
generated	phehla; 
generating	phehla; 
generation	 kuphehla; situkulwane;  tintsanga; 
generations	titukulwane; 
genre	luhlobo; 
genres	tinhlobo tembhalo; 
gentlemen	emajaha; 
geographic	ngekuma kwelive; 
geographical	kwesimo sendzawo; kuma kwelive; 
geography	telive; 
get	tfolakele; 
gets	tfolakele; 
getting	kutfola; 
giant	lizimu;  sichwaga; 
gift	siphiwo; 
girl	intfombatane; 
girls	emantfombatana; 
give	phani; 
given	phiwe; kuniketiwe; 
gives	phani; 
giving	kupha; 
glad	tfokotile; jabulile; 
glass	ingilazi; 
global	-kwemhlaba; mhlaba wonkhe; 
globally	mhlaba wonkhe; 
globe	umhlaba; 
glory	ludvumo; 
go	hamba; 
goal	inhloso;  ligoli;  injongo; 
goals	 tinjongo;  emagoli; tinhloso; 
goes	hamba; 
going	hamba; 
gold	igolide; 
golden	kuligolide;  sagolide; 
gone	hambile; 
good	kuhleleka; 
goods	 imikhicito;  timphahla; umtfwalo; 
gore	hlaba; 
gospel	 umculo wetenkholo; umculo wenkholo; 
got	tfolile; 
govern	busa; 
governance	kwengamela; 
governed	busa; 
governing	 kwengamela;  kubusa; kuphatsa; 
government	hulumende; 
government's	kwahulumende; 
governments	bohulumende; 
governor	umbusi; umphatsi wembuso; 
governors	baphatsi bembuso;  babusi; 
grace	umusa; 
grade	 libanga; lizinga;  luhlobo; 
grades	 emazinga;  imikhakha; tinhlobo;  emabanga; 
grading	nika limaki; hlukanisa; 
gradually	-ngekuya ngekuya; 
graduate	-tfola ticu; 
graduates	tifundziswa;  -labatfole ticu; 
grand	ngalokucotfo; kahle; 
grant	 imali yesibonelelo; sabelo; 
granted	 nikwa; sabelo; 
granting	kunika imvume;  imali yesibonelelo; 
grants	timali tesibonelelo; 
graphic	 umdvwebo; sitfombe; 
grass	tjani; 
grassroots	 umnyombo; ekucaleni; 
grateful	kubonga; 
gratitude	kubonga; 
grave	lidliza; 
graves	emadliza; 
great	khulu; 
greater	khudlwana; 
greatest	khulu kakhulu; 
greatly	khulu kakhulu; 
green	luhlata;  -luhlata; 
greenhouse	indlu yekukhulisa titjalo; indlu yetitjalo tasendlini; 
greetings	kubingelela; 
grew	khulu;  khula; mila; 
ground	 -kugaya; kusila; 
ground-breaking	kwesimanje; kuvulindlela; 
groundbreaking	kwesimanje; kuvulindlela; 
grounds	emabala; 
group	licembu;  butsanisa; 
groups	emacembu; 
grow	lima;  khula; 
growing	khula; 
grown	linywa; khula; 
growth	kukhula; 
guarantee	sicinisekiso; 
guaranteed	 cinisekiwe; cinisekile; 
guarantees	ticinisekiso; 
guard	mahlalesangweni; 
guardian	umondli; 
guest	sivakashi; 
guests	tivakashi; 
guidance	kuhola; 
guide	 condzisa; umholi; 
guided	-condzisiwe; umholi;  hola; 
guideline	inkhombandlela; 
guidelines	tinkhombandlela; 
guides	tinkhombandlela; 
guiding	 kukhomba indlela; ikhombandlela; kucondzisa; 
guilt	satelo;  kuba nelicala; 
gun	sibhamu; 
hail	sangcotfo; 
hailed	kugcoba ngesangcotfo; 
hails	tangcotfo; 
half	ihhafu;  sigamu; 
hall	lihhola; 
hand	 lutsi; sandla; 
handed	-niketa; 
handing	kuniketa; 
handle	sibambo sesikhwama; 
handled	phatfwa; 
handling	kuphatsa; 
handover	kwendlulisa;  ndlulisa; 
hands	tandla; 
happen	enteka; 
happened	entekile; 
happening	enteka; 
happens	enteka; 
happy	-jabula; 
harassment	hlupha; kugcagcalata; 
hard	cinile; lukhuni; 
hare	logwaja;  chakijane; 
harm	kulimata; 
harmful	-nengoti; 
harmony	luvano; 
has	kunako;  unako; 
hatred	 intondvo; inzondo; 
have	nginako; 
having	kubanako; 
hazardous	-nebungoti; kunengoti; 
he	yena; 
head	inhloko; 
headed	shaya ngenhloko;  kuhamba; 
heading	sihloko; 
headline	sihloko sendzaba; 
headlines	tsihloko tetindzaba; 
heads	tinhloko; 
heal	-elulama; 
healing	kwelapha; 
health	imphilo; 
healthcare	kunakekela ngetemphilo; 
healthy	-philile; 
hear	vani; 
heard	vile; 
hearing	kuva;  kutsetfwa kwelicala; 
hearings	 kulalelwa kweluvo; kuva; kutsetfwa kwemacala; 
hears	uyeva; 
heart	 enkhabeni; inhlitiyo; 
hectares	emahektha; 
height	budze; 
heights	budze;  kuphakama; 
held	-banjiwe; 
help	sita; lusito; 
helped	sitile; 
helping	sita; libindza; 
helps	sita; 
hence	kungako; 
her	yena; 
heraldry	kwakhiwa kwetiphandla; 
here	lapha; 
hereby	 ngalamavi; ngaloku; 
hereinafter	ngemuva kwaloko; 
heritage	lifa;  emagugu; 
hero	lichawe; 
heroes	emachawe; 
heroines	emachawekati; 
herself	yena ngekwakhe; 
hi	sawubona; 
hidden	-fihliwe; 
hide	sikhumba; 
hierarchies	kulandzelana kwetigaba; 
high	phakeme; 
high-level	lizinga leliphakeme; 
higher	etulu kakhulu; 
highest	phakeme kakhulu; 
highlight	lokugcamile; 
highlighted	gcamisile; 
highlights	lokugcamile; 
highly	etulu kakhulu; 
hill	ligcuma; 
hills	emagcuma; 
him	yena; 
himself	yena ngekwakhe; 
his	kwakhe; 
historians	tatimlandvo; 
historic	umlandvo; 
historical	kwemlandvo; 
historically	ngekwemalndvo; 
histories	imilandvo; 
history	umlandvo; 
hit	shaya; 
holder	kwekuphatsa; 
holders	kwekuphatsa; 
holding	kubamba; 
holdings	tindzawo; emaploti; 
holds	cukatsa; 
holidays	emaholidi; 
holistic	ngalokuphelele; 
homage	inkonzo; 
home	likhaya;  umuti; 
homelessness	kubate likhaya; 
homepage	likhasi lelikhaya; 
homes	emakhaya;  imiti; 
hominid	umndeni wetilwane letimunyisako; 
honorary	sicu setemfundvo sekuphiwa; 
honour	bonga; hlonipha; 
honourable	hloniphekile; 
honoured	honishwa; 
honouring	bonga; hlonipha; 
honours	sicu setemfundvo; 
hope	litsemba; 
hoped	kwetsemba; 
hopefully	kwetsemba; 
hopes	ematsemba; 
hospital	sibhedlela; 
hospitality	kuphatsa kahle bantfu; 
hospitals	tibhedlela; 
host	longenisa tivakashi; 
hosted	 ngenisile; -emukela; -ngenisile; 
hosting	kwemukela;  kungenisa;  ngenisa; 
hosts	 bavakashelwa; labangenisa tivakashi; 
hotels	emahhotela; 
hour	li-awa; 
hours	ema-awa; 
house	indlu; 
housed	kuhlalisa; 
household	 kwasendlini; umndeni; 
households	emakhaya;  imindeni; 
houses	tindlu; 
housing	 kwakhiwa kwemakhaya;  tetindlu; indlu; 
how	njani;  kanjani; 
however	nanoma kunjalo; 
http	i-http; 
https	ema-http; 
hub	lapho kubutsene khona konkhe lokubalulekile;  lokusekhatsi esondvweni; 
huge	khulu; 
human	umuntfu;  -muntfu;  kwebuntfu; 
humane	 sihawu; umusa; 
humanities	sifundvo ngebantfu; 
humanity	buntfu;  sintfu; 
humankind	umuntfu; 
humans	bantfu; 
humble	kutitfoba;  kutfobeka; 
humbled	tfobeka;  tfobekile; 
humility	kutitfoba; 
hundred	likhulu; 
hundreds	emakhulu; 
husband	indvodza; 
iconic	luphawu; 
icons	timphawu; 
idea	umcabango; 
ideal	inhloso lephakeme; 
ideals	lokufanele; 
ideas	imicabango; 
identification	kubona ngelufuto; 
identified	tfoliwe; -khonjiwe; 
identifies	 tfolakele; khomba; 
identify	tfolakele; khomba; 
identifying	 tfolakele; khomba; 
identities	kutatisa; 
identity	buwena; 
if	nangabe; 
ill	gula; 
illiteracy	kungakwati kubhala nekufundza; kungakwati kufundza nekubhala; 
illness	sifo;  kugula; 
illustrate	khombisa;  bonisa; 
illustrated	-khombisile; -bonisiwe; 
image	umfanekiso; 
images	imifanekiso; 
imagination	umcabango; 
imbalances	kulalingani; 
immediate	kwanyalo; masinyane; ngekungacitsi sikhatsi;  ngekushesha; 
immediately	masinyane; 
immense	-khulu kakhulu; 
immensely	kakhulu; 
immigration	kufika;  kutfutsa; 
imminent	dvute kakhulu; 
immovable	akuhambi; akususwa; 
immunisation	kugoma; 
impact	 imphumela; umtselela; lifutse; 
impacts	imiphumela. Imitselela; emafutse; 
impaired	 nciphisa emandla; ona; 
impediments	tihibe; 
imperative	 lokufunekako; sibopho; lephocelelako; 
imperatives	lokuphocelelako;  lokufunekako; sibopho; 
implement	 enta;  sisetjentiswa; kwenta; 
implementation	kuphumelelisa; 
implemented	-phunyelelisiwe;  phunyelelisiwe; 
implementing	kuphumelelisa; 
implements	 enta;  sisetjentiswa; kwenta; 
implications	lokucatjangwako; 
implies	lokushiwoko; 
import	kungenisa eveni;  tsenga kulamanye emave;  lokutsengwa kulamanye emave; 
importance	kubaluleka; 
important	-balulekile; 
importantly	lokubalulekile; 
imported	kungenisa eveni;  tsenga kulamanye emave;  lokutsengwa kulamanye emave; 
importer	longenisa eveni; 
impose	gidlibeta; 
imposed	bangela veta;  gidlibetiwe; 
imposing	bangela; veta; 
imposition	beka; 
impossible	angeke kwenteke; -khoneki; 
impressed	 cindzetelwe; chazekile; 
impressive	chazana; 
imprison	bopha; 
imprisoned	-boshiwe;  valelwe; 
imprisonment	kuboshwa; 
improper	akusikahle; 
improve	yenta ncono; 
improved	yenta ncono; 
improvement	buncono; 
improvements	buncono; 
improving	kuba ncono; 
in	ngekhatsi; e-; 
inability	kungakhoni; 
inadequate	akweneli; 
inappropriate	akusikahle; 
inaugural	kuvula; 
inauguration	kubekwa esikhundleni; 
incapable	 kungabi nelikhono; kungakhoni; 
incapacity	kungabi nemandla; 
incarceration	kuvalelwa ejele; 
incentives	tikhutsato; 
inception	kucala kwentfo; 
incidence	sehlakalo; 
incident	sehlakalo; 
incidental	-ngengoti; 
incidents	sehlakalo; 
include	faka;  faka ekhatsi; 
included	fakwe ekhatsi;  -fakwe ekhatsi; 
includes	kufaka ekhatsi; 
including	-phetse; 
inclusion	kufakwa; 
inclusive	kufaka konkhe ekhatsi; 
inclusivity	kufaka konkhe ekhatsi; 
income	 imali lengenako; liholo; 
incomes	 timali letingenako; imiholo; 
incomplete	ngaphelele; 
incorporate	faka; 
incorporated	faka; 
incorporates	faka; 
incorporation	kufaka ekhatsi; 
incorrect	-neliphutsa; 
increase	kwengeta;  khulisa;  yandzisa; 
increased	 yandzisiwe; khulisiwe; ngetiwe; 
increases	kwengeta;  khulisa;  yandzisa; 
increasing	kwengeta;  khulisa;  yandzisa; 
increasingly	ngalokukhulako; 
inculcate	julisa; 
incur	kubanga; 
incurred	tfoliwe; 
indaba	umhlangano; 
indeed	mbamba; 
independence	inkhululeko;  kutiphatsa; 
independent	-tiphetse; 
independently	ngekutimela; 
index	inkhomba; 
indicate	khombisa;  khomba; 
indicated	khombisile; 
indicates	khombisa;  khomba; 
indicating	khombisa;  kukhomba; 
indication	sikhombiso;  inkhomba; 
indications	 tinkhomba; kukhombisa; 
indicative	kukhombisa; 
indicator	lokukhombako;  sikhombisi; 
indicators	 tikhomba; tinkhomba; 
indices	tinkhomba; 
indigenous	 -kwendzabuko; kwendzabuko; 
indirectly	ngalokungakacondzi ngco; 
individual	 -ngamunye; kunye; 
individually	ngamunye; 
individuals	 kunye; bantfu; 
industrial	kwemsebenti;  kwemabhizinisi; 
industries	timboni; 
industry	 imboni; umsebenti; 
inequalities	kungalingani; 
inequality	kungalingani; 
infected	-nemagciwane engatini; 
infection	 kungenwa lufu;  kutselela; lufu; 
infections	 kungenwa lufu;  kutselela; imihabulo; lufu; 
inferior	-phansi;  kuba phasi; 
inflation	kwehla nekwenyuka kwetimali; kukhula kwentsengo; 
inflows	 lokungenako; kungena; 
influence	 funta; funta ngekwengcondvo;  kufaka umoya; 
influenced	faka umtselela;  kufaka umoya; 
info	lwatiso; 
inform	atisa; 
information	lwati;  imininingwane;  umbiko; 
informed	kwatiswa;  bhadlile; 
informing	atisa; 
inherent	ngemvelo yakho; 
inherit	 tfola lifa; -dla lifa; 
inherited	 tfola lifa; kudla lifa; 
initial	kucala; 
initially	ekucaleni; 
initiate	ngenisa; phemba; cala; 
initiated	 phemba; kwenta umtamo; cala ; 
initiative	kusungula;  umtamo;  kutentela; 
initiatives	imitamo; 
initiator	umsunguli; umphembi; 
injuries	kulimala; 
injury	 silondza; kulimala; 
injustice	lokuphambene nebulungiswa;  kungabi nebulungiswa; 
injustices	kungaphattfwa ngebulungiswa; lokuphambene nebulungiswa;  kungabi nebulungiswa; 
inmates	tiboshwa; 
inner	ngekhatsi; 
innovation	lokusha; kutisungulela; 
innovative	lokusha; 
input	lokufakwako;  funta lwati; 
inputs	 lokufakwako; emagalelo; 
inquest	kuphenywa kwendzaba yekufa; luphenyo ngekufa; 
inquiry	kuphenya; 
inscribed	bhaliwe; 
insert	faka;  ngenisa; 
inserted	faka;  ngenisa; 
insertion	kufaka; 
inserts	lokufakiwe; 
inside	ekhatsi; 
insight	kwati kabanti; 
insights	kwati kabanti; 
insolvency	kushayeka;  kubate imali; 
insolvent	kushayeka; 
inspect	 -hlola; hlola; 
inspection	kuhlola; 
inspections	kuhlola; 
inspector	umhloli; 
inspectorate	bahloli; kuhlola; 
inspectors	bahloli; 
inspiration	kukhutsata;  lusinga lugcozi; 
inspire	 shisekela; funa; 
inspired	shisekela; 
inspiring	shisekela; 
install	faka; 
installation	kufaka; 
installed	faka; beka; 
instalment	sitolimende; 
instalments	kukhokha kancane kancane; titolimende;  sitolomenthi; 
instead	esikhundleni; 
institute	inhlangano; 
instituted	ngenisa; 
institution	inhlangano; 
institutional	kwesikhungo; 
institutions	tinhlangano; 
instruction	umyalo;  sicondziso;  imfundziso; 
instructional	 ngekufundzisa; Kuyafundzisa; 
instructions	 ticondziso; imiyalo; 
instrument	 insita; sisetjentiswa;  intfo yekusebenta;  lithulusi; 
instruments	 emathulusi;  tingubhu; tisetjentiswa; 
insurance	umshwalensi; 
insurer	 umgcinimshwalensi; umcinisekisi; 
intangible	ngakucuki; 
integral	-hlangene; phelelisako; lokudzingekako; 
integrate	hlanganisa; 
integrated	-hlanganisile; 
integration	kuhlanganisa; 
integrity	bucotfo; 
intellectual	 umuntfu lonengcondvo;  hlakaniphile; kwengcondvo; 
intellectuals	labahlakaniphile;  labanengcondvo; 
intelligence	buhlakani;  kuhlakanipha; 
intend	condza; 
intended	condza; 
intends	condza; 
intensify	 kushibisa; kucinisa; 
intensive	kwentisisa;  shubile; cinile; 
intent	inhloso; 
intention	inhloso; 
intentionally	ngenhloso; 
inter	mbela; ngcwaba; 
interact	hlanganyela; 
interacting	kukhuluma; 
interaction	 kutsintsana; kuhlangana; 
interception	kucala kusebenta; kimiswa; 
interdepartmental	emkhatsini wematiko; 
interest	 tsandza;  intalo; kunaka; 
interested	 kuba nelisasasa; kufuna; 
interests	 tintalo; lisasasa; kunaka; 
interfaith	kuhlanga kwetinkholo; 
interfere	 faka lunyawo lwengulube; ngena ekhatsi; mosha; 
interference	 kufaka lunyawo lwengulube;  kungena ekhatsi; kumosha; 
intergenerational	emkhtaisni wetitukulwane; 
intergovernmental	emkhatsi wabohulumende; 
interim	kwesikhashana;  umkhatsi;  -kwesikhashana;  sikhashana; 
intermediaries	bohambamkhatsini; 
intermediary	kuhamba emkhatsini; 
intermediate	lokusemkhatsini; 
internal	 -ngekhatsi; ngekhatsi; 
international	kwemave emahlaba; kwemave ngemave; 
internationally	ngekwemave emhlaba; 
internet	i-inthenthi; 
interns	labafundzela umsebenti emasebentini; 
internship	luhlelo lwekucecesha; kufundzela umsebenti emsebentini; 
interpret	 humusha; bona; 
interpretation	umbono; 
interpreted	 humusha; bona; tolika; 
interrogate	kupheka ngemibuto; 
interval	 sitfutjana;  umkhatsi; likhefu; 
intervals	emakhefu;  ematfutjana; imikhatsi; 
intervene	kungena ekhatsi; 
intervention	kungena ekhatsi; 
interventions	kungena ekhatsi; 
interview	kubonana; 
interviews	ema-inthavyu;  tinkhulumoluhlolo;  tinhlolokhona; 
intestate	ngaphandle kwekwenta incwadzi yekwaba lifa; 
into	ekhatsi; 
introduce	 etfula; faka;  letsa;  yetfula;  atisa; 
introduced	faka;  letsa;  -tfula; -atisa;  yetfula; 
introducing	faka;  -etfula;  letsa;  yetfula;  atisa; 
introduction	singeniso; 
invalid	 kute emandla; akusebenti; 
invaluable	-ligugu; 
inventory	luhlu; 
invest	sisa; 
invested	-tjalile; 
investigate	 phenya; hlola; 
investigated	 phenya; hlola; 
investigating	 phenya; hlola; 
investigation	kuhlola;  luphenyo; 
investigations	kuphenya; timphenyo; 
investigative	kuyaphenyeka; 
investigator	umphenyi; umseshi; 
investigators	baseshi;  baphenyi; 
investing	-tjalile; 
investments	tintjalomali; 
investor	umtjalimali; 
investors	batjalimali; 
invitation	simemo; 
invite	mema; 
invited	 menyiwe; memile;  menywa; 
invites	mema; timemo; 
inviting	mema; 
involve	 faka ekhatsi; bandzakanya; 
involved	bandzakanyeka; 
involvement	kubandzakanyeka; 
involves	 kufaka ekhatsi; kubandzakanya; 
involving	 kufaka ekhatsi; kubandzakanya; 
iron	 ayina; insimbi; 
irregularities	lokungasiko; 
irregularity	lokungasiko; 
irrespective	kungabuki; kunganaki;  ngaphandle kwekubuka; 
irrigation	kunisela; 
is	u; 
isiXhosa	Sichosa; 
island	sihlenge; 
issue	ludzaba;  lokukhishwako; 
issued	-nikiwe; lokukhishwako;  -niketiwe; 
issues	tindzaba;  tinkinga; 
issuing	 kukhipha; kunika; 
it	kona; 
it's	kwako; kwe-; 
item	 liphuzu; intfo;  lilunga; 
items	tintfo;  emaphuzu; 
its	kona; 
itself	kona ngekwako; 
jewellery	bucwebe; 
job	umsebenti; 
jobs	imisebenti; 
join	hlanganisa; 
joined	-hlanganisiwe; 
joining	kuhlanganisa; 
joint	lilunga;  lijoyini; 
jointly	ngekuhlanganyela; 
journalism	buntsatseli; 
journalist	intsatseli; 
journalists	tintsatseli; 
journey	luhambo;  hamba; 
joy	injabulo; 
judge	 umehluleli; lijaji; 
judgement	sigwebo; 
judges	emajaji;  behluleli; 
judgment	sigwebo; 
judgments	tigwebo; 
judicial	temajaji; -kwehlulela; 
judiciary	betebulungiswa; 
junior	lijuniya; lomncane; 
jurisdiction	emandla esikhundla; 
jurisdictions	emandla esikhundla; 
juristic	kwemamandla esikhundla; 
just	nje; 
justice	bulungiswa;  kulunga; 
justified	lungisiwe;  sekwelwe; colelwe;  tsetselelwe; 
justify	 tsetselela; lungisa; beka tizatfu; 
keen	kuba nemdlandla; 
keep	gcina;  kugcine; beka; 
keeping	gcina; beka; 
kept	gcina; beka; 
key	 sikhiya; inkhomba;  khiya; 
keynote	umlayeto lobalulekile; 
kick	khahlela; 
kick-off	kucala kwemdlalo; 
kill	kubulala; 
killed	 bulele; -bulelwe; 
kilometre	likhilomitha; 
kilometres	emakhilomitha; 
kind	lunga; 
kindly	ngemusa; 
kinds	tinhlobo; 
king	silo; 
kingdom	umbuso lophetfwe yinkhosi; 
kings	tinkhosi; 
knew	kwati; 
know	kwati; 
knowing	kwati; 
knowingly	ngekwati; 
knowledge	lwati; 
known	atiwa; 
knows	yati; 
laboratories	emalabhorethri;  emalebhu; 
labour	 sebenta;  kubeleka;  umhelo; umsebenti; 
lack	 swela; kudzinga; 
ladies	bomake; 
laid	-talelwe;  bekiwe; 
lake	lichibi; 
land	 hlala;  umhlaba;  insimu; live; 
landfill	tindvundvuma; 
lands	 imihlaba; tiganga; 
landscape	kubukeka kwelive; 
language	lulwimi; 
languages	tilwimi; 
lapse	phela; 
large	-khulu; 
large-scale	ngalokubanti; 
largely	kakhulu; 
larger	-khulu kakhudlwana; 
largest	-khulu kakhulu; 
lasting	tsatsa sikhatsi lesidze kuphela; chubanako; 
lastly	kwekugcina; 
late	ngemuva kwesikhatsi; 
later	muva; 
latest	kwamuva kakhulu; 
latter	 lokushiwo kamuva; kwekugcina; kwamuva; 
laughter	luhleko; 
launched	-tfuliwe; 
launches	kwetfula; 
launching	kwetfula; 
laundering	kweba imali; 
laureate	umzuzi wemklomelo lobalulekile; 
laureates	bazuzi bemiklomelo lebalulekile; 
law	umtsetfo; 
law-making	kushaywa umtsetfo; 
lawful	lokusemtsetfweni; 
lawfully	ngekwemtsetfo; 
laws	imitsetfo; 
lawyer	ummeli; 
lawyers	bameli; 
lay	talela; 
laying	talela; 
lead	umtfofu; 
leader	umholi; 
leaders	baholi; 
leadership	buholi; 
leading	kuhola; 
leads	imitfofi; 
leaflet	licenjana; 
leaflets	emacenjana; 
league	inhlangano; 
learn	kufundza;  fundza; 
learned	fundzile; 
learner	umfundzi; 
learners	bafundzi; 
learning	kufundza; 
learnt	fundzile; 
lease	rentisa; 
leased	rentisile; 
leasehold	lorentako; 
least	lokuncane; 
leave	ilivi; 
leaves	emalivi; 
leaving	-hamba; 
lecture	fundzisa; 
led	hola; 
left	esandleni sesancele;  ngasesancele; 
leg	licele;  lunyawo;  umlente; 
legacies	imishiyandvuku; 
legal	-semtsetfweni; 
legally	ngekwemtsetfo; 
legend	insimi; 
legendary	sigayigayi; 
legends	tinsimi; 
legislation	umtsetfo;  kushaywa kwemtsetfo; 
legislative	kwemtsetfo; 
legislature	sishayamtsetfo; 
legislatures	tishayamtsetfo; 
legitimacy	kufaneleka; 
legitimate	kufanelekile;  kusemtsetfweni; 
lend	boleka; 
lending	kubolekisa; kuhlala phasi kwendizamshini; 
length	budze; 
lesser	lobolekisako; lorentisako;  umrentisi; 
lesson	sifundvo; 
lessons	tifundvo; 
let	enta; 
let's	enta; 
letter	 luhlavu; incwadzi; 
letters	tincwadzi; 
level	 bungako;  kuphakama; levela; 
levels	 linganisa; emazinga; 
levied	hlawulisa; 
levies	tinhlawulo; 
levy	umtsedlwana; 
liabilities	tikweleti; 
liability	lokucitsa imali; 
liable	fanela; 
liaise	 bonisana; khulumisana; 
liaison	kukhulumisana;  kubonisana; 
liberalisation	kukhululeka; 
liberation	kukhulula;  khulula; 
librarians	baphatsi bemalayibhrari;  bosomtapolwati; 
libraries	 imitapolwati; emalayibhrari;  emarekhodi; 
library	ilayibhrari;  ilayibhrari yemarekhodi; 
licence	ilayisensi; 
licences	emalayisensi; 
license	ilayisensi; 
licensed	 kuba nelayisensi; kuba nemvume; 
licensee	iyalisensi; 
licensees	emalayisensi; 
licensing	kunika imvume; 
lie	kuvundla kweluswane esiswini; 
lies	emanga; 
life	imphilo; 
lifetime	imphilo yonkhe; 
light	 kukhanya;  -lula; lula;  malula; 
lighting	kwekukhanyisa; 
like	 tsandza;  -njenga; njenge-; 
likely	kwenteka; 
limit	 sigcino; umkhawulo; 
limitation	kuba nemkhawulo; 
limitations	imikhawulo; 
limiting	sigcino;  kukhawulisa; 
limits	imikhawulo; 
line	umugca;  faka imfulo;  lilayini; 
line'	umugca;  lilayini; 
line-up	 kuhela;  kushaya luhlele; luhlelo; 
lines	imigca; 
linguistic	-phatselene nelulwimi; 
link	 chumanisa;  sichumanisi; kuhlanganisa; 
linkages	tichumanisi; 
linked	sichumanisi;  hlanganisile; chumanisile; 
linking	 chumanisa; kuchumanisa; 
links	kuchumana;  kuhlangana; 
liquid	lokusamanti;  luketjeti; 
liquidation	kukhokhwa kwetikweleti temuntfo lohlulekile kutikhipha; kuvalwa kwebhizinisi; 
liquidator	lokhokhisa tikweleti temuntfu losahlulekile kutikhipha; 
liquidity	kugucuka kube ngemanti; 
liquor	tjwala; 
list	luhlu; 
listed	bhaliwe; 
listen	lalela; 
listing	kwenta luhlu; 
lists	tinhlu;  yenta luhlu; 
literacy	kwati kufundza nekubhala; 
literally	njengobe kunjalo; 
literary	 kwetincwadzi letibhaliwe; kwemibhalo; 
literature	tembhalo; 
litigation	ummango; 
little	ncane; 
live	 -nemlilo; phila; 
lived	 -hlala; phila; 
livelihood	kutiphilisa; 
livelihoods	tindlela tekutiphilisa; kutiphilisa; 
lives	timphilo; 
livestock	imfuyo; 
living	kuphila; 
load-shedding	kwabelana gezi ngetikhawu; 
loan	sikweleti; 
loans	 timalimboleko; tikweleti; 
local	 -kwesigodzi; kwendzawo; 
locally	kwendzawo; 
locals	 -kwesigodzi; kwendzawo; 
located	 bekwa endzaweni; tfoliwe; beka endzaweni; 
location	 kuniketwa; indzawo;  lilokishi; 
lock-up	khiya; khiyela; 
lodge	hlala;  indzawo yekuhlala; 
lodged	fakiwe; khululiwe; 
lodging	kuhlala; 
logistics	 kuhleleka; lokudzingekako; 
long-term	sikhatsi lesidze; 
longer	-dze kakhudlwana;  sikhatsi lesidze; 
look	buka; 
looked	bukile; 
looking	buka; 
looks	 kubukeka; kubuka; 
loop	sihibe; 
lose	lahla; 
loss	 kulahlekelwa ekhulwini; kulahlekelwa; 
losses	 kulahlekelwa; kulahlekelwa; 
lost	-lahlekelwe; 
lot	nyenti; lizinga lemphilo; 
lottery	ilotho; 
love	tsandza; 
loved	tsandza; 
lovers	titsandzani; 
low	phasi; 
low-income	imali lengenako lencane; umholo lomcane; 
lower	ngaphasi; 
lowest	phasi kakhulu; 
lump	sigadla; 
machine	umshini; 
machinery	imishini; 
machines	imishini; 
macro-economic	umnotfo lomkhulu; 
macroeconomic	umnotfo lomkhulu; 
made	 -akhile; -enta; 
magazine	liphephabhuku; 
magazines	liphephabhuku;  emaphephabhuku; 
magisterial	kwemantji; 
magistrate	imantji; 
magistrate's	kwemantji; 
magistrates	bomantji; 
magnificent	kuhle kakhulu; 
magnitude	bukhulu; 
mail	 liposi; tfumela; 
main	lokukhulu; 
mainly	ikakhulu; 
mainstream	umkhakha lobanti; 
mainstreaming	kufaka emkhakheni lobanti; 
maintain	gcina; 
maintained	gcina; 
maintaining	-ondla; 
maintains	gcina; 
maintenance	 kugcinwa;  kunakekelwa; kunakekela; 
major	-khulu;  luhlu lolukhulu lwemanothi; 
majority	linyenti;  bukhulu ngemtsetfo;  linengi; 
make	 enta; luhlobo; 
makers	 labakhako; benti; 
makes	 -akha; tinhlobo; 
making	enta;  -akha; 
malaria	malaleveva; 
male	 -dvuna; lomdvuna; 
males	labadvuna; 
mall	imoli; 
man	indvodza; 
manage	phatsa; 
managed	 lawulile; phumelela; phatsa; 
management	 baphatsi; kuphatsa; 
manager	umphatsi; 
managers	baphatsi; 
manages	phumelela; phatsa; 
managing	phumelela; -kukhona; 
mandate	 ligunya lemandla; ligunya; 
mandated	-gunyatiwe; 
mandates	emagunya; 
mandatory	gunyatiwe; 
manifestations	kubonakalisa; 
manner	indlela; 
manual	-entiwa ngetandla;  incwadzi yekuchaza; 
manufacture	yenta; 
manufactured	yenta; khicita; 
manufacturing	kukhicita; 
manuscripts	 tincwadzi letisengakashicilelwa; emamanyuskripthi; 
many	-nyenti; 
map	libalave; 
mapping	 kwenta luklayo; kudvweba libalave; 
maps	emabalave; 
march	 masha;  shuca; umshuco; 
marched	 masha; imashi;  shuca; umshuco; 
margin	lusentse;  umphetfo; 
marginal	catjangwako; 
marginalised	bandlululwa; 
marginalized	bandlululwa; 
maritime	mayelana nekwaselandle; 
mark	luphawu;  umklomelo;  nika emamaki; 
marked	khonjiwe; 
market	 bahwebi; imakethe;  tsengisa; 
marketing	kutsengisa;  kuhweba; 
markets	timakethe;  timakethe; maketha;  tsengisa; 
marking	luphawu;  kuvala; 
marks	 emamaki;  imiklomelo; timphawu; beka timphawu; 
marriage	 kuteka; umshado; 
marriages	imishado; Imendvo;  imishado; 
married	Shadile;  -endzile; 
mass	 sicuku; sisindvo;  incumbi; 
massive	khulu kakhulu; 
master	umphatsi; 
master's	kwemphatsi; 
match	 fanana;  sipani; umdlalo;  kufanana;  umetjiso; 
matches	umetjiso; 
material	lutfo;  indvwangu; 
materially	ngekwentfo lephatsekako; 
materials	 tindvwangu; tintfo; 
maternal	phatselene neluhlangotsi lwekhabomake; 
mathematical	ngetibalo; 
mathematics	tibalo; 
matric	matikuletjeni; 
matrimonial	inkonzo yemshado; 
matter	lutfo;  bovu; 
matters	tindzaba;  tinkinga; 
maturity	 kuvutfwa; kukhula; 
maximise	kukhulisa;  yenta kube kukhulu; khulisa; 
maximum	bunyenti bekugcina;  -ngebunyenti bekugcina; 
may	Inkhwenkhweti; unga;  anga;  kunga; 
maybe	mhlawumbe; 
mayor	 sodolobha; imeya; 
mayors	baphatsimadolobha;  bosodolobha; 
me	mine; 
mean	-shokutsi; dzelela;  inombolomkhatsi; 
meaningful	kuneshokutsi; 
meaningfully	ngenshokutsi; 
meanings	tinshokutsini; 
means	kusho kutsi; 
meant	kusho kutsi;  kusho lokutsite; 
measure	 linganisa;  bungako; silinganiso; 
measured	kaliwe; 
measurement	silinganiso; 
measures	 linganisa;  bungako; tilinganiso; 
measuring	kukala; 
mechanical	 -mshini; -kwemshini; 
mechanism	kusebenta kwemshini;  kusebenta samshini; 
mechanisms	 kusebenta kwemshini; tindlela; 
media	betindzaba; 
mediation	sisombululo; sicatululo; 
medical	-kwelapha; 
medicine	umutsi; 
medicines	imitsi; 
medium	emathulusi; 
medium-term	ithemu lesemkhatsini; 
meet	hlangana; 
meeting	umhlangano; 
meetings	imihlangano; 
meets	hlangana; 
mega	lokukhulu; 
melting	ncibilika; kuncibilika; 
member	lilunga; 
member's	kwelilunga; 
members	emalunga; 
membership	bulunga; 
memorable	khumbulekako; 
memorandum	imemorandum; 
memorial	sikhumbuto; litje lesikhumbuto; 
memories	kukhumbula;  tinkhumbulo; 
memory	kukhumbula;  inkhumbulo; 
men	emadvodza; 
mental	 -kwenhloko;  -phatselene nengcondvo; ngenhloko;  -kwengcondvo; 
mentally	ngenhloko; ngekwengcondvo; 
mention	shano; 
mentioned	shiwo; shano; 
merchant	umhwebi; 
mere	 manje nje; kuphela; 
merely	 manje nje; kuphela; 
merger	kuhlanganiswa; 
merit	fanela; 
merits	kufanela; 
message	umbiko; 
messages	imibiko; 
messenger	sitfunywa; 
met	hlangene; 
metal	insimbi; 
metals	tinsimbi; 
method	indlela; 
methods	tindlelakwenta; tindlela; 
metro	khulu kakhulu; 
metropolitan	lidolobhakati; 
micro	ncane; 
middle	umkhatsi; 
midst	emkahstini; 
might	kungenteka; 
migration	kutfutsa; 
milestones	emagcatsi; 
military	 kwemphi; emasotja; 
milk	lubisi; 
millennium	umnyakankhulungwane; 
million	sigidzi; 
millions	tigidzi; 
mind	umcondvo;  ingcondvo; 
mindful	cabanga; 
minds	 tingcondvo; imicondvo; 
mine	gubha; 
mineral	lokumbiwa phansi emayini;  simbiwa; 
minerals	 lokumbiwa phansi emayini; timbiwa;  emaminerali; 
mines	 gubha; (i)mba; timayini; 
minimise	hlisa; nciphisa; 
minimum	buncane bekugcina; 
mining	tetimayini; 
minister	 indvuna yelitiko; umfundisi;  Ngcongcoshe; 
minister's	kwendvuna; 
ministerial	kwetindvuna; 
ministers	 tindvuna tematiko;  bafundisi; tindvuna; 
ministry	belitiko; 
minor	-semncane; 
minority	bumbalwa; 
minutes	emaminithi; 
misconduct	kutiphatsa kabi; 
misleading	kukhohlisa; 
missing	lokungekho; 
mission	umsebenti;  sibopho;  umsebenti lojutjiwe; 
missions	 imisebenti yekuhambisa livangeli; tibopho;  imisesebenti lelukhuni; 
mitigate	hlisa; nciphisa; 
mitigation	 kwehlisa; kunciphisa; 
mix	hlanganisa; 
mixed	hlanganisiwe; 
mobilisation	kugcogca; 
mobilise	nyakatisa; 
mobility	 hambako; kunyakata; 
model	sibonelo;  bumba;  siboniso; 
models	 imifanekiso;  kumodela; bakhangisimphahla; sibonelo; 
moderate	 likahle; lokwanele; 
modern	kwesimanje; 
modernisation	kwenta kube kwesmanje; 
modified	gucula; gucugucula; 
modify	gucula; 
moment	sikhashana; 
moments	tikhashana; 
momentum	emandla; umfutfo;  kukhula; 
monetary	imali; 
money	imali; 
moneys	timali; 
monies	timali; 
monitor	elusa; 
monitored	landzelela;  lusa; 
monitoring	landzelela;  kwelusa; 
monitors	emamonitha; elusa; 
month	inyanga; 
monthly	ngenyanga; 
months	tinyanga; 
monument	litje lesikhumbuto; 
monuments	ematje esikhumbuto; ematjesikhumbuto; 
moral	sifundvo; 
moreover	 ngetulu kwaloko; ikakhulu; 
morning	 kusa; ekuseni; 
mortality	bunyenti balabafako; kufa; 
mortgage	 sikwelti sendlu; kubanjiswa ngemphahla kute kukhokhwe sikweleti; 
most	linyenti; 
mostly	kakhulu; 
mother	make; 
mothers	bomake; 
motion	siphakamiso;  umnyakato; 
motions	tiphakamiso;  iminyakato; 
motivation	 kugcugcutela; kukhutsata; 
motto	sicubulo; 
mountain	intsaba; 
mountains	tintsaba; 
mounted	-sekelwe; 
mouth	umlomo; 
movable	hambisekako; hambako; 
move	 khweshisa; sinyatselo; 
moved	-sukile; khweshisile; 
movement	inhlangano;  umnyakato;  kuhamba; 
movements	tinhlangano;  imibutfo;  iminyakato; 
moves	tinyatselo; 
movie	lifilimu; 
moving	kughamba; 
much	kakhulu; 
multi-party	tinhlanganonyenti; 
multilateral	-mikhakhanyenti; 
multilingual	tilwiminyenti; 
multilingualism	bulwiminyenti; 
municipal	 kwelidolobha; masipala; 
municipalities	 bomasipalati; bomasipala; 
murals	lokwentiwe etibondzeni; 
murder	 kusontsa; kubulala; 
museum	umsamo;  imphalane; 
museums	imisamo; iminyuziyamu; 
music	umculo; 
musical	lifilimu lemculo; 
musician	umculi; 
musicians	baculi; 
must	fanele; 
mutandis	ngekuya kwetingucuko letifanele lesetentiwe; 
mutatis	ngekuya kwetingucuko letifanele lesetentiwe; 
mutual	bubili; 
mutually	bubili; 
my	kwami; 
myself	mine ngekwami; 
name	ligama;  yetsa; 
named	-shiwo; yetsa; 
namely	kutsiwa; lababo-; 
names	emagama; 
narrative	kulandzisa; 
narrow	kuncipha; 
natal	phatselene nekutalwa; 
nation	sive; 
nation-building	kwakha sive; 
national	-kwavelonkhe;  -sive; 
nationality	buve; 
nationally	ngekwavelonkhe; 
nationals	-sive;  bantfu bavelonkhe; 
nationhood	buve; kubumbana kwesive;  kuba munye kwesive; 
nations	tive; 
native	wemdzabu;  wekudzabuka; 
natural	 -mvelo; kwemvelo; 
nature	imvelo;  indalo; 
near	 dvutane; eceleni; 
nearest	dvutane kakhulu; 
nearly	cishe; 
necessarily	lokudzingekako; 
need	sidzingo;  dzinga; 
needed	tidzingo;  dzinga; 
needs	tidzingo;  dzinga; 
negative	 ngaphansi kwelicandza; kulandvula; 
negatively	ngalokungakhi; kabi; 
neglect	kunganaki;  yekelela; 
neglected	kunganaki;  yekelela; -nganaki; 
negligence	kuyekelela; 
negotiate	 bonisana; khulumisana; 
negotiated	 bonisana; khulumisana; 
negotiating	 bonisana; khulumisana; 
negotiation	tinkhulumo; 
negotiations	tinkhulumo tekubonisana; 
neighbouring	lokungumakhelwane; kwakhela; 
neither	hhayi; 
net	 linetha; imali lesele; 
networking	kuchumana; 
networks	 emanethiwekhi; Tinhleloluchumano; 
never	ngeke; 
nevertheless	nanoma kunjalo; 
new	lokusha; 
newly	kusha; 
news	tindzaba; 
newsletter	incwadzi yetindzaba; incwadzitindzaba; 
newsletters	tincwadzitindzaba; 
newspaper	liphephandzaba; 
newspapers	emaphephandzaba; 
newsroom	ligumbi letindzaba; 
next	-dvute; 
night	busuku; 
nine	imfica; 
no	cha; 
noble	kulunga;  kuba nesitfunti; 
nominal	 kwemabito; lokushiwo nje; 
nominated	khetsa; phakamisa; 
nomination	kwenyula; 
nominations	kukhetsa;  kuphakanyiswa; 
non	kute; 
non-compliance	kungahambisani; 
non-governmental	lokungesiko kwahulumende;  lokungekho ngaphasi kwahulumende; 
non-profit	akungenisi imali;  kute intalo; 
non-racial	kungabandlululi; 
non-racialism	kungahambisani nelubandlululo ngekwebuhlanga; 
non-refundable	akubuyiselwa imali; 
non-sexism	kungakhetsi ngebulili; 
non-sexist	kungakhetsi ngebulili; 
non-tax	kungakhokhiswa intsela; 
none	kute; 
nor	cha; 
norm	imihambo; 
normal	-sesimeni lesikahle; 
normally	ngalokwetayelekile;  ngalokuvamile; 
norms	 imihambo; tinchubo; 
north	ngasenyakatfo;  inyakatfo;  enyakatfo; 
northern	ngasenyakatfo; 
not	hhayi; 
notable	dvumile; 
notably	dvumile; 
note	 linothi;  caphela;  emanothi; bhala;  caphelisisa;  imali yeliphepha; 
noted	 timali temaphepha;  kwati;  yati;  emanothi; bhala;  caphelisisa; 
notes	emanotsi; 
nothing	lite; 
notice	bona;  kunaka;  satiso; 
notices	 tatiso; bona;  kunaka; 
notification	kwatisa; 
notified	kwatisa; 
notify	yatisa; 
noting	 caphelisisa;  yatisa; kubhala;  kucaphela;  kwenta emanothi; 
notion	umbono; 
notwithstanding	nanoma kunjalo; 
novel	inoveli; 
now	 manje nje; kuphela; 
nuclear	lokungekhatsi; 
null	 kuphelisiwe; kucedvwe emandla; 
number	 inamba;  sibalo; inombolo; 
numbers	tinombolo; 
numerous	nyenti;  -nyenti; 
nurse	 nesa;  umhlengikati; nesi; 
nurses	 nesa;  bahlengikati; emanesi; 
nursing	buhlengikati; 
nurture	 khulisa; nakekela; 
nurturing	kukhulisa;  kunakekela; 
nutrition	 kudla kudla lokunemsoco; kwekondla;  -kwekondla; 
oath	sifungo; 
object	 lutfo;  umentiwa; intfo;  phikisa; 
objection	kwala; 
objections	kwala; 
objective	inhloso;  -phatselene nendzikimba; 
objectives	-phatselene netindzikimba; tinhloso; 
objects	tintfo;  mentiwa;  phikisa; 
obligation	sibopho; 
obligations	tibopho; 
oblige	sibopho; 
obliged	 phocelelekile; bophelelekile; kubopheleleka; 
observatory	 kubukisisa; kunaka; 
observe	buka;  hlolisisa; 
observed	buka;  hlolisisa; 
obtain	tfola; 
obtained	tfola; 
obtaining	kutfola; 
obvious	-selubala; 
obviously	kusebaleni; 
occasion	 sehlakalo; umcimbi; 
occasions	tehlakalo;  imicimbi; 
occupation	 kutsatfwa; umsebenti;  kutfumba; 
occupational	umsebenti; 
occupied	hleli; hlala; 
occupy	tfumba; 
occur	kwentela; 
occurred	kwentekile; 
occurrence	sigameko; 
occurring	kwenteka; 
occurs	kwenta kube kwesmanje; 
ocean	lwandlekati; 
of	kwa-;  kwe-; 
off	onakele; kwa-; cedzela;  bolile;  kwe-; 
offence	licala; 
offences	emacala; 
offender	 lowente licala; lowonile; sephulamtsetfo; 
offenders	 labonile; tephulamtsetfo;  labente emacala; 
offer	lokunikwako; nikela; 
offered	nikiwe; nikela; 
offering	umnikelo; 
offerings	iminikelo; 
offers	nikela;  lokunikiwe; 
office	lihhovisi;  sikhundla; 
office-bearers	losesikhundleni; 
officer	sisebenti;  machuzu; 
officers	tisebenti;  bomachuzu; 
offices	tikhundla;  emahhovisi; 
official	sikhulu;  lonesikhundla;  kwembuso; 
officially	ngekwemtsetfo; 
officials	sisebenti;  tikhulu; 
offset	linganisa; 
offshore	kulamanye emave; 
often	vamile; 
old	-dzala; dzala; 
older	dzala kakhudlwana; -dzadla kakhudlwana; 
oldest	 -dzala kakhulu; dzala kakhulu; 
omission	lokweciwe; kweca; kushiya; 
omissions	lokweciwe; kushiya; 
on	ngetulu;  kusachubeka; 
on-going	 kuyachubeka; kuchubeka; 
once	kanye; 
once-off	kanye kuphela; 
one	kunye; 
ones	bokunye; 
ongoing	 kuyachubeka; kuchubeka; 
online	-phuma; 
only	kuphela; 
onto	kuko; 
open	vula; 
opened	vuliwe; vulile; 
opening	imbobo; 
opens	vula; 
operate	kuhlindza; 
operated	kuhlindza; 
operates	kuhlindza; 
operating	kuhlindza; 
operation	 kuhlindvwa;  kuhlindza;  kubala; umsebenti;  sento; 
operational	 kuyasebenta; kusebenta; 
operations	 kuhlindvwa;  kuhlindza;  kubala; imisebenti;  tento; 
operator	luphawu;  kwekuhambisa; kwekusebenta;  lohambisako;  losebentako; 
operators	 labahambisako; timphawu;  labasebentako; 
opinion	umbono; 
opinions	imibono; 
opportunities	ematfuba; 
opportunity	litfuba; 
oppose	phikisa; 
opposed	phikisa; 
opposite	lokuphikisako; 
opposition	 imbangi; kuphikisana;  emacembu laphikisako; 
oppressed	cindzetelekile; 
oppression	incindzetelo; 
oppressive	kucindzetela; 
optimal	lokusezingeni lelisetulu; 
optimism	kwetsemba; 
option	kukhetsa; 
options	kukhetsa; 
or	noma; 
oral	ngemlomo;  -kwemlomo; 
order	 umyalo;  oda; luhlelo;  li-oda;  kuhlela;  hlela;  kulandzelana; 
ordered	 yala;  oda; luhlelo;  li-oda;  kuhlela;  hlela;  kulandzelana; 
orders	 imiyalelo; tinhlelo; 
ordinance	 umtsetfo wamasipala; simiso; 
ordinarily	ngalokwetayelekile;  ngalokuvamile; 
ordinary	lokwetayelekile; 
organ	sitfo; 
organisation	inhlangano;  umbutsano; 
organisational	kwenhlangano; 
organisations	tinhlangano; 
organised	hlelekile; 
organisers	bahleli; 
organising	kuhlela; 
organization	inhlangano; 
organizations	tinhlangano; 
organized	 nhlelekile; hleliwe; 
organizers	bahleli; 
organs	titfo tekukhuluma; 
orientation	kucalisa; fundziswa; 
origin	 indzabuko; ekucaleni; 
original	kwendzabuko;  -ndzabuko; 
originally	ekucaleni; 
origins	tindzabuko; ekucaleni; 
other	lokunye; 
others	labanye; 
otherwise	 ngale kwaloko; ngaphadle kwaloko; 
ought	fanele; 
our	kwetfu; 
ours	kwetfu; 
ourselves	tsine ngekwetfu; 
out	ngaphandle;  phuma; 
outcome	umphumela; 
outcomes	imiphumela; 
outdoor	ngaphandle;  -ngaphandle; 
outgoing	loshiya sikhundla; 
outline	 bekisa; luhlaka;  umncele; 
outlined	 bekisa;  kubeka emabalengwe; kwenta umnyele; 
outlines	 bekisa; tihlaka; iminyele; 
outlook	kubukeka; 
output	umphumela; 
outputs	imiphumela; 
outreach	umsebenti wesihle; 
outside	ngaphandle;  lingaphandle;  lingephandle; 
outsourced	tsetfwe ngaphandle; 
outstanding	lokushodako; 
outward	ngaphandle; 
oval	-salicandza; 
over	ngetulu; 
overarching	lokubalulekile; 
overcome	ncoba; 
overcrowding	kugcwala; 
overseas	 ngesheya kwetilwandle; ngesheya; 
oversee	ngamela; 
overseeing	ngamela; 
oversight	ngamela; 
overview	sibutsetelo; 
overwhelming	ngamako; 
owed	kweletwa; 
owing	kweleta; 
own	kuba nentfo; 
owned	kuba kwalokutsite; 
owner	unini; umnikati; 
owners	banikati; 
ownership	bunikati; 
pace	sivinini; 
package	iphakheji; umgodla; 
packages	emaphakheji; imigodla; 
page	likhasi; 
pages	emakhasi; 
paid	liholo;  khokhela; holela; 
pain	buhlungu; 
painful	kwebuhlungu;  -buhlungu; 
painting	 sitfombe lesipendiwe; kupenda; 
paintings	imipendo; titfombe letipendiwe; 
palace	sigodlo; 
panel	sigungu;  iphanela; 
paper	liphepha;  inyusiphepha; 
papers	emaphepha;  emaphephandzaba; 
paragraph	 ipharagrafu; indzima; 
paragraphs	 emapharagrafu; tindzima; 
parameters	emapharamitha;  imikhawulo; imitsetfo; 
parent	umtali; 
parental	-kwebutali; 
parenting	kwenta umsebenti wekuba ngumtali; 
parents	batali; 
parks	Paka; emapaki;  emapaki;  tindzawo tekungcebeleka; 
parliament	iphalamende; 
parliament's	Kwephalamende; 
parliamentarian	lilunga lasephalamende; 
parliamentarians	emalunga asephalamende; 
parliamentary	kwemphalamende; 
parliaments	emaphalamende; 
parole	setsembiso sekukhululwa ejele ungabaleki; 
part	 sitfo senkhulumo; incenye; 
part-time	ngalesinye sikhatsi; 
partial	incenye;  nganhlanye; 
partially	incenye;  nganhlanye; 
participant	umhlanganyeli; 
participants	badlali; 
participate	bandzakanyeka;  hlanyanyela; 
participated	 hlanganyele; bandzakanyekile; nhlanganyele; 
participates	bahlanganyeli; 
participating	kuhlangayanyela ; kubandzakanyeka; 
participation	kubandzanyeka; kuhlanganyela; 
participatory	kubandzanyeka; kuhlanganyela; 
particularly	ikakhulu; 
particulars	imininingwane; 
parties	emacembu; 
partly	incenye; 
partner	umlingani;  umhlanganyeli;  sitsandvwa; 
partnered	 kusebentisana kwalababili; kuhlangana kwalababili; 
partners	 bahlanganyeli;  tingani; balingani; 
partnership	buhlanganyeli; 
partnerships	kusebentisana;  buhlanganyeli; 
parts	tincenye; 
party	licembu; 
pass	kuniketa;  kunika;  ndlulisa;  lipasi; 
passed	kuniketa;  kunika; phumelela;  endlula;  ndlulisa; 
passenger	umgibeli; 
passengers	bagibeli; 
passes	 phumelela;  –phasa; kuniketa;  kunika; phumelela;  ndlulisa; 
passing	kuphumelela;  kuphasa;  kwendlula; 
passport	iphasipoti; 
past	 -engcile; sikhatsi lesengca lesiphelele; 
path	indlela; 
patient	sigulane; 
patients	tigulane; 
patriotism	kutsandza live; kutsandza live lakho; 
pattern	iphethini; 
patterns	Imisiko;  emaphethini ; emaphethini; 
paved	kuvula indlela; 
pavilion	lithende lelikhulu; indzawo yetibukeli emidlalweni; 
pay	 bhadala; liholo; 
payable	sikhatsi sekukhokhela; khokheleka; 
paying	khokha;  bhadala; holela;  liholo; 
payment	imbadalo; 
payments	tinkhokhelo; 
pays	bhadala; holela; 
pdf	i-pdf; 
peace	kuthula; 
peaceful	kuthula; 
peak	sicongo; 
peer	ntsanga;  intsanga; 
penalties	 emlotseni; tijeziso; 
penalty	sijeziso;  emlotseni; 
pending	ngakaphetfwa; 
pension	umhlalaphansi; 
pensions	imihlalaphansi; 
people	bantfu; 
people's	kwebantfu; 
peoples	bantfu; 
perceived	tsafwa sengatsi; 
percent	liphesenti; 
percentages	emaphesenti; 
perception	catjangwako; 
perceptions	catjangangwako; 
perform	enta;  dlala; 
performance	 kujabulisa; kusebenta;  umdlalo; 
performances	 kujabulisa;  imidlalo; kusebenta; 
performed	 -enta; -dlalile; 
performer	umdlali; 
performers	badlali; 
performing	enta;  dlala; 
performs	enta;  dlala; 
perhaps	mhlawumbe; 
period	 sikhatsi lesibekiwe; sikhatsi; 
periodical	-sikhatsi ngesikhatsi; 
periods	tikhatsi; 
perjury	kufungela emanga; 
permanent	futsi; 
permanently	futsi; 
permission	imvume; 
permit	 vumela; imvume; 
permits	vumela;  timvume; 
permitted	vumela;  vuma; 
perpetuate	bhebhetsela; 
person	umuntfu;  lokhulunyiswako;  lokhulumako; 
person's	kwebantfu; 
personally	kutentela; ngekwami; 
personnel	tisebenti; 
persons	 lokukhulunywa ngabo; lokucondziswa kuye; bantfu; 
perspectives	imibono; 
pertaining	mayelana;  phatselene; 
petition	sikhalonyandzaleyo; 
petitions	 tikhaloticelo; ticelosikhalo; 
pharmaceutical	kudidiyelwa kwemitsi; 
pharmacy	likhemisi; 
phase	libanga; 
phased	ngenisa;  pheliswa; 
phases	tigaba; 
phenomenon	senteko; 
philosophy	ifilosofi; 
phone	lucingo; 
photo	sitfombe; 
photograph	sitfombe; 
photographers	umtfwebulititfombe; 
photographic	kwetitfombe; 
photographs	tfwebula titfombe; sitfombe; 
photography	kutfwebula titfombe; 
photos	titfombe; 
physical	 -ngekwemtimba; -kwenyama; 
physically	kwemtimba; 
piano	ipiyano; 
picture	 umfanekiso; sitfombe; 
pictures	titfombe;  umfanekiso; 
piece	lucetu; 
pieces	tincenye; 
pillar	insika; 
pillars	tinsika; 
pioneers	 ematilosi; emavulandlela; emadvulandlela; 
piracy	bugunyati; 
pivotal	phatselene nesihloko sekutungeletisa; 
place	indzawo; 
placed	bekiwe; 
placement	kufakwa endzaweni letsite; 
places	tindzawo; 
placing	beka; 
plain	-bonakalako;  litsafa; 
plains	 -bonakalako; ematsafa; 
plaintiff	ummangali; 
plaintiff's	ummangali;  ummangaleli; 
plan	 lungiselela;  ipulani;  ncuma; luhlelo;  licebo; 
planned	 lungiselela;  ncuma; hlela;  yenta licebo; 
planning	 kulungiselela; kuhlela; 
plans	 emalungiselelo;  emacebo; tinhlelo; 
plant	 sitfombo;  tisetjentiswa temboni; imboni;  hlanyela; 
plants	 tisetjentiswa temboni;  titfombo; titjalo;  hlanyela; 
plate	 ngcwengcwe; lucwecwe; 
platform	inkhundla;  siteshi sesitimela; 
platforms	tindludla;  titeshi tetitimela; tinkhundla; 
platinum	insimbi lemhlophe; iplatinamu; 
play	umdlalo; 
played	dlala; 
player	umdlali; 
players	badlali; 
playhouse	emadlwane;  indlu yekudlalela bantfwana; 
playhouses	tindlu tekudlalela bantfwana; 
playing	kudlala; 
plays	imidlalo; 
plea	sicelo; 
pleading	 kuncenga; kucela; 
pleadings	 kuncenga; kucela; 
please	 -cela; tsine; 
pleased	jabulile; 
pleasure	injabulo; 
pledge	sifungo; sitsembiso; 
pledged	tsembisile; fungile; 
plenary	kuhlanga kwabo bonkhe; 
plight	simo lesibucayi; inhlupheko; 
plus	hlanganisa; 
pm	entsambama; 
poaching	kutingela ngekweba; 
poem	 silandzelo; inkondlo; 
poet	sonkondlo; 
poetry	bunkondlo; 
poets	bosonkondlo;  timbongi; 
point	 khomba;  licashati; sihloko; 
pointed	 cija; khomba; cijile; 
points	 khomba; emacashati;  tihloko; emaphuzu; 
police	emaphoyisa; 
policies	tinchubomgomo;  tincubomgomo; imishwalensi; 
policing	buphoyisa; 
policy	inchubomgomo;  ipholisi;  incubomgomo; 
politics	 tembangave;  tembusave; ipolitiki; 
pollution	kungcoliseka; 
pool	sitiba; 
poor	buphuya; 
poorer	phuye kakhudlwana; 
poorest	phuye kakhulu; 
poorly	kabi; 
popular	-dvumile; 
population	linanibantfu; 
pornography	umbukiso wetitfombe letingcunu netemacasi; 
port	sikhumulo semikhumbi; 
portal	iphothali; 
portfolio	 ifayela; sikhundla; 
portion	incenye;  libinta; 
portrayed	fanekisa; 
ports	tikhumulo temikhumbi;  tikhumumulo temikhumbi; 
pose	kuma kwemtimba; 
posed	kuma ngandlela tsite;  kuma kwemtimba; 
position	indzawo;  sikhundla; 
positions	tindzawo;  tikhundla; 
positively	 ngekwetsemba; ngalokwakhako; 
possess	veta; 
possession	bunikati;  kuba nelibhola; 
possibilities	khonakala; 
possible	khoneka; 
possibly	khoneka; 
post	 tfumela;  liposi; sikhundla; 
post-apartheid	ngemuva kwelubandlululo; 
postal	 phatselene neliposi; 
postgraduate	lonesisicu sasenyuvesi; 
postponed	hlehlisiwe; 
postponement	kuhlehliswa; 
posts	 tfumela;  emaposi; tikhundla; 
pot	 libhodo; imbita; 
potential	kuba nemandla; 
potentially	ngalokunemandla; 
poverty	buphuya; 
power	emandla;  emandla ekuphatsa;  ligunya; 
powerful	-nemandla; 
powers	emadla; emandla;  emandla ekuphatsa;  emagunya; 
practicable	-nekwenteka; 
practice	 kutilolonga; kusebenta; 
practices	tayeta;  kutilolonga;  kutetayeta; kusebenta; 
practise	lolonga; 
practitioner	umsebenti loceceshiwe; 
practitioners	tisebenti; 
praise	bonga; 
prayer	umthandazo; 
pre-colonial	ngembi kwembuso wekugwamandza; 
pre-trial	ngembi kwekuvula umkhondvo; 
preamble	 sendvulelo; singeniso; 
precede	endvulela; 
preceded	-endvulela; 
preceding	kwendvulela; 
precinct	libala;  ligceke; 
precincts	 emabala; emagceke; 
precious	ligugu; 
prefer	-khetsa; 
preference	kukhetsa; lokutandvwa kakhulu; 
preferential	lokutsandvwa kakhulu; 
preferred	lokutsandvwa kakhulu;  -khetsa; 
pregnancy	kutetfwala; 
pregnant	khulelwe; 
prejudice	 kuncuma kucala; sigwebonchanti; 
premier	ndvunankhulu; 
premised	chaziwe; 
premises	emabala elikhaya; 
preparation	 kulungiselela; emalungiselelo;  inhlanganisela;  hlanganisa; 
preparations	 kulungiselela; emalungiselelo; 
prepare	lungiselela; 
prepared	lungisiwe; Lungiselelwe;  lungele; 
preparing	lungiselela; 
prescribe	khetsa; 
prescribed	-khetsiwe; 
prescribing	kuncuma; 
prescription	 imilayeto; timiso; 
prescripts	lokuncunyiwe; 
presence	kubakhona; 
present	siphon;  nyalo; kubakhona; 
presentation	setfulo;  kunikelwa; 
presentations	tinkhulumo;  tetfulo; 
presented	kwetfulwa;  -tfula;  kwetfula; kuniwe siphon; 
presenting	 -tfula; kwetfula; 
presently	kwamanje; 
presents	tipho; 
preservation	 kulondvolotwa; kugcina; 
preserve	gcina; 
preserved	gcina; 
preserving	gcina; 
preside	kwengamela; 
presidency	kwamengameli; 
president	mengameli;  umengameli; 
president's	kwamengameli; 
presidential	kwamengameli; 
presidents	bomengameli; 
presiding	kwengamela; 
press	ayina;  cindzetela; 
pressing	kucindzetela; 
pressure	kucindzetela;  sicindzetelo; 
pressures	kucindzeteleka; 
prestigious	lokusezingeni lelisetulu; 
presumed	catjangangiwe; 
pretty	kuhlehliswa; 
prevail	chubeka ngemandla; 
prevailing	chubeka ngemandla; 
prevalence	bukhona besifo ngaleso sikhatsi; 
prevent	vikela; 
prevented	vikela; vimbela; 
preventing	 vikela; kuvimbela; 
prevention	kuvimbela; 
previous	lokwedlulile; 
previously	phambilini; 
price	intsengo; 
prices	tintsengo; 
pricing	kubeka intsengo; 
pride	 ligcabho; kutatisa; 
priest	umphristi; 
primarily	ikakhulu;  balulekile; 
primary	kwekucala; 
prime	sisusa sekucala; 
principal	 umphatsisikolo; thishelanhloko; 
principals	baphatsitikolo; bothishelanhloko; 
principle	umgomosisekelo; 
principles	imigomosisekelo; 
print	 kusicilela umbala; umbhalo; 
printed	-phrintiwe;  kusicilela umbala; bhala; 
printing	-phrinta;  umbhalo;  kusicilela umbala; kubhala; 
prior	ngembi;  phambili; 
priorities	-balulekile; 
prioritise	yenta kube kwekucala; lekubalulekile; 
prioritised	kwentiwa kube kwekucala; 
priority	-balulekile; 
prison	lijele; 
prisoner	siboshwa; 
prisoners	tiboshwa; 
prisons	emajele; 
privacy	 lingasese; imfihlo; 
privilege	imvumesibonelelo; 
privileged	kwentelwa umusa; 
privileges	emalungelo; 
prize	umklomelo; intsengo; 
prizes	tintsengo; 
proactive	 kuphakamela etulu; kuvula indlela; 
probably	mhlawumbe; 
probation	sikhatsi sekulindza; 
probe	buta; 
problem	inkinga;  sibalo; 
problems	tinkinga;  tibalo; 
procedural	ngekwenchubo; 
procedure	 kuhlindza; inchubo; 
procedures	 kuhlindza; tinchubo; 
proceed	chubeka; 
proceeding	kuchubeka; 
proceedings	lokuchubekako; 
proceeds	tinchubo; 
process	 indlelanchubo;  lungisa; luhlelo;  inchubeko; 
processed	 hambisa; hlela;  lungisa; chuba; 
processes	 tinchubo;  tindlelanchubo;  ndlulisa; tinhlelo; chuba; 
processing	 kuchuba;  lungisa; kuhlela; 
procession	ludvwendvwe; 
proclamation	simemetelo; 
procurement	kutfola tintfo letidzingekako; 
produce	umkhicito; 
produced	khicita; 
producer	umkhiphi (wemdlalo); 
producers	bakhiciti; bakhiphi (bemdlalo); 
produces	imikhicito; 
producing	kukhicita; khicita; 
product	 umphumela wekuphindzaphindza; sivuno; 
production	kukhicita;  kurekhoda; 
productions	imikhicito;  kurekhoda; 
productive	kukhicita; 
productivity	 kukhona kukhicita; kukhicita; 
products	imiphumela yekuphindzaphindza;  tivuno; 
profession	umsebenti lofundzelwe; umkhakha wetemfundvo; 
professional	chwepheshe;  sifundziswa;  -kwemsebenti lofundzelwe; 
professionals	tifundziswa; bocwepheshe;  tingweti; 
professions	 ticu tebungcweti; imikhakha yetemfundvo; 
professor	solwati; phrofesa; 
profit	inzuzo; 
profits	tinzuzo; 
profound	khulu;  mangalisako;  balulekile; 
program	luhlelo; 
programme	luhlelo; 
programmed	hlela; 
programmes	tinhlelo; 
programming	kuhlela;  kwakha tinhlelo; 
programs	tinhlelo; 
progress	inchubekelembili; 
progression	inchubekelembili; 
progressive	-tfutfukako;  -chubekako; 
prohibit	 alela; akukavumeleki; 
prohibited	kungavumeli; 
prohibition	sivimbeli;  kungavumeleki; 
projected	khulisiwe; 
projection	kuveta sitfombe; 
projections	kuveta sitfombe; 
projects	imiklamo; 
prominent	dvumile; yatiwako; 
promise	 tsembisa; setsembiso; 
promised	tetsembiso; tsenjisiwe; 
promises	tetsembiso; 
promote	tfutfukisa; 
promoted	tfutfukisa; 
promotes	khutsata; 
promoting	tfutfukisa; 
promotion	kwenyuswa; 
promptly	masinyane;  ngekushesha; 
promulgation	simemetelo; 
proof	bufakazi; 
proper	kahle; 
properly	 ngalokufanele; kahle; 
properties	timphahla;  timphawu; 
property	 luphawu; imphahla; 
proportion	incenye;  kulingana;  kulinganisa nemphumela; 
proposal	siphakamiso; 
proposals	tiphakamiso; 
prosecute	shushisa; 
prosecuted	shushisiwe; 
prosecuting	kushushissa; 
prosecution	kushushisa; 
prosecutions	kushushisa; 
prosecutor	umshushisi; 
prosecutors	bashushisi; 
prospective	 lokutako; lokulindzelwe; 
prospectus	incwajana yekucacisa; 
prosperity	kuphumelela; bunjinga; 
prosperous	kuphumelela; 
prostitution	bungwadla; 
protect	vikela; 
protected	vikela; 
protecting	vikela; 
protection	kuvikela; 
protector	 umvikeli; Iphorthekhtha; umvikeli; 
protest	 shuca; sikhalo; 
protests	tikhalo;  imishuco; 
protocol	umbandzela lobekiwe; 
protocols	imibandzela lebekiwe; 
proudly	ngelicabho; 
prove	cinisekisa; khombisa;  kubonakalisa;  fakaza; 
proved	khombisa;  kubonakalisa;  cinisekisa; 
proven	 khombisile; cinisekisiwe; kucinisekisa; 
provide	niketa; pha; 
provided	niketa; 
provident	ingcamu; 
provider	umniketi; umtfulinsita; 
providers	batfulitinsita; baniketi; 
provides	batfulitinsita; baniketi;  -nika; 
providing	kuniketa;  phani; 
province	sifundza; 
province's	kwesifundza; 
provinces	tifundza; 
provincial	kwesifundza; 
provision	 umphako; kuphakela; umbandzela;  kunika emandla;  ingcamu; 
provisions	 tingamu;  umphako; ingcamu; Imibandzela;  imiphako;  kunika emandla; 
proviso	umbandzela; 
proxy	ummeleli;  lomelele;  emandla ekumelela; 
prudent	hlakaniphile; 
prudential	ngekuhlakanipha; 
psychological	kwengcondvo; kwetengcondvo; 
public	 -wonkhewonkhe; wonkhewonkhe; 
publication	umbhalo loshicilelwe; 
publications	imibhalo leshicilelwe; 
publicly	ngalokusebaleni; 
publish	memetela; 
published	memetela; shicilelwe; 
publisher	umshicileli;  umkhiphi; 
publishers	bashicileli;  bashicileli; 
publishes	shicilela; memetela; 
publishing	shicilela; memetela; 
punishment	kujezisa; 
purchase	 tsenga; kutsenga; 
purchased	 tsenga; kutsenga; 
purchases	 tsenga; kutsenga; 
purporting	kwesekela; 
purpose	injongo; 
purposes	tinjongo; 
pursuant	fanele; 
pursue	landzelela; 
pursued	landzelela; 
pursuing	kulandzelela; 
pursuit	landzela; 
put	beka; 
puts	beka; 
putting	beka; 
qualification	lilungelo;  siciniseko sekucecesheka;  siciniseko sekutsi umuntfu uceceshiwe; 
qualifications	ticu; 
qualified	-nelilungelo; 
qualify	 bunjani;  -emukeleka; chaza; 
qualifying	tfwasa;  kufaneleka;  -emukeleka;  faneleka; chaza; 
qualitative	lokungiko; 
qualities	bunjalo; 
quality	bunjalo; 
quantitative	-kwelinani; bunyenti; 
quantity	linani; 
quarter	ikota; 
quarterly	ngekota; 
quarters	emakota; 
queries	imibuto; 
quest	 kuhlwaya; kufuna lwati ngalokutsite; 
question	umbuzo; 
questioned	buta; 
questionnaires	tinhlumbuto; 
questions	imibuto; 
quickly	masinyane;  ngekushesha; 
quite	mbamba; 
quorum	linyenti lelidzingekako; 
quotations	ticashunwa; 
quote	caphuna; 
race	 buhlanga;  umjako; sive;  umjaho; 
races	 tinhlanga; Imicudzelano; 
racial	kwesive; 
racism	buhlanga; 
radio	umsakato; 
raid	kuhlasela; 
rail	umgibe; 
railway	 jantji; loliwe; 
rain	imvula;  -ina;  iyana; 
rainbow	umushi wenkosazana; 
rainfall	kuna kwemvula; 
raise	khuphula; 
raised	khuphula; 
raises	khuphula; 
raising	khuphula; 
rally	umhlangano lomkhulu; 
rand	lirandi; 
range	 libanga;  simo semandla eliphimbo;  libanga lelincunyiwe; budze; 
ranges	 simo semandla eliphimbo; tinhlobo;  kwenteka ngemandla;  budze; 
ranging	 libanga;  simo semandla eliphimbo; budze;  emabanga lancunyiwe; 
rank	indzawo; 
ranks	tigaba; 
rape	 bamba;  kugagadlela;  dlwengula; kubamba; 
rapidly	ngekushesha; 
rare	akukavami; 
rate	 linganisa;  silinganiso sentfutfuko; bungako; 
rather	lokungenani; 
ratification	vumela;  cinisa; 
ratified	 vunyelwe; cinisiwe; 
rating	kuhlelembisa; 
ratings	kuhlelembisa; 
ratio	 ireshiyo; kwelamalamana;  kwelamana; 
rationalisation	kuchaza; 
raw	-kahlutwa; luhlata; 
reach	fika; finyelela; 
reached	-finyelele; fikile; 
reaching	fika; finyelela; 
read	fundza; 
reader	umfundzi;  incwadzi yekufundza; 
readers	 tincwadzi tekufundza; bafundzi; 
readily	ngekushesha; 
readiness	kulungela; 
reading	kufundza; 
ready	lungile; 
reaffirm	cinisekisa; 
real	mbamba;  kona kona; 
realisation	kucondza;  kuzuza; kwenteka; 
realise	tfola; 
realised	kwentekile;  -zuzile; -bonile; 
realising	-bona;  -zuza; kwenteka; 
realities	emaciniso; 
reality	mbamba; 
realization	-bona;  -zuza; kwenteka; 
realize	 enteka; -zuza;  -bona; 
really	mbamba; 
reason	 cabanga; sizatfu; 
reasonable	-vakalako; 
reasonably	ngalokufanele; 
reasons	 imicabango; tizatfu; 
reburial	kungcwatjwa kabusha; 
recall	kususwa esihlalweni; 
recapitalisation	kutfutfukisa umnotfo ngetindlela letinsha; 
receipts	emarisidi; tiliphi; 
receive	tfola;  yemukela; 
received	tfola;  -emukela; 
receives	tfola;  -emukela; 
receiving	tfola;  -emukela; 
recent	sandza kenteka; 
recently	sandza kenteka; 
recession	kwehla kwemnotfo; 
recipient	umemukeli; 
recipients	bemukeli; 
reclaim	buyisa lokungekwakho; 
recognise	bona;  vuma;  emukela; 
recognised	 bonwa; hlonishwa; 
recognises	bona;  hlonishwa; 
recognising	kubona; 
recognition	kubona; 
recognize	kubona; 
recognized	 bonwa; hlonishwa; 
recommendation	siphakamiso;  kuncoma; 
recommendations	tiphakamiso;  kuncoma; 
recommended	tusa; 
recommends	ncoma; 
reconciliation	kubuyisana; 
reconstruction	kwakha kabusha; 
record	 kubhalwa kwemphahla;  rekhoda;  lirekhodi; bhala; 
recorded	 kubhalwa kwemphahla;  rekhoda; bhala;  emarekhodi; 
recording	kutsatsiswa; 
records	 kubhalwa kwemphahla; umbhalo;  lirekhodi;  emarekhodi; 
recover	phindze utfole; 
recovered	 phindze utfole; thulela; 
recovery	 kululama; kusindza;  kwelulama; 
recreation	 kutiphumulisa;  kudala kabusha; kukhibika; 
recreational	kukhibika; 
recruitment	kugcogca bantfu; 
rectify	lungisa; 
recycling	kuhlanta;  kujikeletisa; 
red	bovu; 
redistribution	sabalalisa kabusha; 
redress	lungisa; 
reduce	nciphisa; 
reduced	nciphisa; 
reducing	kunciphisa; phendvulela; 
reduction	kunciphisa; 
reductions	kunciphisa; 
refer	condzisa ku-; -endlulisa; 
reference	iriferensi; 
references	emariferensi; 
referral	kwendluliswa; 
referred	ndlulisiwe; 
referring	conndzisa; 
refers	condzisa ku-; 
reflected	phindziseleka; 
reflecting	phindziseleka; 
reflection	 kubuyiswa emuva; fanana; 
reflective	khombisa; 
reflects	buyeketa; 
reform	 kugucuka; luntjintjo;  gucuka; 
reforms	 kugucuka; luntjintjo;  gucuka; 
refund	kubuyisela;  buyisela; 
refurbishment	kulungisa; 
refusal	kwala; 
refuse	 ala; tibi; 
refused	 ala; tibi; 
refuses	 ala; tibi; 
regard	tsatsa ngekutsi; 
regarded	tsatsa ngekutsi; 
regarding	macondzana; 
regardless	ngekungabi nendzaba; 
regards	mayelana; 
regeneration	 kuvusetela; kuvuselela; 
regime	umbuso; 
region	 sifundzave; sifundza;  sigodzi; 
regional	kwesifundza;  -kwesigodzi; 
regions	 tigodzi; tifundza; 
register	 bhalisa; irejista; 
registered	bhalisa; 
registering	kubhalisa; 
registers	emarejista; 
registrar	mabhalane; 
registration	kubhalisa; 
registries	emarejista; 
registry	kubhalisa; 
regular	 -yenteka njalo;  -tayelekile; ngekwemgomo;  -ngendlela; 
regularly	ngalokuvamile; 
regulate	lawula; 
regulated	lawula; hambisa ngendlela; 
regulates	lawula; hambisa ngendlela; 
regulating	lawula; hambisa ngendlela; 
regulation	 simiso; timiso; 
regulations	timiso; 
regulator	umlawuli; silawuli; 
regulators	tilawuli; balawuli; 
regulatory	lawula; 
rehabilitation	kubuyisela similo; 
rehearsal	kutilolonga; 
rehearsals	kutilolonga; 
reinforce	vumela;  cinisa; 
reintegration	kuhlanganisa kabusha; 
reiterate	phindza;  gcizelela; 
reiterated	phindza;  gcizelela; 
reject	 ala; kwala; 
rejected	 ala; kwala; 
relate	chaza; landzisa; 
related	-nebuhlobo; 
relates	chaza; landzisa; 
relating	chaza; landzisa; 
relation	budlelwane; 
relations	budlelwane; 
relationship	budlelwane;  kuhlobana;  bungani betingani; 
relationships	budlelwane;  kuhlobana;  bungani betingani; 
relative	 sibaluli; sihlobo;  kuya nge-;  tihlobo; 
relatively	kulingana;  nakucatsaniswa; 
relatives	 tibaluli; tihlobo; 
release	khulula; 
released	khulula; veta;  khululiwe; 
releases	khulula; veta; 
relevance	hambisana; 
reliable	-tsembekile; 
relief	lusito;  kucopha; 
religion	inkholo; 
religions	tinkholo; 
religious	kwenkholo;  -kwenkholo; 
rely	tsembela; 
remain	sala; 
remainder	 insalela; lokusele; 
remained	sala; 
remaining	sala; 
remains	tinsalela; 
remand	buyisela emuva; 
remarkable	 -mangalisako; kuhle kakhulu; 
remarks	kuphawula; 
remedies	emakhambi; 
remedy	likhambi; 
remember	khumbula; 
remembered	khumbula; 
remembrance	kukhumbula;  inkhumbulo; 
remind	khumbuta; kukhumbuta; 
reminded	khuntjutwa; kukhumbuta; 
reminder	sikhumbuto; 
reminders	tikhumbuto; 
remote	-khashane; 
removal	 kuhambisa; kususa; kukhipha; 
remove	susa; 
removed	susa; 
removing	susa; 
remuneration	 imbadalo; inkhokhelo; 
renaissance	kukhula kwalokusha; imvuselelo yelwati; 
renamed	camba kabusha; 
renaming	kwetsa ligama kabusha; 
render	nika; 
rendered	nika; 
rendering	nika; 
renew	enta busha; 
renewal	kuvuselela; 
renewed	enta busha; 
renovations	kulungisa; 
renowned	dvumile;  -yatiwa kakhulu; 
rent	 tsela; intsela;  irenti; 
rental	kurenta; 
repair	kukhandza; 
repairs	 kukhandza; kulungisa; 
repatriation	buyisela eveni lakubo; 
repeal	citsa; sula; 
repealed	citsiwe; sula; 
repeals	citsa; sula; 
repeat	phindza; 
replace	kubuyisela;  misa;  vala; 
replaced	 kufaka esikhundleni salokunye; faka esikhundleni salokunye; 
replacement	kumisa; 
replies	timphendvulo; tiphendvulo;  phendvula; 
reply	kuphendvula; timphendvulo;  phendvula; 
report	 bika; umbiko; 
report-back	 kwetfula umbiko; kubita; 
reported	imibiko;  bika; 
reporting	umbiko;  kubika; 
reports	imibiko; 
reposition	kuma kabusha; 
repositioning	kuna kabusha; 
repository	 silondvoloti; indzawo yekubeka; 
representation	kumelwa;  kumela; 
representations	kumelwa;  kumelela; 
representative	 ummeleli; ummeli; 
representatives	 ummeleli; ummeli; 
represented	melela; 
representing	kumelela; 
represents	tipho; 
repressive	vimbela; 
republic	iriphabliki; 
republics	emariphabhliki;  emariphabliki; 
request	sicelo; 
requested	cela; 
requester	locelako; 
requesting	kucela; 
requests	ticelo; 
require	dzinga; 
required	dzinga; 
requirement	sidzingo; 
requirements	sidzingo; 
requires	dzinga; 
requiring	kubuta; 
requisite	lokufunekako;  lokudzizngekako; 
rescue	 kusindzisa; sindzisa; 
research	 cwaninga;  lucwaningo; kusesha; 
researcher	umcwaningi; 
researchers	bacwaningi; 
reservation	bekwe eceleni; lebekelwe; 
reserve	 lolindzile;  sabelo; gcina;  londvolota; 
reserved	bekwe eceleni; 
reserves	 sabelo; gcina;  londvolota; labalindzile; 
residence	indzawo yekuhlala; likhaya; 
residential	indzawo yekuhlala; -kwekuhlala; 
residents	bahlali; 
resides	hlala; 
residing	hlala; 
resignation	kuyekela; 
resilience	kumelana nebumatima; 
resistance	 kumelana; kuvimbela;  kwala;  kucinisela; 
resolution	 simiso; sincumo; 
resolutions	timiso;  tincumo; 
resolve	sombulula; 
resolved	sombulula; 
resolving	kusombulula; 
resounding	vakala kakhulu; 
resource	timbiwa; 
resources	timbiwa; 
respect	inhlonipho; 
respected	hlonishwa; hlonipha; 
respective	ngekufanana; 
respectively	ngekulandzelana; 
respects	Tinhlonipho;  uyahlonipha; 
respond	phendvula; 
responded	phendvula; 
respondent	umbekacala; 
respondents	babekacala; 
responding	phendvula; 
responds	phendvula; 
response	imphendvulo;  phendvula; 
responses	timphendvulo; 
responsibilities	 tibopho; imitfwalo; 
responsibility	 sibopho; umtfwalo; 
responsible	-nesibopho; 
responsive	sabelako;  vumelako; 
rest	 sikhawu; kuphumula; 
restitution	kubuyisana;  kubuyisela umhlaba; 
restoration	buyisela esimeni sako; 
restorative	kubuyela esimeni lesifanele; 
restore	buyisela esimeni sako; 
restored	 buyiselwa esimeni lesifanele; buyisela esimeni lesifanele; 
restoring	kubuyisela esimeni lesifanele; vuselela; 
restraint	vimbela ; 
restricted	beka umkhawulo; 
restriction	akukavumeleki; 
restrictions	imikhawulo; 
restructuring	kulungisa kabusha;  kuhlela kabusha; 
result	umphumela; 
resulted	umphumela; 
resulting	umphumela; 
results	imiphumela; 
retail	kutsengisela; 
retain	gcina; 
retained	gciniwe; 
retention	 kugcinwa; 
retire	kutsatsa umhlalaphansi; 
retired	 kutsatsa umhlalaphansi;  kutsatsa impesheni; kutsatsa umhlalaphasi; 
retirement	imphesheni; 
retrieval	kukhipha; 
return	 kubuyela emuva; kubuyisa; 
returned	kububuya; 
returns	kubuya; 
reveal	 kubeka ebaleni; kukhiphela ebaleni; 
revealed	kukhishelwa ebaleni; 
revenue	 timali letingenako; imalingena; 
revenues	 timali letingenako; imalingena; 
reverse	guculela; 
review	buyeketa; sibuyeketo; 
reviewed	buyeketa; buyeketiwe; 
reviewing	 kubuyeketa; buyeketa; 
reviews	tibuyeketo; kubuyeketa; 
revise	buyeketa; 
revised	buyeketa; 
revision	kubuyeketa; 
revisions	kubuyeketa; 
revitalisation	kwenta kancono; kufaka emandla lamasha; 
revoke	buyisa; citsa umyalo; 
revolution	 kucitsa umbuso; kuphendvuka lokugcwele; 
revolutionary	-mayelana nengucuko/nekuvukela; 
reward	umvuzo; umklomelo; 
rhino	bhejane; 
rich	njinga; 
right	 ngesekudla; kahle;  lungile;  sekudla; 
rightful	fanele; 
rights	emalungelo; 
rise	phakama;  yenyukela; 
rising	kuvuka;  kuphakama; 
risk	bungoti; 
risks	bungoti; 
river	umfula; 
rivers	imifula; 
road	umgwaco;  umgwanco; 
roads	imigwaco; 
robust	namandla; 
rock	lidvwala; 
rod	 luswati;  silinganisa; indvuku; 
role	indzima; 
role-players	badlalindzima; 
roles	tindzima; 
roll	bhalisa; 
roll-out	calisa kusebenta; 
rolled	kugicika; 
rolling	kugicika; 
rollout	calisa kusebenta; 
rolls	emaroli;  gicika; 
room	likamelo; 
rooms	emakamelo; 
root	 umsuka; imphandze; 
rooted	simile; cinile; 
roots	timphandze; 
rose	phakama;  khuphuka; 
round	 indilinga;  indingilizi; umjikeleto; 
rounded	 indilinga; tungeletiwe; indingilizi;  jikeleta;  -fakwe ekhatsi; sandingilizi; 
roundtable	ingcoco; 
route	indlela; 
routes	tindlela; 
routine	inkhambiso; 
royal	 -kwebukhosi; bukhosi; kwasesigodlweni; 
royalties	 luhlobo lolutsite lwemali; basesigodweni; imali letfolwa babhalimabhuku njalo ngemnyaka; 
royalty	imali letfolwa babhalimabhuku njalo ngemnyaka; 
rule	 irula;  kubusa; umtsetfo; 
rules	 emarula; imitsetfo; 
ruling	sincumo; 
rulings	tincumo; 
run	gijima; baleka; 
running	kuphatfwa kwelikhaya; gijima; baleka; 
runs	gijima; baleka; 
rural	emakhaya;  liphandle;  -maphandleni; 
sacred	ngcwele; 
sacrifice	 nikela; umnikelo;  kunikela; 
sacrifices	 nikela; iminikelo;  kunikela; 
saddened	kuba lusizi;  phatseka kabi; 
sadness	kudzangala; 
safe	sisefo;  -phephile; 
safeguard	kuvikela; 
safeguarding	kuvikela; 
safety	 kuphepha; kuvikeleka; 
said	tsite; 
salaries	imiholo; emaholo; 
salary	 liholo; umholo; 
sales	lokutsengiswako; 
salute	-bingelela ngenhlonipho; bingelela;  kubingelela ngenhlonipho; 
same	ngalokufananako; 
sample	 isampula; sifaniso; 
samples	emasampuli; 
sampling	 kufanisa; kusampula; 
san	Umutfwa; 
sanction	kunklinywa; 
sanitation	 kuvikela ekungcoleni; tindlela tekususa tinsila; 
sap	inkhovu; 
saps	bomanafu; 
satisfaction	kwenelisa; 
satisfactory	netisa; 
satisfied	-enelisa; 
satisfies	enelisa; 
save	vimba; 
saving	konga; 
savings	imali leyongiwe; 
saw	lisaha; 
say	tsani; 
saying	sisho; -tsi; 
says	utsi; 
scale	ngemanotsi laphelele;  sikalo;  inkhwetfu; 
scarce	-yindlala; 
scene	 indzawo yesento; sicephu;  sigaba semdlalo; 
scenes	 tigaba semdlalo;  tindzawo tesehlakalo; tehlakalo; 
schedule	luhlelo;  ishejuli; 
scheduled	faka eluhlelweni;  kufwaka eluhlelwenimsebenti; fakwa kuluhlelomsebenti; 
schedules	 tinhlelomsebenti;  emashejuli; tinhlelo; 
scheduling	 kwenta luhlelo; kwenta ishejuli; kuhlela luhlelomsebenti; 
scheme	luhlelo lwemisebenti; 
schemes	 tinhlelo temisebenti; tikimu; 
scholar	umntfwana wesikolwa; Umfundzi;  umntfwna wesikolwa; 
scholars	 bantfwana besikolwa; bafundzi; 
scholarship	umfundzate; 
school	sikolo; 
schooling	kufundza; 
schools	tikolo; 
science	isayensi; 
sciences	emasayensi; 
scientific	-nesayensi; 
scope	umgamu;  lokufundvwako; 
score	 luhlelo lwetindlela lolubhaliwe;  emashumi lamabili;  ligoli; umphumela;  umculo lobhalwe phasi;  dvweba; 
scorecard	likhadimaphuzu; 
scoring	 kutfola lokufunako; kunika emamaki;  kuniketa emamaki; 
scourge	kubhubhisa; 
screen	 buso;  sihenco; hlola; 
screening	kuhlolisisa; 
script	umbhalo;  liphepha; 
scrutinise	funisisa; 
scrutiny	kuhlolisisa; 
sculpture	 sitfombe lesibatiwe;  kubata; kucopha; 
sea	lwandle; 
seal	 nameka; sivimbo; 
sealed	vala;  namatsisela; 
search	 phenya; sesha; 
searched	 seshile; phenyile; 
season	 sikhatsi semnyaka; sikhatsi semidlalo; 
seasonal	-kwetikhatsi temnyaka; ngetikhatsi letitsite; 
seasons	 tikhatsi temidlalo; tikhatsi temnyaka; 
seat	 kulabakhulu; sikhundla; 
seats	tikhundla;  tihlalo; 
sec	kwesibili; 
second	 inombolo yesibili; sekela;  kwesibili; 
secondary	ngephansi; 
secondly	kwesibili; 
secret	imfihlo; 
secretariat	lihhovisi lebubhalane; 
secretary	lobhala; 
secretary-general	mabhalene jikelele; 
section	 sigaba semsebenti;  sigaba sencwadzi; sigaba;  incenye; 
sectional	umkhakha; 
sections	 tigaba sencwadzi;  tigaba semsebenti;  tigaba; tincenye; 
sector	umkhakha; 
sectors	tincenye ; imikhakha;  imikhakha; 
secure	londvolota; 
secured	londvolota; -londvolotekile; 
securing	kulondvolota; 
securities	tibambiso; 
security	kuvikela;  sibambiso;  kuvikeleka; 
see	buka; 
seeing	bona; 
seek	funa; 
seeking	funa; 
seeks	funa; 
seem	 bonakala sengatsi; bukeka sengatsi; 
seems	 bonakala sengatsi; bukeka sengatsi; 
seen	bonwa; 
segment	sigamu; 
segregation	kubandlulula; lubandlululo; 
seize	bamba;  emuka; 
seized	bamba;  banjwa; 
seizure	kucaleka; 
select	khetsa; 
selected	khetsiwe; 
selection	kwela; 
self	buwena; bumine; 
self-determination	kutikhetsela; kutimisela; 
self-sufficiency	kuna nako konkhe lokudzingako; 
selfless	kutidzela; 
sell	tsengisa; 
selling	kutsengisa; 
seminar	Isemina;  ingcungcutsela; umhlangano; 
seminars	imihlangano; Emasemina;  tingcungcutsela; 
send	 tfuma; tfumela; 
sending	 tfuma; tfumela; 
sends	 tfuma; tfumela; 
senior	lomkhulu; 
sense	umuva; 
sent	 tfumela; tfumele; Tfunyelwe; 
sentence	umusho;  sigwebo; 
sentenced	 kwetjwa; gwetjwa; 
sentences	 tigwebo; imisho; 
sentencing	kugweba; 
separate	 hlukene; ehlukene;  ehlukanisa; 
separated	-hlukanisa; -ehlukene;  -hlukene;  -ehlukanisa; 
separately	ngekwehlukana; 
separation	kwehlukana; 
sequestration	kudliwa;  kwemukwa sikhashana; 
series	 lokulandzelanako; luchungechunge; 
serious	mbamba; 
seriously	 ngekweliciniso; mbamba; 
servant	sisebenti; 
servants	tisebenti; 
serve	 phakela;  sebentela; tfumela; 
served	 phakela;  sebentela; sita; tfumela; 
serves	 phakela;  sebentela; sita; tfumela; 
service	 insita; insita; umsebenti; 
serviced	lungisiwe;  sita;  yentelwe lokutsite; 
services	 tinsita; imisebenti; 
serving	 phakela;  kudvonsa sigwebo ejele;  sebentela; sita; tfumela; 
session	sikhatsi; 
sessions	tikhatsi; 
set	indzawo;  isethi;  lokuhambelanako;  tsatsisa; 
seta	i-seta; 
sets	 lokuhambelanako; emasethi;  cipha; 
settle	hlala;  misa; 
settled	sitsile; Hlalisekile;  tintile; 
settlement	indzawo;  indzawo leyakhiwe;  kwakha; 
settlements	tindzawo;  takhiwo;  tindzawo tekuhlala; 
settler	umchamuki;  sakhi; 
settlers	 bachamuki; bahlali; 
seven	sikhombisa; 
severe	 -matima; -nemandla; 
sew	tfunga; 
sewing	kutfunga; 
sex	bulili; 
sexual	-netemacansi; 
sexually	ngekwemacasi; 
shall	kwenteka; 
shape	simo;  bumba; 
shaped	bumbekile; 
shapes	-akha;  bumba; bobunjwa; 
shaping	kubata; 
share	 abela;  kwabelana; sabelo; 
shared	kwabelana;  abela;  kwabelana; sabelo; 
shareholder	umninimasheya; umhlanganyeli ebhizinisini; 
shareholders	baninimasheya; bahlanganyeli ebhizinisini; 
shareholding	kuba nemasheya; 
shares	 emasheya; kwabelana; Bolekana;  kwabelana; 
sharing	bolekana;  abela;  kwabelana; sabelo; 
shark	shaka; 
sharks	shaka; 
sharp	bukhali; 
she	yena; 
shedding	kususa;  kuhhohloka; 
sheet	 lishidi; liphepha; 
sheets	ticwencwe; emaphepha;  emashidi; 
shelter	 khosela; indlu;  likhaya; 
sheriffs	bomabhalane benkantolo yemajaji; 
shift	khwesha; 
shifted	khwesha; 
shifting	khwesha; 
shifts	khwesha; 
ship	umkhumbi; 
shipping	kuhambisa ngemkhumbi; 
ships	imikhumbi; 
shock	kwetfuka; 
shocked	kwetfuka; 
shocks	kwetfuka; 
shop	sitolo; 
shopping	kutsenga; 
shops	titolo; 
shore	lusentse; 
shores	Tinsentse telwandle; 
short	-fishane; 
short-term	sikhashana; kwesikhashana; 
shortage	kushoda; kweswelakala; 
shortages	 kushoda; kweswelakala; 
shorter	fishane kakhudlwana; 
shortly	kafishane; masinyane; 
shot	intsambo; 
should	fanele; 
show	khombisa; 
showcase	khombisa;  khangisa; 
showcasing	khombisa;  khangisa; 
showed	khombisa; 
showing	khombisa; 
shown	khombisa; 
shows	imibukiso; 
side	 licele; luhlangotsi;  licele lendvwangu; 
sign	luphawu;  sayina; 
signal	 luphawu; umbiko;  sikhombisi; 
signals	 tinkhomba; timphawu;  imibiko; tecwayisi; 
signature	isayini; 
signed	sayina; 
significance	balulekile; 
significant	balulekile; 
significantly	ngalokubalulekile; 
signifies	khombisa; 
signing	kusayina; 
signs	timphawu;  sayina; 
silver	isiliva; 
similar	-fanana; 
similarly	kanjalo;  ngalokufanako; 
simple	lula; 
simply	kalula; 
simultaneously	ngesikhatsi sinye;  kanye kanye; 
since	kusukela; 
sincere	kucinisa; 
sincerely	ngekucinisa; 
sing	hlabela; 
singer	umhlabeleli; 
singing	kuhlabela; 
single	-dvwa; 
sister	sisi; dzadze; 
sisters	bosisi; bodzadze; 
sit	hlala; 
site	libala;  siza; 
sites	 emabala; tindzawo; 
sitting	kuhlala; 
sittings	imihlangano; 
situated	beka; 
situation	simo;  sikhundla; 
situations	 tikhundla; timo; 
six	sitfupha; 
sixth	kwesitfupha;  kunye kwesitfupha; 
size	bukhulu;  bungako;  isayizi; 
skill	 buciko; likhono; 
skilled	 fundzile; kuba nemakhono; 
skills	 buciko; emakhono; 
slave	sigcila;  sigcili; 
slavery	bugcili;  bugcila; 
slaves	tigcili; 
slightly	kancane; 
slip	shelela;  lihlumela; 
slow	-kancane; 
small	licolo; 
small-scale	ngalokucane; 
smaller	ncane kakhudlwana; 
so	ngako-ke; 
so-called	lokutsiwa; 
soccer	libhola;  umdlalo webhola; 
social	tenhlalo; 
socially	ngekwenhlalo; 
societal	kwetenhlalo; 
societies	tinhlangano;  imimango; 
society	 umkhambatsi; inhlangano;  ummango; 
socio-economic	tenhlalomnotfo; tenhlalakahle netemnotfo; 
socioeconomic	tenhlalomnotfo; 
soil	umhlabatsi; 
solar	-phatselene nelilanga; 
sold	tsengisa; 
soldiers	emasotja; 
solely	kuphela; 
solid	 sigaca; sigadla;  sasigadla; 
solidarity	kuvelana; umfelandzawonye; 
solution	sisombululo;  kutfukulula; 
solutions	 tisombululo; Imibhubhudlo; tisombululo;  kutfukulula; 
some	labanye;  lokunye; 
someone	umuntfu lotsite;  lomunye umuntfu; 
something	 lenye intfo; intfo letsite; 
sometimes	ngalesinye sikhatsi; 
somewhat	lokunye; 
son	indvodzana; 
song	ingoma; 
songs	tingoma; 
soon	masinyane; 
sophisticated	matima;  lukhuni; 
sort	kuhlunga; 
sought	funwako; 
soul	umoya; 
souls	imimoya; 
sound	 -philile; umsindvo; 
sounds	imisindvo;  -philile; 
source	 indzabuko; umtfombo; 
sources	imitfombo; Tindzabuko;  imitfombolwati; 
sourcing	 umtfombo; imitfombolusito; 
south	eningizimu;  ngaseningizimu; 
southern	eningizimu;  ngaseningizimu; 
sovereign	 -bukhosi; inkhosi; bukhosi; 
space	indzawo;  sikhala;  umkhatsi; 
spaces	tikhala; 
spatial	indzawo; 
speak	khuluma; 
speakers	tikhulumi; 
speaking	khuluma; 
speaks	khuluma; 
spear	sikhali; 
special	 -khetsekile; luhlobo lolwehlukile; 
specialisation	likhono lelikhetsekile;  kugcila kulokutsite; lokukhetsekile; 
specialised	likhono lelikhetsiwe; 
specially	ikakhulu; 
specifically	ikakhulu; 
specifications	kucacisa; 
specified	condzanisa ngco; 
specify	condzanisa ngco; 
specimen	sifaniselo; 
specimens	emasampuli;  imifaniselo; 
spectacular	-jabulisako; 
spectrum	umkhakha; 
speech	 kukhuluma; inkhulumo; 
speeches	tinkhulumo; 
speed	sivinini;  litubane; 
speedy	ngekushesha; 
spend	sebentisa imali; 
spending	-citsa; kusebentisa imali; 
spent	citsa sikhatsi;  sebentisa imali; 
sphere	indingilizi; 
spheres	indingilizi; 
spirit	umphefumulo; 
spiritual	 -mphefumulo;  -kwemoya; kwemoya; 
split	 ehlukanisa; hlukana; 
spoke	khulumile; 
spoken	khuluma; 
spokesperson	 lokhulumela labanye; sikhulumi; 
sponsor	sekela; 
sponsored	 sekelwe; umesekeli; sekela; 
sport	umdlalo; 
sporting	umdlalo;  kudlala imidlalo; 
sports	umdlalo; 
spotlight	lilambu lelinemandla; lilambu; 
spouse	umlingani; 
spouses	Labashadene;  labatsesene; 
spread	hlanyela; 
square	 sikwele; inkhundla;  kwela phindzaphindza ngaleyo nombolo; 
stabilise	tintisa; 
stability	kutinta; 
stable	sitebele; 
stadium	inkhindla yetemdlalo; 
stadiums	tinkhundla tetemdlalo; 
staff	 sitafu; basebenti; 
stage	 libanga;  sigcawu; sigaba;  siteji; 
stages	 emabanga;  tinkhundla; tigaba; titeji; 
staging	tigaba tesifo; 
stakeholder	lotsintsekako;  umhlanganyeli; 
stakeholders	 bahlanganyeli; labatsintsekako; 
stalwart	sicumama; 
stalwarts	tetsenjwa letinkhulu; 
stamp	sitembu; 
stance	kuma; 
stand	 indzawo yekubukela; kwekuma; 
standard	 libanga;  umgomo; lizinga; 
standardised	bekwe ezingeni; 
standardization	 kubekwa ezingeni; 
standards	 emazinga; imigomo;  emabanga; 
standing	 tindzawo tekubukela; kwekuma; 
stands	 indzawo yekubukela; kwekuma; 
stanza	indzima; 
star	inkhanyeti; 
stars	tinkhanyeti; 
started	-cala; 
starting	-cala; 
starts	-cala; 
state	 bunjalo;  umbuso; live; 
state-owned	kwembuso; 
stated	kusho lokutsite; 
statement	 sitatimende; umbiko; 
statements	sitatimende; 
states	emave;  bunjalo;  imibuso; 
stating	 kubeka emavi; kusho; 
station	siteshi; 
stationery	kwekubhala; 
stations	titeshi; 
statistical	lubalobalo; 
statistician-general	solubalobalo jikelele; 
statue	umfanekiso lobatiwe; 
stature	umumo; 
status	simo; 
statute	umtsetfo; 
statutes	imitsetfo; 
statutory	umtsetfo; 
stay	hlala; lahleka; 
steadily	ngekungaphatami; 
steal	ntjontja; 
steel	insimbi; 
steer	condzisa; 
steering	condzisa; 
step	 libanga; sinyatselo; 
steps	tinyatselo;  emabanga; 
sterling	ncomeka kakhulu; kuhle kakhulu; 
still	thulisa; 
stimulating	vusa; 
stipulate	phawula; 
stipulated	beka kucace; 
stock	 sabelo; imfuyo;  sitoko; 
stolen	ntjontja; 
stone	khokha; 
stood	 indzawo yekutsengisela; indzawo yekubukela; 
stop	mani;  yekela; 
storage	kulondvolota; 
store	 indzawo yekubeka timphahla;  londvolota; khweta; 
stored	 londvolotiwe; beka;  londvolota; khweta; 
stories	tindzaba; 
storm	siphepho; 
story	indzaba; 
storytellers	bacocindzaba; 
storytelling	kucoca indzaba; 
strategic	ngelisu; 
strategies	emasu; 
strategy	lisu; 
stream	umfudlana; 
streams	imifudlana; 
street	kugcizelela;  sitaladi; 
streets	tindlela;  titaladi; 
strength	emandla; 
strengthen	cinisa; 
strengthened	cinisiwe; 
strengthening	cinisa; 
stress	 gcizelela;  kudzinwa kwengcondvo; kudzinwa; 
strides	tinyatselo; 
strike	 sitelega; teleka; 
string	intsambo; 
strip	sicephu;  umtiya; 
strips	imicu; 
strive	lwa; 
striving	phokophela; 
strong	tinyatselo; 
stronger	kuba nemandla; 
strongly	kuba nemandla; 
struck	shaya; 
structural	ngekweluhlelo; 
structured	Sakheko; -akha;  kwakheka; 
structures	 takhiwonchanti; takhiwo; Takheko; 
struggle	kushikashikeka; 
struggles	 kushikashikeka; imishikashika; 
struggling	shikashikeka; kushikashikeka; 
student	umfundzi; 
students	bafundzi; 
studies	kufundza;  tifundvo; 
studio	indlu yekusakata; 
studios	titjudiyo; emagumbi ekusakata; 
study	kufundza; 
style	 sitalo sembali; indlela;  sitayela; 
sub-item	intfo lencane; 
sub-programme	luhlelo loluncane; 
sub-regulation	umtsetfomgomo lomncane; 
subject	 umenti;  lophansi kwembusi; ingcikitsi; 
subjected	beka ngaphansi kwemtsetfo; tingcikitsi;  bomenti;  labangaphansi kwembusi; 
subjects	 tihloko;  lokukhulunywa ngako;  tingcikitsi; tifundvo; 
submissions	tetfulo; 
submit	ngenisa; 
submitted	ngenisiwe; 
submitting	ngenisa; 
subparagraph	indzima lencane; 
subpoenaed	lisamane lekubitela fakazi enkantolo; 
subscribe	bhalisa; 
subscribed	bhalisile; 
subsections	tigatjana; 
subsequent	landzela lapho landzelako; 
subsequently	ekugcineni; 
subsidiary	satitako; 
subsidies	imali yeselekelelo; 
subsidy	imali yekulekelela; 
subsistence	kuphila; 
substance	 lutfo; intfo; 
substances	tintfo; 
substantial	bonakalako; 
substantially	ngalokubonakalako; 
substantive	sobito; 
substitute	vala;  melela;  lokutsatse indzawo;  lovala lophumako; 
substituted	 faka lokunye endzaweni yalokunye; vala;  melela; 
substitutes	faka lokunye endzaweni yalokunye; timeleli; 
substituting	 kuma esikhundleni salokunye; kuvala sikhundla salophumako; kuvala sikhundla salomunye;  melela; 
substitution	 kuntjintja umdlali; kuvala; 
succeed	vala; 
succeeded	phumelela; 
success	imphumelelo; 
successes	timphumelelo; 
successfully	ngemphumelelo; 
succession	kulandzelana esikhundleni; 
successor	lolandzelako esikhundleni; 
such	njenge;  lokunjalo; 
suffer	vani buhlungu; hlupheka; 
suffered	vile buhlungu; hluphekile; 
suffering	 kuva buhlungu; buhlungu; 
sufficient	 -enele; enele; 
sufficiently	ngalokwenele; 
sugar	shukela; 
suggested	phakamisa; 
suggestion	siphakamiso; 
suggestions	imibono;  tiphakamiso; 
suggests	phakamisa; 
suitable	fanele; 
suitably	fanele; 
sum	 samba; sibalo; 
summary	 umbuseketo; sifinyeto; 
summer	lihlobo; 
summit	 ingcungcutsela; sicongo; 
summits	tingcungcutsela; ticongo; 
summoned	bitwa; 
sun	lilanga; 
sung	hlabele; 
superior	-ngetulu; 
supervisees	gadza; 
supervision	 kwelusa; kuhlola; 
supervisory	kugadza; 
supplied	niketa; 
supplier	umphakeli; umtfulitinsita; 
suppliers	batfulitinsita; baphakeli; 
supplies	timphahla; 
supply	 phakela;  imphahla lekhona; tidzingo;  lokukhona; 
support	 sisekelo; sekela;  ondla; 
supported	 sisekelo; sekela;  -ondla; 
supporting	sekela;  -ondla; 
supportive	kwesekela; 
supports	 sisekelo; sekela;  -ondla; 
supposed	cabangakinjalo; 
supreme	phakeme; 
sure	cinisekile; 
surely	mbamba; -cinisile; 
surface	 lingephandle;  kulolonga; lingetulu; 
surplus	 insalela; lokusele; 
surrender	kutinikela; 
surrounding	tungeletile; 
surveillance	kugadza; 
survey	phenya; 
surveyor	umhloli; 
surveyors	bahloli; bapopoli; 
surveys	tinklayo; 
survival	kusindza; 
survive	phila; 
surviving	phila; 
suspect	sola; umsolwa; 
suspected	Solwa;  -solile; 
suspects	basolwa; 
suspend	misa; 
suspended	misa; 
suspension	kumisa; 
suspensions	 kuyekelisa;  kuyekeliswa; kumisa; 
sustain	gcina; 
sustainability	kulondvolota; kuchubekela embili ngalokungenamkhawulo; 
sustainable	kuchubekela embili ngalokungenamkhawulo; 
sustained	gcina; 
sustaining	gcina; 
swear	tfuka;  funga; 
swearing	tfuka;  funga; 
switch	chafata; 
sworn	fungile; 
symbol	luphawu; 
symbolic	luphawu; 
symbolically	ngekweluphawu; 
symbolises	khombisa; 
symbolism	luphawu; 
symbols	timphawu; 
symposium	umhlangano; 
symptom	luphawu; 
symptoms	timphawusifo; 
system	 luhlelo;  inchubo; indlela; 
systematically	ngekweluhlelo; 
systemic	ngekweluhleo; 
systems	 tinhlelo;  tinchubo; tindlela; 
table	 litafula; lithebula; 
tabled	beka etafuleni; -etfula; 
tables	ematafula;  emathebula; 
tabling	kwetfula; 
tackle	-makha; 
tags	emathegi; 
take	tsatsa; sicephu; 
taken	tsetfwe;  tsatsiwe;  -tsetfwe; 
takeover	tsatsa; 
takes	tsatsa;  ticephu; 
taking	tsatsa; 
tale	insimu; 
talent	siphiwo;  lithalenta; 
talented	-nesiphiwo; 
talents	 tiphiwo; emathalenta; 
tales	tinganekwane; 
talk	khuluma; 
talking	khuluma; 
talks	khuluma; 
tangible	 bonakalako; phatsekako; 
tap	impompi; 
tape	ithephu yekukala; 
target	inhloso; 
targeted	condza; 
targeting	condza; 
targets	tinhloso; 
tariff	linani lelibekiwe; 
tariffs	tinhlawulo; 
task	umsebenti; 
tasked	kunikwa umsebenti; 
tasks	imisebenti; 
taught	fundzisa; 
tax	 umtselo; intsela; 
taxable	khokhelwa intsela; 
taxation	kutsela; 
taxed	tseliswa; 
taxes	 imitselo; tintsela; 
taxi	 ematekisi; itekisi; 
taxpayer	umkhokhintsela; 
taxpayers	bakhokhintsela; 
teach	fundzisa; 
teacher	thishela; 
teachers	bothishela; 
teaching	kufundzisa; 
team	licembu; 
teams	emacembu; 
teaser	sibangakwenta; 
technical	kwelwati lolutsite; 
technicians	bosobuciko; 
technique	lisu;  buciko; 
techniques	 buciko; emasu; 
technological	-kwebuchwepheshe; 
technologies	bucwepheshe; 
technology	buchwepheshe; 
telecommunication	kuchumana ngelucingo; 
telephone	lucingo;  shaya lucingo; 
television	 mabonakhashane; ithelevishini; 
tell	tjela; 
telling	tjela; 
tells	tjela; 
temporarily	kwesikhashana; 
temporary	kwesikhashana;  sikhashana; 
ten	lishumi; 
tend	vama; 
tender	ithenda; 
tendered	kungenisa; 
tenders	emathenda; 
tension	kuntsala;  mdvonseni; 
tenure	sikhatsi sekuba sesikhundleni; 
term	 sikhatsi lesibekiwe; ligama;  lithemu; 
terminate	bhubhisa;  ncamula; 
terminated	 ncamulile; bhubhisile; 
termination	 kuncamula; kubhubhisa; 
terminology	isayensi yelwatimagama; 
terms	imibandzela; 
terrestrial	kwemhlaba; 
territorial	indzawo; 
territories	tigodzi;  iminyele; 
territory	 umnyele; sigodzi; 
terrorism	bumbuka; 
tertiary	kwesitsatfu;  lokuphakeme; 
test	 kuhlola;  sivivinyo;  vivinya; luhlolo;  hlola; 
tested	kuhlola;  vivinya;  hlola; 
testimony	bufakazi; 
testing	 kuvivinya;  kuhlola;  vivinya; luhlolo;  hlola; 
tests	 tinhlolo; tihlolo; tivivinyo; 
text	lokucuketfwe; 
than	kuna-; 
thank	bonga; 
thanks	bonga; 
that	loko; 
that's	kwa-; 
the	i-; 
theater	ligumbi lekuhlindzela; itiyetha; 
theatres	ligumbi lekuhlindzela;  tinkhindla temidlalo yasesiteji; 
theft	kuntjontja; 
their	kwabo; 
them	bonakalako; 
theme	umongo;  umgogodla wendzaba; 
themes	tingcikitsi;  tingcikitsi; imigogodla yetindzaba; 
themselves	bonakalako; 
then	 kwabese; bese; 
therapy	kwelapha; 
there	 lapho; khona; 
thereafter	ngemuva kwaloko; 
thereby	umphumela; 
therefore	ngako-ke; 
therein	lapho khona; 
thereof	ngako-ke; 
thereon	kusukela lapho; 
thereto	kulokushiwo; 
thereupon	 masinyane ngemuva kwaloko; kulokushiwo; 
therewith	ngaloko; 
these	 laba; loku; 
they	baya; 
thing	intfo; 
things	tintfo; 
think	cabanga; 
thinking	 cabanga; kucabanga; 
third	 kwesitsatfu; kunye; 
thirdly	kwesitsatfu; 
thirds	kwesitsatfu; kunye kulokutsatfu; 
thirty	emashumi lamatsatfu; 
this	loku; 
thorough	ngalokuphelele; 
those	 leto; labo; 
though	noma; 
thought	cabanga; 
thoughts	imicabango; 
thousand	 nkhulungwane; inkhulungwane; 
thousands	tinkhulungwane; 
threat	kwesabisa; 
threaten	sabisa; 
threatened	sabisa; 
threats	kwesabisa; 
three	kutsatfu; 
three-day	lilanga lesitsatfu; 
three-year	umnyaka wesitsatfu; 
threshold	linani lelincane lelidzingekako; 
thriving	kuphokophela; 
throughout	kuko konkhe;  kuso sonkhe sikhatsi; 
thus	ngako-ke; 
ticket	lithikithi; 
ticketing	kukhipha emathikithi; 
tickets	emathikithi; 
tie	 ithayi; kubambana; 
tiers	imikhakha; 
ties	 bothayi; kubambana; 
till	kute kube; ithili; 
time	sikhatsi; 
timeframes	tikhatsi letibekiwe; 
timely	ngesikhatsi lesifanele; 
times	phindzaphindza; 
tirelessly	ngekungadzinwa; 
title	sihloko; 
titled	sihloko; 
titles	tihloko; 
to	ku-; 
tobacco	ligwayi;  imboza; 
today	lamuhla; 
together	ndzawonye; 
toilet	 indlu lencane; umthoyi; 
toilets	imithoyi;  tindlu letincane;  tindlu tangasese; 
told	tjelile; 
tolerance	kubeketela; 
tomorrow	kusasa; 
tonight	lamuhla ebusuku; 
tons	emathani; 
too	futsi; 
took	tsese; tsetse; 
tool	sikhali;  lithulusi; 
toolkit	ikhithi yemathulusi;  libhokisi lemathulusi;  sikhwama semathulusi; 
tools	 emathulusi; tikhali; 
top	sicongo; 
topic	sihloko; 
topics	tihloko; 
total	samba; 
totalled	samba; 
touch	kutsintsa; 
tough	matima; -cinile; 
touring	kuvakasha; 
tourism	tekuvakasha; 
tourist	sivakashi; 
tourists	tivakashi; 
tournament	ithonamenti; 
tournaments	emathonamenti; 
tours	luhambokuvakasha; 
toward	dvutane;  kuya embili; 
towards	dvutane;  kuya embili; 
town	lidolobha; 
towns	emadolobha; 
township	lilokishi; 
townships	emalokishi; 
trace	 luphawu; tfola;  tsatsisa;  landzelela; 
track	luhala; 
trade	 kutsengiselana;  kuhweba; umsebenti;  tsengisa; 
trading	kuhweba; 
tradition	indzabuko;  umhambo; 
traditional	 -kwendzabuko; -ngekwendzabuko; 
traditionally	ngalokwetayelekile;  ngekwelisiko; 
traditions	Tindzabuko; imihambo;  emasiko; 
traffic	kuphitsitela kwetimoto; 
trafficking	kushushumbisa;  kuphitsitela kwetimoto; 
tragedy	inhlekelele;  imbangalusizi; 
tragic	inhlekelele; 
train	sitimela;  cecesha;  fundzisa; 
trained	 cecesha; fundzisa; 
training	 kucecesha; kufundzisa; 
trajectory	kuhamba kwenhlavu yesibhamu; indlela; 
transaction	kutsengiselana; 
transactions	kutsengiselana; 
transfer	 kukhiphela;  ntjintja; susa;  kudlulisela; 
transferred	 kukhiphela;  ntjintja; susa;  kwendlulisela;  kudlulisela; 
transferring	 kundlulisela;  kukhiphela;  ntjintja; susa;  kwendlulisela; 
transfers	kuntjintja;  kundlulisela;  kukhiphela;  ntjintja; lilungelo lebuninimphahla; 
transform	gucula; 
transformation	 kugucuka kwendzawo; ingucuko; 
transformed	kuguculiwe; 
transforming	kucula; 
transition	ingucuko; 
transitional	kwendlulela kulesinye simo; 
translate	humusha; 
translated	 hunyushiwe; humushiwe; 
translation	kuhumusha; 
translator	umhumushi; 
translators	bahumushi; 
transmission	kwengcisa; 
transmit	 dlulisa; sabalalisa; 
transmitted	sabalalisa;  ndlulisa; 
transparency	kungagodli; 
transparent	-bonakalisa ngale; 
transport	kutfutsa;  tfutsa; 
transportation	kutfutfwa;  kutfutsa; 
travel	luhambo; 
travelled	hambile; 
travelling	hamba; 
treasure	ingcebo; 
treasures	tingcebo; 
treasuries	imicebo; 
treasury	tetimali; 
treat	 elapha; phatsa; 
treated	 elapha; phatsa; 
treaties	tivumelwane; tivumelwano; 
treatment	kwelashwa; 
treaty	 sivumelwane; sivumelwano; 
tree	sihlahla; 
trees	tihlahla; 
trend	indlelatsite; 
trends	tindlelatsite; 
trial	kulinga;  kutsetfwa kwelicala; 
trials	kulinga;  kutsetfwa kwelicala; 
tribunal	inkantolo;  libandla leliteka emacala; 
tribunals	tinkantolo;  emabandla lateka emacala; 
tribute	kubonga; kutsela; 
tried	tama;  tamile; 
triple	phindzeke katsatfu; 
triumph	kwehlula; kuncoba; 
trophy	 indzebe; inkomishi; 
troupe	licembu; licembu lebadlali; 
truly	 ngempela; mbamba; -cinisile; 
trust	tsemba; 
trustee	lilunga;  umphatsi lobekiwe; 
trustees	emalunga;  baphatsi lababekiwe; 
trusts	sikhwama; ithrasti; 
truth	liciniso; 
try	tama; 
trying	tama; 
turfs	lisoyi;  indzawo yekugijima emahhashi; sidzindzi; 
turn	jikisa; kujika; jika; 
turnaround	gucuka; jika; 
turned	 jikisiwe; kujika; guculiwe; 
turning	umgobo; 
turnover	imali lezuzwe ibhizinisini; 
twelve	lishumi nakubili; 
twentieth	kwemashumi lamabili; 
twenty	emashumi lamabili; 
twice	kabili; 
twitter	i-twitter; 
two	 bili; kubili; 
two-day	emalanga lamabili; 
two-thirds	tincenye letimbili talokutsatfu; 
type	luhlobo; 
types	tinhlobo;  luhlobo; 
typically	jwayelekile;  vamile; 
ultimate	ekugcineni; 
ultimately	ekugcineni; 
unable	ngakhoni; 
unacceptable	akwemukeleki; 
unanimous	longatiwa; kuvumelana; akawatiwa; 
unauthorised	akukagunyatwa;  akukavunywa; 
uncertainty	kungaciniseki; 
unconstitutional	-phambene nemtsetfosisekelo; 
under	phasi; 
underdevelopment	kungatfutfuki; kungatfutfukiswa; 
undergo	kwentiwa lokutsite;  ngenela lokutsite; 
underlying	-ngaphansi; 
undermine	bukela phasi;  tsatsela phasi; 
underpin	sekela; miselwa-; 
understand	kucondzisisa; 
understanding	kucondza; 
understood	visisa; 
undertake	yenta; 
undertaken	yentile; 
undertaking	yenta; 
undertook	yentile; 
underwater	ngaphasi kwemanti; 
underway	kuyentiwa; 
undue	 ngakabitwa; jeziza ngelunya; ngafanele; 
unemployed	kungasebenti; 
unemployment	kungasebenti; 
unfair	 -ngakalungi; ngafanele; 
unfortunately	 ngenhlanhla lembi; ngelishwa; 
unhappy	ngajabuli; 
unified	kuhlanganisa; 
uniform	 inyufomu; -fanako; 
unify	kuhlanganisa; 
union	 inhlanganiso; inhlangano; 
unions	tinhlangano;  tinhlanganiso;  tinyonyana; 
unit	 iyunithi; bunye; 
unitary	phatselene nebunye; 
unite	hlanganisa; 
united	-hlangene; 
units	emayunithi;  imivo; 
unity	bunye; 
universal	fananako; 
universe	konkhe lokukhona; 
universities	emanyuvesi; 
university	inyuvesi; 
unknown	akwatiwa; 
unlawful	akukho emtsetfweni; 
unleash	khulula; 
unless	ngaphandle nangabe-; 
unlike	akufani; 
unlikely	angeke kwenteke; 
unnecessary	kute sidzingo; 
unprecedented	akukate sekube khona phambilini; 
unqualified	ngafaneleki; 
unreasonable	kungevisisi; kubete ingcondvo; 
unregistered	akukabhaliswa;  awukabhaliswa; 
unsafe	akukaphephi; 
until	kute kube; 
untold	 akukhulunywa; akatjelwa; 
unusual	akukavami; 
unveil	vula; 
unveiled	vula; 
unveiling	vula; 
up	etulu; 
upcoming	lokutako; 
update	kwakamuva; 
updated	kwentiwe kwaba kwanyalo; 
updates	kwakamuva; 
upgrade	tfutfukisa; 
upgraded	tfutfukisiwe; 
upgrades	tfutfukisa; 
upgrading	tfutfukisa; 
uphold	 vumela; sekela; 
uploading	 kukhipha idokhumenti kungcondvomshini; kukhipha idokhumenti ku-inthanethi; 
upon	ngetulu kwa-; 
urge	inshisekelo; 
urged	ncenga; 
urgency	kuphutfuma; 
urgent	phutfumako; 
urgently	ngalokuphutfumako; 
urges	tinshisekelo; 
us	tsine; 
usage	kusebentisa; 
use	 kusetjentiswa; umsebenti; 
used	setjentisiwe; 
useful	kulusito;  kuba lusito; 
user	umsebentisi; 
users	basebentisi; 
uses	 kusetjentiswa; umsebenti; 
using	kusetjentiswa;  sebentisa; 
utilisation	kusebentisa; 
utilise	sebentisa; 
utilised	setjentisiwe; 
vacancies	tikhala; 
vacancy	sikhala; 
vacant	vulekile; kute; 
valid	kuyasebenta, liciniso; 
validity	kuciniseka;  sicinisekiso lesisemtsetfweni; 
valley	sigodzi; 
valuable	-ligugu; 
valuation	kuhlola; 
value	intsengo;  bungako; 
valued	intsengo; tsandvwako; 
values	imihambo;  imihambo nemagugu; 
van	iveni; 
variation	kuntjintjantjintja; 
varied	hlukahlukana; 
varies	ntjintjantjintja; 
variety	kwehlukahluka; 
various	hlukahlukune; 
varying	ntjintjantjintja; 
vast	-nyenti kakhulu; 
vehicle	 sitfutsi; incola; 
vehicles	 timotolo; titfutsi;  tincola; 
vendor	lotsengisa endleleni; 
venture	kulinga;  linga; 
ventures	 kulinga; emalanga; 
venue	 inkhundla; indzawo; 
venues	 tindzawo; indzawo; 
verification	kucinisekisa; 
verify	cinisekisa; 
version	luhlobo; 
very	kakhulu; 
vessel	umtsambo;  umkhumbi; 
vested	nikiwe; 
veterans	tigayigayi; 
via	endlula; 
viability	 kukhona kwenta lokutsite; kwenteka; 
viable	 kukhona kwenta lokutsite; kwenteka; 
vibrant	kuba nemandla; 
vice-chairperson	lisekela lasihlalo; 
victim	umhlukunyetwa; 
victims	umhlukunyetwa; 
victor	umncobi; 
victory	kuncoba; 
video	ividiyo; 
videos	ividiyo; 
viewed	-bukile; 
viewing	kubuka; 
views	Imboniso/imibono; 
village	lidolobhana; 
villages	lidolobhana; 
violation	kwephula; 
violations	kwephula umtsetfo; 
violence	ludlame; 
violent	kuba nebudlova; 
virtually	cishe;  lokungukona; 
virtue	emandla;  ligunya; 
visa	ivisa; 
vision	 umbono; kubona; 
visionary	kucabangela embili; 
visit	kuvakasha; vakasha; 
visited	 vakashile; vakashela;  vakashele-; 
visiting	kuvakasha; 
visitor	sivakashi; 
visitors	sivakashi; 
visits	kuvakasha; 
visual	-sibonwa;  bonakalako; 
visually	kubona; 
vital	balulekile; 
vocational	-phatselene nemsebenti; 
voices	 kuvakalisa livi; emavi; 
void	kungabi nalutfo; kuba lite; 
volatility	kukhwamuka; kunyamalala; 
volume	umtsamo; 
voluntarily	kutivumela; 
voluntary	kutivumela; 
volunteers	emavolontiya; 
vote	khetsa;  kukhetsa;  ivoti; 
voted	khetsa;  kukhetsa; -votile; 
voter	umkhetsi; 
voters	labavotako; umkhetsi; 
votes	khetsa; emavoti;  kukhetsa;  ivoti; 
voting	kuvota; 
vulnerability	kuba sengotini; 
vulnerable	-labasengotini; 
wage	 liholo; umholo; 
wages	imiholo; 
waiting	kulindza; 
walk	hamba; 
walks	hamba; 
wall	umtsangala;  lubondza; 
walls	 imitsangala; tibondza; 
want	 sifiso; sidzingo; 
wanted	 dzinga; sifisa; 
wants	funa; 
war	imphi; 
wards	emawodi;  tigceme; 
warm	futfumele; 
warmth	kufutfumala;  imfudvumalo; 
warning	 layalako; umyalo; 
warrant	incwadzimvume; nika emandla; 
warrants	nika emandla;  tincwadzimvume; 
wars	timphi; 
was	beka-; 
waste	 imfucuta; tibi; 
watch	liwashi; 
water	 nisela; emanti;  tselela;  natsisa; 
waters	 nisela; emanti; 
way	indlela; 
ways	tindlela; 
we	tsine; 
we've	besi-; 
weakness	butsakatsaka; 
weaknesses	butsakatsaka; 
wealth	umcebo; 
weapon	sikhali; 
weapons	tikhali; 
weather	simo selitulu; 
web	bulembu; 
website	iwebhusayithi; 
websites	emawebhusayithi; 
week	liviki;  lisontfo; 
week-long	liviki lonkhe; 
weekend	imphelasontfo; 
weeks	emaviki;  emasontfo; 
weight	 sikalo;  kala; sisindvo; 
welcome	-mukelekile; 
welcomed	-mukelekile; 
welcomes	-mukela; 
welcoming	-mukela; 
welfare	inhlalakahle;  sonhlalakahle; 
well	umtfombo; 
well-being	kuphila kahle; 
well-known	dvumile;  yati kakhulu; 
wellbeing	kuphila kahle; 
went	hambile; 
west	 ngasenshonalanga;  inshonalanga; enshonalanga; 
western	kwasenshonalanga; 
wetland	sitete; 
wetlands	tihlambo; 
what	ini; 
what's	ini; 
whatever	noma ngabe yini; 
whatsoever	noma ngabe yini; 
when	nini; 
whenever	noma kunini; 
where	kuphi; 
whereas	kantsi; 
whereby	lapho khona; 
whereupon	lapho khona; 
wherever	noma kuphi; 
whether	noma; 
which	kuphi; 
whichever	noma ngukuphi; 
while	ngesikhatsi-; 
whilst	ngesikhatsi-; 
whips	tinswebhu; 
white	mhlophe; 
whites	 lokumhlophe; labamhlophe; 
who	bani; 
whole	phelele; 
wholesale	ihholiseyi; kutsengisa ngebunyenti; 
wholly	ngalokuphelele; 
whom	bani; 
whose	kwabani; 
why	leni; 
wide	banti; 
widely	ngalokubanti; 
wider	bantana; 
widespread	kwandza yonkhe indzawo; 
wife	umfati; 
wild	singanga; kungalawuleki; 
will	kuvuma;  incwadzi yekwaba lifa; 
willing	kuvuma; 
willingness	kuvuma; 
win	ncoba; 
wind	umoya; 
winding-up	kuphetsa; 
window	 lifasitela; lifasitelo; 
wine	iwayini; 
winner	umncobi; 
winners	bancobi; 
winning	kuphumelela;  kuwina; 
winter	busika; 
wisdom	kuhlakanipha;  inhlakanipho; 
wish	 fisa; sifiso; 
wishes	tifiso; 
wishing	kufisa; 
with	na-; 
withdraw	kukhipha imali; 
withdrawal	 kukhipha; kuyekela;  kuphuma; 
withdrawn	kukhipha imali; 
within	ngekhatsi; 
without	ngaphandle kwa-; 
witness	fakazi; 
witnessed	bofakazi; 
witnesses	bofakazi; 
woman	umfati; 
women	bafati; 
women's	kwabomake; 
won	ncoba; 
wonderful	kuhle; 
wood	 lihlatsi; lukhuni; 
word	ligama; 
words	emagama; 
work	 sebenta;  imisebenti yebuciko; umsebenti; 
worked	-sebentile;  sebentile; 
worker	sisebenti; 
workers	tisebenti; 
workforce	basebenti; 
working	 sebenta; kusebenta; 
workplace	emsebentini; 
works	imisebenti;  imisebenti; 
workshops	 imihlanganosikolwa; Emashabhu; 
workspace	indzawo yekusebentela; emasebentini; 
world	umhlaba; 
world's	kwemhlaba; 
world-class	lokuphuma embili emhlabeni; 
worlds	imihlaba; 
worldwide	umhlaba wonkhe; 
worrying	kukhatsateka; 
worse	kubi kakhulu; 
worst	kubi kakhulu kakhulu; 
worth	kuyintfo lenhle;  kunenzuzo; 
worthy	 kunenzuzo; kuhle; 
would	nga-; 
wound	silondza;  limata; 
wounds	tilondza;  limata; 
write	bhala; 
writer	umbhali; 
writers	umbhali; 
writers'	kwebabhali; 
writing	kubhala; 
writings	imibhalo; 
written	 bhalwe-; -bhalile; 
wrong	ngakalungi;  -ngakalungi; 
wrote	bhala; 
xenophobia	kuzonda bachamuki; 
xenophobic	kuzonda bachamuki; 
year	umnyaka; 
year's	kwemnyaka; 
year-on-year	yonkhe iminyaka; 
years	iminyaka; 
yes	yebo; 
yesterday	itolo; 
yet	kantsi;  hhayi manje; 
yield	luphawu lekudedela lodlulako;  vuna; khicita; 
yields	 tivuno; imikhicito; khicita; 
you	wena;  nine; 
young	umntfwana; 
younger	-ncane kakhudlwana; 
your	wakho;  kwakho; 
youth	insha; 
zero	licandza; 
zone	umkhakha wemhlaba; 
zones	tindzawo;  imikhakha; 
