ABET	IABET; 
ACH	IACH; 
ANC	IANC; 
APRIL	uAprili; 
AU	IAU; 
Achebe	uAchebe; 
Adam	uAdam; 
Africa	iAfrika; 
Africa's	eyeAfrika; 
African	umAfrika; 
African-American	umMelika ongumAfrika; 
Africans	ama-Afrika; 
Afrikaans	isiBhulu; 
Ahmed	uAhmed; 
Albert	uAlbert; 
Alexander	uAlexander; 
Alexandra	uAlexandra; 
Alfred	uAlfred; 
America	iMelika; 
American	umMelika ; 
Andre	uAndre; 
Andrew	uAndrew; 
Angeles	iAngeles; 
Angola	iAngola; 
Apr	uApr; 
April	u-Apreli;  uAprili; 
Arab	umArabhu; 
Arcadia	eArcadia; 
Asian	umAsiya; 
Audios	 izixhobo zesandi; izixhobo ezivakalayo; 
Auditor	umvavanyi wesandi; umphicothi-zincwadi ; umphulaphuli-zandi; 
Australia	iAustralia; 
Austria	iAustria; 
Ave	umbuliso; 
BBC	IBBC; 
BRICS	IBRICS; 
Baba	usana; 
Bantu	abantu; 
Bay	igqabi lomthi elisisiqholo;  itheku; ukuthintela; 
Beginner's	eyoqalayo; 
Berlin	eBerlin; 
Bertha	uBertha; 
Blatter	uBlatter; 
Bloemfontein	iBloemfontein; 
Boer	uMfama; 
Botha	uBotha; 
Botswana	eBotswana; 
Brazil	iBrazili; 
Britain	iBrithani; 
British	eyaseBrithani; 
Burundi	eBurundi; 
CEOs	iiCEO;  amaGosa aPhezulu oPhumezo; 
CHAN	UCHAN; 
CNS	ICNS; 
COP	ICOP; 
CPA	ICPA; 
CPC	ICPC; 
CPT	ICPT; 
Canada	iKhanada; 
Cannes	eCannes; 
Caribbean	iCaribbean; 
Carnegie	iCarnegie; 
Castle	inqaba; iCastle; 
Cedar	umsedare; 
Chairman	uSihlalo; 
Charlotte	uCharlotte; 
Chinese	umTshayina; 
Chinua	uChinua; 
Christian	 uMkristu;  yobuKristu; umKrestu; 
Christmas	iKrismesi; 
Clerks	ooNobhala; 
Cllr	uCeba; 
Coetzee	uCoetzee; 
Commissioner	uMgunyaziswa; 
Confederations	iiMbumba;  iiManyano; 
Congo	eCongo; 
Cuba	iCuba; 
Cyril	uCyril; 
DBE	IDBE;  ISEBE LEMFUNDO ESISISEKO; 
DECEMBER	EYOMNGA; UDISEMBA; 
DG	 UMPHATHI-JIKELELE; UDG; 
DRC	IDRC; 
DSO	IDSO; 
Danny	uDanny; 
David	uDavid; 
Dec	uDis; 
December	uDisemba;  eyoMnga; 
Deregister	ukucima ubhaliso; 
Desmond	uDesmond; 
Dome	iDome; uphahla olungqukuva; 
Dominican	iDominican; 
Dr	uGqr; 
Drakensberg	uLundi; 
Dutch	iDutch; 
EC	 empuma-kapa; EEC; 
EFF	IEFF; 
Eddie	uEddie; 
Edinburgh	eEdinburgh; 
Elizabeth	uElizabeth; 
Ellen	uEllen; 
Emmanuel	uEmmanuel; 
England	iNgilani; 
English	isiNgesi; 
Ethiopia	iEthiopia; 
Europe	iYurophu; 
European	yaseYurophu;  umYurophu; 
Excellency	Mhlekazi; 
FEBRUARY	 eyoMdumba; uFebruwari; 
FRANCOIS	UFRANCOIS; 
FRIDAY	ULWESIHLANU; 
Feb	uFeb; 
February	 eyoMdumba; uFebruwari; 
Federal	uManyano; 
Filter	hluza; 
Florence	eFlorence; 
Fort	iNqaba; 
France	iFransi; 
Francis	uFrancis; 
Francois	uFrancois; 
French	iFrench; 
Friday	 lwesiHlanu; uLwesihlanu; 
Fridays	ooLwesihlanu; 
GB	IGB; 
GDP	IGDP; 
Gandhi	uGandhi; 
Gauteng	eGauteng; 
Gazette	iGazethi; 
George	uGeorge; 
German	iJamani; 
Germany	iJamani; 
Ghana	eGhana; 
Gina	uGina; 
Glossary	uLuhlu lweenkcazelo; 
God	uThixo; 
Guardian	uMlondolozi; 
HIV-positive	une-HIV; 
Hague	iHague; 
Handbook	iNcwadi yesikhokelo; 
Harare	eHarare; 
Hawks	ooKhetshe; iiHawk; 
Helen	uHelen; 
Hon	Obekekileyo; 
Howard	uHoward; 
Hugh	uHugh; 
Humphreys	ooHumphrey; 
I'm	ndi; 
ICT	I-ICT; 
India	eIndiya; 
Indian	umIndiya; 
Infecting	phembelelayo; sulelayo; 
Interjections	izigaxelo; izikhuzo; 
Islamic	isi-Islam; 
JANUARY	EYOMQUNGU; UJANUWARI; 
JULY	UJULAYI; EYEKHALA; 
JUNE	EYESILIMELA; UJUNI; 
Jacob	uYakobu; 
James	uJames; 
Jan	uJan; 
January	eyoMqungu;  uJanuwari; 
Japan	iJapan; 
Jewish	EyamaJuda; 
Joe	uJoe; 
Johannes	uJohannes; 
Johannesburg	iJohannesburg; 
John	uJohn; 
Johnson	uJohnson; 
Jonathan	uJonathan; 
Jordan	uJordan; 
Joseph	uYosefu; 
Jul	uJul; 
Julius	uJulius; 
July	uJulayi;  eyeKhala; 
Jun	UJUN; 
June	 eyeSilimela; uJuni; 
Kenya	eKenya; 
Keyword	intetho engundoqo; 
Kimberley	eKimberley; 
Kingsley	uKingsley; 
Korea	eKorea; 
Kruger	uKruger; 
KwaZulu-Natal	eKwaZulu-Natala; 
Kyoto	eKyoto; 
LIS	ILIS; 
Layla	uLayla; 
Lesotho	iLisuthu; 
LinkedIn	iLinkedln; 
Lisa	uLisa; 
London	eLondon; 
Lotteries	iiLotho; 
Lotto	iLotho; 
Lulu	uLulu; 
Luthuli	uLuthuli; 
MONDAY	UMVULO; 
MP	IMP; 
MPs	IIMP; 
MR	MNU; 
Mack	uMack; 
Madam	Nkosikazi; 
Mali	eMali; 
Mama	uMama; 
Mandela	uMandela; 
Mandela's	ekaMandela; 
Manuel	uManuel; 
Mar	uMar; 
Max	uMax; 
Maya	uMaya; 
Mayor	uSodolophu; 
Mbeki	uMbeki; 
Meanwhile	xeshikweni; 
Methodist	iWesile; 
Michael	uMichael; 
Miriam	uMiriam; 
Mme	Nkskz; 
Monday	uMvulo; 
Monterrey	eMonterrey; 
Moscow	eMoscow; 
Moses	uMoses; 
Mourns	ukuzilela; 
Mpumalanga	Empumalanga; 
Mr	Mnu; 
Mrs	Nkskz; 
NB	 QAPHELA; QWALASELA; 
NCR	INCR; 
NOVEMBER	uNovemba; EYENKANGA; 
Nadine	uNadine; 
Namibia	iNamibia; 
Natal	iNatala; 
Ndebele	isiNdebele; 
Neal	uNeal; 
Nelson	uNelson; 
Nelspruit	eNelspruit; 
Nene	uNene; 
Netherlands	eNetherlands; 
Newtown	eNewtown; 
Nigeria	eNigeria; 
Nigerian	umNigeria; 
Nkandla	eNkandla; 
Nobel	iNobel; 
Nov	uNov; 
November	uNovemba;  eyeNkanga; 
OC	IOC; 
OCTOBER	EYEDWARHA; UOKTOBHA; 
Obama	uObama; 
Oct	uOkt; 
October	 eyeDwarha; uOktobha; 
Offender's	eyomaphuli-mthetho; 
Oliphant	uOliphant; 
Oliver	uOliver; 
Olympic	iOlympic; 
Olympics	iiOlympic; 
Oscar	uOscar; 
PACs	iiPAC; 
PAP	IPAP; 
PC	IPC; 
Pan	iPan; 
Paris	eParis; 
Parliament's	eyePalamente; 
Paul	uPaul; 
Pele	uPele; 
Peter	uPeter; 
Petersen	uPetersen; 
Pietermaritzburg	ePietemaritzburg; 
Postpones	urhoxisa; 
Presidency	uBongameli; 
President's	eyoMongameli; 
Pretoria	ePitoli; ePretoria; 
Prince	 umlawuli welizwe elincinane; iNkosana; 
Pringle	uPringle; 
Prof	uNjingalwazi; 
Protector	uMkhuseli; 
RSVP	NCEDA UPHENDULE; 
Reginald	uReginald; 
Registrar	uMbhalisi; 
Rejoice	gcoba; vuya; 
Riverside	eRiverside; 
Robert	uRobert; 
Russia	eRashiya; 
Russian	uMrashiya; 
Rustenburg	eRustenburg; 
Ruth	uRuth; 
SA	MZANTSI AFRIKA; 
SA-UK	ISA-UK; 
SALSA	ISALSA; 
SAPS	ISAPS; 
SAX	ISAX; 
SCOPA	ISCOPA; 
SEPTEMBER	EYOMSINTSI; USEPTEMBA; 
SETA	ISETA; 
Sarah	uSarah; 
Sasol	iSasol; 
Saturday	uMgqibelo; 
Secretariat	oonobhala; 
Secretaries	oonobhala; 
Secretaries-General	ooNobhala-Jikelele; 
Self-Governance	uMazilawule; 
Senate	eyeeNgwevu; 
Senegal	eSenegal; 
Sep	uSep; 
September	 uSeptemba; eyoMsintsi; 
Shanghai	eShangai; 
Sharpeville	eSharpville; 
Sinclair	uSinclair; 
Skip	tsiba; 
Smith	uSmith; 
Sol	uSol; 
Soweto	eSoweto; 
Spain	eSpain; 
Stellenbosch	eStellenbosch; 
Steve	uSteve; 
Sudan	eSudan; 
Sunday	iCawa; 
Surname	ifani; 
Susan	uSusan; 
Swaziland	eSwazini; 
Switchboard	iziko leminxeba; 
TUESDAY	NGOLWESIBINI; 
TV	ITV; 
Tambo	uTambo; 
Tanzania	eTanzania; 
Tat	uTat; 
Tata	uTata; 
Tau	uTau; 
Temba	uTemba; 
Thabo	uThabo; 
Thomas	uThomas; 
Thursday	 ulweSine; Lwesine; 
Timbuktu	eTimbuktu; 
Transvaal	iTransvaal; 
Tshwane	eTshwane; 
Tuesday	uLwesibini; 
UK	IUK; 
UN	IUN; 
UNESCO	IUNESCO; 
URL	IURL; 
USA	IUSA; 
Uganda	IUGANDA; 
Umtata	UMTHATHA; 
Unsubscribe	 cima ubhaliso; cima umrhumo; 
Venice	iVenice; 
Victoria	eVictoria; 
WEDNESDAY	NGOLWESITHATHU; 
Walter	uWalter; 
Wednesday	uLwesithathu; 
William	uWilliam; 
Williams	ooWilliam; 
Wits	eWits; 
Witwatersrand	iWitwatersrand; 
Xhosa	isiXhosa; 
York	eYork; 
Yvonne	uYvonne; 
Zambia	eZambia; 
Zimbabwe	eZimbabwe; 
Zimbabwean	uMzimbabwe; 
ability	isakhono;  ukuba nako; 
able	nakho; ninakho, unakho; 
about	ngase; malunga; 
above	ngaphezulu; 
above-mentioned	exeliweyo ngentla; 
abroad	phesheya; 
absence	ukungabikho; 
abuse	ukuxhaphaza; 
abused	 tshabhisiwe; phethwe kakubi;  xhatshaziwe; 
academia	amalungu ezifundiswa; 
academic	emfundo ephakamileyo; 
academics	iakademiki; emfundo ephakamileyo; 
academies	 amaziko emfundo ephakamileyo; izikolo zemfundo ephakamileyo; iiakhademi; 
academy	iziko lemfundo ephakamileyo; iakhademi;  isikolo semfundo ephakamileyo; 
accelerate	ukukhawulezisa; 
accelerated	khawulezisile; 
accelerating	ukukhawulezisa; 
acceleration	ukunyuka kwesantya; 
accept	amkela; 
acceptable	eyamkelekayo; 
acceptance	 ukubukwa; ulwamkelo; 
accepted	amkelwe; 
accepting	amkela; 
access	 ukungena kwikhompyutha; ukungena; 
accessed	 ngenile kwikhompyutha; ngenile; 
accessibility	 ukungeneka; ukufikeleleka; 
accessible	ukufikelela; 
accession	 ulongezelelo; ufikelelo; 
accident	ingozi; 
accidents	iingozi; 
acclaim	 ncoma; bonga; thakazela;  qhwaba izandla;  dumisa; 
acclaimed	 dumisile;  qhwabe izandla;  thakazele; bongile;  ncomile; 
accommodate	qhelanisa; hlalisa; 
accommodated	hlalise;  qhelanise; 
accommodation	ukubona;  indawo yokuhlala; 
accompanied	khaphile;  ukhaphe ngesixhobo somculo;  phumelelisile; ubekhona; 
accompany	ukubakhona;  ukukhapha ngesixhobo somculo; 
accord	 ngqinelana; vumelana; 
accordance	ngokungqinelana; 
accorded	ngqinelene;  vumelene; 
according	ngoko; 
account	 i-akhawunti; ityala;  iakhawunti; 
accountability	uxanduva;  uxanduva lokuphendula; 
accountable	ukuba noxanduva lokuphendula; 
accountants	ababhali-zimali; 
accounted	ifakwe kwiakhawunti;  ifakwe kwityala; 
accounting	ucalulo-mali; 
accounts	 iiakhawunti; amatyala; 
accreditation	 uqinisekiso; ulwamkelo; 
accredited	amkelweyo; qinisekisiweyo; 
accruals	izongezeleko; 
accrue	ukwandisa amanani; 
accrued	kwandiswe amanani; 
accumulate	ukunyusa; 
accumulated	kunyuswe; 
accuracy	ukuchaneka;  ukuchana; 
accused	ummangalelwa; 
achieve	phumelela; 
achieved	phumelele; 
achievement	impumelelo; 
achievements	iimpumelelo; 
achieving	phumelela; 
acknowledge	ukuvuma; 
acknowledged	uvumile; 
acknowledges	ukuvuma; 
acquire	fumana;  ukurhwaphiliza; 
acquired	 uzuzile; ufumene; 
acquisition	ufumano;  imfuyo; inzuzo; 
act	 iqonga lemidlalo;  linganisa;  dlala eqongeni;  isenzo; umthetho; 
acted	dlale eqongeni;  wenzisile;  udlalile; ulinganisile;  udlale kwiqonga lemidlalo; 
acting	bambela; 
action	intshukumo; 
actions	iintshukumo; 
actively	 phaphileyo; khaliphileyo;  sebenzayo;  khutheleyo; 
activism	 ukuphapha; ubukhuthali;  ukuqabuka; ubukhalipha; 
activists	abazabalazi; 
activities	imisebenzi; 
activity	umsebenzi; 
actor	umdlali;  umdlali weqonga; 
actors	abadlali;  abadlali beqonga; 
actress	umdlali weqonga wasetyhini; 
acts	 udlala kwiqonga lemidlalo; wenzisile; dlala eqongeni;  udlalile;  ulinganisile; 
actual	eyona; 
actually	 ezinyanisweni; koko;  ngokwenyaniso;  ngokwenene; 
ad-hoc	lungiselelwe ijongo ethile; enzelwe injongo ethile; 
add	dibanisa;  yongeza; 
added	dityanisiwe;  yongeziwe; 
adding	dibanisa;  yongeza; 
additional	okongeziweyo; 
address	idilesi; 
addressed	ifakwe idilesi; 
addresses	ufaka idilesi; 
addressing	ukufaka idilesi; 
adds	dibanisa;  yongeza; 
adequate	anele; 
adequately	 ngokulingeneyo; ngokwaneleyo;  ngokufaneleyo; 
adhere	landela; 
adherence	ukulandela; 
adjourn	misela elinye ixesha; 
adjourned	miselwe elinye ixesha; 
adjudication	ubugwebi; isigwebo; 
adjust	lungelelanisa;  ukulungelelanisa ityala; 
adjusted	kulungelelaniswe ityala; lungelelaniswe; 
adjustment	ukuziqhelanisa;  ulungelelwaniso; 
adjustments	amalungelelwaniso; 
administer	ukulawula;  lawula; 
administered	kulawulwe; 
administering	ukulawula; 
administration	 ulawulo lokuzalisekiswa komthetho;  ukulawula; ulawulo; 
administrations	iinkqubo zolawulo; 
administrative	eyokuphatha;  eyolawulo; 
administrator	 umlawuli wephondo; umlawuli; 
administrators	 umlawuli wephondo; umlawuli; 
admissible	 evumelekileyo; eyamkelekileyo; 
admission	 imvumo-tyala; ukwamkela;  ulwamkelo; 
admit	vuma; 
admitted	vumile; 
adopt	ukwenza ukuba ngowakho;  amkela njengomntwana wakho; 
adopted	ukwenza ukuba ngowakho;  amkela njengomntwana wakho; 
adopting	ukwenza ukuba ngowakho;  amkela njengomntwana wakho; 
adoption	ukwamkelwa njengomntwana; 
adoptive	 omisa njengomntwana; owamkela njengomntwana ; 
adopts	ukwenza ukuba ngowakho;  amkela njengomntwana wakho; 
adult	umntu omdala; 
adults	abantu abadala; 
advance	 qhubela phambili; phambili;  imali enikezwa ngaphambi kwexesha; 
advancement	inkqubela-phambili; 
advances	 qhubela phambili; phambili;  imali enikezwa ngaphambi kwexesha; 
advancing	 qhubela phambili; phambili;  imali enikezwa ngaphambi kwexesha; 
advantage	uncedo; 
advantages	amancedo; 
advent	ukuza;  ukufika; 
adverse	 enembandezelo;  enobutshaba; engalunganga;  enamashwa;  enobubi;  echaseneyo; 
adversely	 ngembandezelo; ngobutshaba;  ngobubi;  ngokungalunganga; ngokuchaseneyo; 
adversity	 imbandezelo;  amashwa;  ubuhlwempu; ubunzima;  ububi; 
advertise	papasha;  -azisa; 
advertised	azisile; papashile; 
advertisement	intengiso; 
advertising	ukwazisa; 
advice	ingcebiso;  icebo; 
advise	 cebisa;  luleka; ukucebisa;  azisa; 
advised	 lulekilwe; azisiwe; cetyisiwe; 
adviser	umeluleki;  umazisi; umcebisi; 
advisers	abacebisi;  abaluleki;  abazisi; 
advisor	umcebisi; 
advisories	abacebisayo; 
advisors	abacebisi;  abaluleki;  abazisi; 
advocacy	inkxaso; 
advocate	 igqwetha lejaji; xhasa;  mela; 
advocates	xhasa;  mela;  amagqwetha ejaji; 
affairs	imicimbi; 
affect	-enza ukuba;  phembelela; 
affected	ukuchaphazeleka; 
affecting	-enza ukuba;  phembelela; 
affects	 iphembelela; ichaphazela; 
affidavit	ingxelo efungelweyo; 
affirm	 ngqina; ukungqina; 
affirmation	ingqinisekiso; 
affirming	 ngqina; ukungqina; 
affordable	efikelelekayo; 
afforded	ukubanakho; 
aforementioned	ekhankanyiweyo ngaphambili; 
aforesaid	exeliweyo ngaphambili; 
after	emva; 
afternoon	 emva kwemini; emalanga; 
again	kwakhona; 
against	chasene;  ngqubana; 
age	 iminyaka;  imihla; ubudala;  luphala; 
aged	 umntu omdala; ubudala;  ixhego;  ukwaluphala; 
agencies	abenzeli;  abaphatheli; 
agency	abalungiseleli; 
agent	 isenzisi;  isiguquli; umenzi;  i-arhente; 
agents	 isenzisi; abenzeli; ii-arhente;  iziguquli; 
ages	 iminyaka;  imihla; ubudala;  luphala; 
aggregate	umyinge; 
aggrieved	ukunganeliseki; 
ago	 kade;  kukade; kudala; 
agree	vuma; 
agreed	vumile; 
agreement	isivumelwano; 
agreements	izivumelwano; 
agrees	uvuma; 
agricultural	zolimo; 
agriculture	ezolimo;  ulimo; 
ahead	 qhubela phambili;  ixesha elizayo; ngaphambili; 
aid	uncedo;  siza; 
aids	siza;  amancedo; 
aim	 jolisa; injongo; 
aimed	joliswe; kujongwe; 
aims	 ijolise; iinjongo; 
air	umoya;  bethisa ngomoya; 
aircraft	 inqwelo yomoya;  inqwelomoya; inqwelo-moya; 
airport	isikhululo seenqwelo-moya; 
airports	izikhululo zenqwelomoya; izikhululo zeenqwelo-moya; 
albeit	 nakuba; nangona; 
alcohol	 i-alkoholi;  isinxilisi; ialkoholi; 
alert	lumkisa; 
align	lungelelanisa; 
aligned	lungelelanisiwe; 
alignment	ulungelelwano; 
alike	 fanayo; ngokufanayo; 
all	bonke;  onke;  ngokupheleleyo; 
allegation	 isityholo; ukutsho; 
allegations	izityholo; 
alleged	osolwayo; 
allegedly	ngokutsho; 
alleviate	ukudambisa; 
alleviation	udambiso; ukudambisa; 
alliance	umanyano;  umanyano lwabancedani; 
allocate	 abela; ukwaba;  -aba; 
allocated	 abela; ukwabiwa;  -aba; 
allocation	ulwabiwo; 
allocations	izabiwo; 
allow	ukuvumela; 
allowance	isibonelelo; 
allowances	izibonelelo; 
allowed	uvunyelwe; 
allowing	ukuvumela; 
allows	uvumela; 
almost	phantse; 
alone	wedwa;  odwa; 
along	kunye; 
alongside	ecaleni kwa-; 
already	se; sele; 
also	kananjalo;  kanjalo; 
alter	 guqula; tshintsha; 
alternate	 nokutshintsha-tshintsha;  ukuqakatha; bolekisana; 
alternative	enye indlela; 
although	 nakuba; nangona; 
always	 soloko;  lonke ixesha; rhoqo;  qho;  ngamaxa onke; 
am	ndi-; 
ambassador	ummeli-sizwe;  unozakuzaku; 
ambassadors	oonozakuzaku; abameli-sizwe; 
ambient	kuthe lwale; izirhanqo; 
ambit	umda; 
amend	ukulungisa;  ukuhlomela; 
amended	kuhlomelwe;  kulungisiwe; 
amending	ukulungisa;  ukuhlomela; 
amendment	isilungiso; 
amendments	izilungiso; 
amends	ulungisa;  uhlomela; 
amnesty	uxolelo mabanjwa; 
among	phakathi kwezinye;  phakathi kwabanye; 
amongst	phakathi kwezinye;  phakathi kwabanye; 
amount	 fikelela; ubungakanani;  isambuku; 
amounted	yenze; fikelele; 
amounting	 fikelela; yenza; 
amounts	fikelela; izimbuku; 
an	into; 
analogue	into efana nenye; 
analyse	 ukuhlahlela; hlalutya; 
analysed	hlalutyiwe; kuhlahlelwe; 
analyses	amahlahlelo; 
analysing	 ukuhlahlela; ukuhlalutya; 
analysis	uhlahlelo; 
ancestor	ukhokho;  isinyanya; 
ancestors	 ookhokho; izinyanya; 
ancient	 -mandulo; mandulo; 
and	kunye, ne; 
animal	 irhamncwa; isilwanyana; 
animals	izilwanyana;  amarhamncwa; 
annex	ukuhlomela; 
annexure	 isihlomelo; ufakelo;  isongezo; 
anniversary	isikhumbuzo sonyaka; 
announce	yazisa; 
announced	yazisile; 
announcement	isaziso; 
announcements	izaziso; 
announces	yazisa; 
annual	unyakamnye;  yeminyaka le; 
annually	unyaka nonyaka;  eminyaka ngeminyaka; 
annum	unyaka; 
another	enye; 
answer	impendulo;  isiphumo; 
answers	iziphumo;  iimpendulo; 
anthem	umhobe; 
anti-apartheid	ukuliwa kocalucalulo; 
anti-corruption	 ukuchasana nokungcola; ukuchasana nenkohlakalo; 
anti-pass	ukuchasana namapasi;  ukuchasana nepasi; 
anticipated	cinga kwangaphambili;  yenza kwangaphambili enza kuqala; 
any	 nayiphina; nayiphi; 
anyone	nabanina; 
anything	nantonina;  nayiphina into; 
apart	bucala; 
appeal	 ukubongoza;  ukubhena; isibheno; 
appealed	 velile; bhenile;  bongozile; 
appeals	izibheno;  izibongozo; 
appear	ukuvela;  ukubonakala; 
appearance	 inkangeleko; ukuvela; 
appeared	bonakele; 
appearing	ukuvela;  ukubonakala; 
appears	 ubonakala; uvela; 
appellant	umbheni; 
appendix	ithunjana; 
applaud	 ncoma; bonga; thakazela;  qhwaba izandla;  dumisa; 
applicable	elungele; 
applicant	umceli; 
applicants	umceli; 
application	 ukusebenzisa;  usetyenziso;  ukusetyenziswa;  ukusetyenziswa komthetho ngusompempe; isicelo; 
applications	 izisetyenziswa; izicelo; iintsebenziso;  ukusetyenziswa komthetho ngusompempe;  iinkqubo zekhompyutha; 
applied	ukusetyenziselwa; 
applies	cela; 
apply	ukucela; 
applying	ukucela; 
appoint	ukuqesha; 
appointed	ukuqesha; 
appointing	ukuqesha; 
appointment	ukuqeshwa; 
appointments	 amadinga; imimiselo;  iingqesho; 
appoints	ukuqesha; 
appreciate	ukuncoma;  bulela; 
appreciated	ukuncoma;  bulela; 
appreciates	ukuncoma;  bulela; 
approach	ukungena; 
approached	ngenile; 
approaches	ngena; 
appropriate	efanelekileyo;  fanelekileyo; 
appropriated	fanelekisile; 
appropriately	fanelekileyo; 
appropriation	 uhlahlo-mali; ukubekelwa; 
appropriations	amahlahlo-mali;  izabiwo; 
approval	imvume; 
approve	ukuvuma; 
approved	ukuvuma; 
approximately	 ngokusondeleyo; malunga; 
arbitration	ulamlo; 
arbitrator	umlamli; 
architect	umyili wezakhiwo; 
architects	izazi ngokwakhiwa kwezindlu;  abayili bezakhiwo; 
architectural	eyezakhiwo; 
architecture	ubugcisa bokwakha; 
archival	eyolondolozo lezibhaliweyo; 
archive	indawo yokulondoloza izibhalo ezibalulekileyo; 
archives	iindawo zokulondoloza ezibhaliweyo; 
area	ummandla;  inxalenye; 
areas	imimandla;  iinxalenye; 
arena	ibala; 
argue	ukuxoxa; 
argued	 xoxile; phikisene; 
argument	 impikiswano; ingxoxo; 
arguments	 iimpikiswano; iingxoxo; 
arise	 vela; ukusuka;  ukuma;  phakama;  ukuphuma; 
arises	 liyaphuma;  uyema; uyavela; uyasuka;  uyaphakama; 
arising	 esukayo;  ephakamayo; evelayo;  emayo;  ephumayo; 
arm	ingalo; 
armed	xhobile; exhobileyo;  xhotyisiwe; 
arms	izikhali; 
arose	phakeme;  mile; sukile;  vukile; 
arrange	ukucwangcisa;  cwangcisa; 
arranged	cwangcisiwe; kucwangcisiwe; 
arrangement	amalungiselelo; 
arrangements	amalungiselelo; 
array	misa ngezintlu; 
arrest	 bamba; ukubamba; 
arrested	 bamba; ukubamba; 
arrival	ukufika; 
arrive	 fika; ukufika; 
arrived	fikile; 
art	 umsebenzi wobugcisa; ubugcisa; 
artefacts	izinto ezenziwe ngezandla;  izinto eziyilwe ngumntu; 
article	 inqaku; impahla; 
articles	 amanqaku; iimpahla; 
articulate	 ukubiza ngokucacileyo; cacisa; 
articulated	bize ngokucacileyo;  cacisile; 
artist	igcisa; 
artistic	yobugcisa; 
artists	amagcisa; 
arts	 ubungcibi; ubuchule;  imisebenzi yobugcisa;  ubugcisa; 
artwork	 umsebenzi wobugcisa; imifanekiso nemizobo esencwadini;  imifanekiso nemizobo kushicilelo; 
artworks	imifanekiso nemizobo esencwadini;  imisebenzi yobugcisa;  imifanekiso nemizobo kushicilelo; 
as	 njengoko; xa; njenga;  kuba; 
ascertain	qononondisa;  qondisisa; qinisekisa; 
aside	 ecaleni; bucala; 
ask	buza; 
asked	buzile; 
asking	buza; 
asks	buza; 
aspect	isolotya; 
aspects	amasolotya; 
aspiration	 ulangazelelo;  uvuthelo; ukutsala; 
aspirations	amalangazelelo; imitsalane; 
assault	uhlaselo; 
assembly	 indlu yowiso-mthetho; ingqungquthela; 
assented	vumele;  vumile; 
assert	 ngqina;  banga; ukutsho; 
assess	 ukuxabisa; hlola; 
assessed	hlolile;  xabisile; 
assesses	 ukuxabisa; hlola; 
assessing	 ukuxabisa; hlola; 
assessment	uhlolo; 
assessments	amaxabiso; 
assessor	umncedisi-jaji; 
assessors	abancedisi-jaji; 
assets	onako wena; 
assign	 misela;  nyula;  nika; yaba; 
assigned	 nyuliwe;  nikiwe; yabelwe; miselwe; 
assignment	umsebenzi wophando; 
assist	ncedisa; 
assistance	uncedo; 
assistant	isandla;  umncedisi; 
assisted	uncediso; 
assisting	ukuncedisa; 
assists	ukuncedisa; 
associate	 ukunxulumanisa; iqabane; 
associated	 ukunxulumanisa; iqabane; 
association	unxulumano; 
associations	izinxulumano; 
assume	 thatha ngokungathi; cinga;  qala umsebenzi; 
assumed	qale umsebenzi; cinge;  thathe ngokungathi; 
assumptions	izenziso; iingcinga; 
assurance	isiqinisekiso;  isithembiso; 
assure	 thembisa; qinisekisa; 
assured	 thembisile; qinisekisile; 
astronomy	inzululwazi ngeenkwenkwezi; 
at	e-; 
atmosphere	iatmosfera;  umoya ongqonge umhlaba; 
atmospheric	 eyomoya ojikeleza umhlaba; umoya; eyeastmosfera; 
attach	ukudibanisa;  ukuthimba; 
attached	ukudibanisa;  ukuthimba; 
attachment	 unamatheliso; udibaniso;  uthimbo; ubuhlobo; 
attack	 hlasela; uhlaselo;  ukuhlasela; 
attacks	ukuhlasela; amahlaselo; 
attain	ukufikelela; 
attained	ukufikelela; 
attainment	ufikelelo; 
attempt	 ukulinga; ilinge; 
attempted	 lingile; zamile; 
attempts	amalinge; 
attend	ukubakho; 
attended	ukubakho; 
attending	ukubakho; 
attention	inyameko; 
attitude	umoya;  isimo; 
attitudes	izimvo;  izimo; 
attorney	igqwetha; 
attorneys	amagqwetha; 
attract	tsala; 
attracted	umtsalane; 
attribute	isimo; 
attributed	balelwe;  phawulelwe; 
auction	ifandesi; 
audience	 ababukeli; abaphulaphuli; 
audiences	 ababukeli; abaphulaphuli; 
audio	 isandi; evakalayo; 
audio-visual	ebonwa iviwa; 
audiovisual	izixhobo ezivakalayo nezibonakalayo ezincedisa ekufundiseni; 
audit	uphicotho- zincwadi;  ukuphicotha iincwadi zemali;  ukuphicotha iincwadi; 
audited	kuphicothwe iincwadi;  kuphicothwe iincwadi zemali; 
auditing	uphicotho- zincwadi;  ukuphicotha iincwadi zemali;  ukuphicotha iincwadi; 
auditor	umphicothi-zincwadi;  umphicothi zincwadi zemali; 
auditor-general	umphicothi-ziincwadi-jikelele; 
auditors	abaphicothi-zincwadi; 
audits	uphicotho- zincwadi;  ukuphicotha iincwadi zemali;  ukuphicotha iincwadi; 
august	endilekileyo; enesithunzi; 
auspices	izithembiso;  iinkuthazo; 
authentic	eyinyaniso;  eyenene; 
author	umbhali; 
authorisation	ugunyaziso; 
authorise	gunyazisa; 
authorities	amagunya;  iziphathamandla;  iingcali;  abasemagunyeni; 
authority	 isiphathamandla; igunya;  ingcali;  abasemagunyeni; 
authorization	ugunyaziso; 
authorize	gunyazisa; 
authorized	gunyaziwe; 
authors	ababhali; 
automated	sebenzisa oomatshini abazihambelayo; 
automatically	ngokuzenzekelayo; 
availability	 ukusebenziseka; ukufumaneka; 
avenue	iavenyu; 
avenues	iiavenyu; 
average	umndilili;  eavareji; 
aviation	uhambo ngomoya; 
avoid	 ukucezela;  nqanda; phepha; 
avoidance	ukuphepha;  intlonipho; 
awaiting	ukulindela; 
award	umvuzo;  imbasa;  nika; 
awarded	 iimbasa; imivuzo;  nikwe; 
awarding	 ukunika imbasa;  ukunika umvuzo; ukunika; 
awards	 iminikelo;  iimbasa; imivuzo; 
aware	ukuqonda;  qonda; 
awareness	 ukuqonda; ukwazi; 
away	 lahla; kude; ngekho;  susa; 
babies	iintsana; 
baby	usana; 
back	emva;  umva wolwimi;  umva wesandla;  umsundulo;  igxalaba; 
backdrop	 indawo engasemva; umva weqonga ozotyiweyo; 
background	 indawo engemva; imvelaphi; 
backgrounds	iimvelaphi; iindawo ezingemva; 
backlog	umsebenzi osalele emva; 
backlogs	imisebenzi esalele emva; 
bad	ngcolileyo; khohlakeleyo; bi;  bolileyo; 
bag	ingxowa; 
bail	ibheyile; 
bake	bhaka;  ukubhaka; 
baking	ukubhaka; 
balance	 intsalela; ukulingana;  isikali;  ukuzinza;  ukulinganisa;  ukulungelelanisa;  ukundindana;  ukuqoshelisa; 
balanced	lungeleleneyo;  zinzileyo; 
balances	 izikali;  iziqoshelisi;  izindindanisi; iintsalela;  imilinganiso;  izilungelelanisi;  izizinzisi; izilinganisi; 
ball	ibhola; 
ballet	umdlalo obalisa imbali ngokudanisa; 
band	ibhanti;  igubu; 
bank	ibhanki;  udonga lomlambo; 
banking	ukubhanka;  ukufumba; 
banks	iibhanki;  iindonga zomlambo; 
baobab	umthi webaobab; 
bar	ibhari;  umlinganiselo wexesha emculweni; 
bargain	isigqibo;  isisulu; 
bargaining	ukwenza isisulu;  ukwenza isigqibo; 
barrier	isithintelo; 
barriers	izithintelo; 
base	 isisekelo;  ichiza lokwenza ityuwa;  isiseko sobalo; isiseko;  umzantsi; 
based	 izisekelo;  isiseko sobalo; isiseko;  umzantsi; iziseko-mandla zokuziphinda-phinda;  amachiza okwenza ityuwa; 
baseline	umgca wesiseko; 
basic	-sisiseko; 
basics	iziseko; 
basis	isiseko; 
basket	umnyazi; 
battle	idabi; 
bay	itheku; 
be	yiba; 
beach	unxweme; 
beaches	amanxweme; 
bear	ibhere; 
bearers	abaphathi-ncwadi; 
bears	amabhere; 
beautiful	bukekayo; mhle; 
beauty	ubuhle; 
became	ukuba; 
because	 ngokokuba;  ngokuba; kuba;  ngenxa; 
become	ukuba; 
becomes	ukuba; 
becoming	ukuba; 
bed	ibhedi;  intsele; 
beds	iibhedi; iintsele; 
bee	inyosi; 
been	 ibe; ube; 
beer	utywala; 
before	ngaphambi; 
began	qalile; 
begin	qala; 
beginning	ekuqaleni; 
begins	uqala; 
begun	uqalile; 
behalf	 egameni; ngenxa; 
behaviour	 izimbo; ukuziphatha; 
behind	emva; 
being	 ubukho; umntu; 
beings	abantu; 
belief	inkolo;  inkolelo; 
beliefs	iinkolo;  iinkolelo; 
believe	kholelwa ; kholwa; 
believed	kholelwe;  kholiwe; 
believes	kholwa; 
believing	okholwayo; 
belong	 ubumnini;  eyakho; eyam; 
belonging	impahla yomnini; 
belongs	eyomninini; 
beloved	 othandekayo; isithandwa;  intanda; 
below	ngezantsi; 
benchmark	isilinganiso sokulinganisa; 
beneficial	 enoncedo;  encedayo; eluncedo; 
beneficiaries	abafumana uncedo;  abazuzi boncendo; abahlomli; 
beneficiary	 ozuza uncedo; ofumana uncedo; umhlomli; 
benefit	 ingenelo; ukunceda; 
benefited	ncedekile;  zuzile; 
benefits	amancedo; 
best	iqula; 
better	ngcono;  bhetele;  lungile;  kakuhle kunoku; 
between	phakathi; 
beyond	 ngaphesheya; ngaphaya; 
bid	biza ixabiso;  ukubiza ixabiso; 
bidders	ababizi-xabiso; 
bids	izibizi-xabiso; 
biennale	nyaka-mbini; 
big	nkulu; 
bigger	elikhulu; 
biggest	elona likhulu; 
bilateral	 kumacala amabini; amacala amabini; 
bill	ityala;  umlomo wentaka;  iakhawunti;  umthetho oyilwayo;  ukuthumela ibhili;  umthetho osayilwayo; 
billion	isigidi sezigidi; 
bills	imthetho eyilwayo;  umlomo wentaka;  iiakhawunti;  ukuthumela iibhili; amatyala;  umthetho osayilwayo; 
bind	bopha; 
binding	umqukumbelo; 
bingo	umdlalo wamakhasi; 
biodiversity	izityalo nezilwanyana ezahlukeneyo; 
biological	 eyenzululwazi ngezilwanyana nezityalo; eyebhayoloji; 
bird	intaka; 
birds	iintaka; 
birth	 ukuzala; ukubeleka; 
birthday	umhla wokuzalwa; 
black	mnyama; 
blacks	abamnyama; 
blind	ukungaboni;  oyimfama;  ukumfamekisa;  ukumfameka; 
block	isambuku;  ibhloko;  isiqobo;  iqhekeza lomkhenkce; 
blood	 ujikelezo lwegazi; igazi; 
blue	-luhlaza okwesibhakabhaka;  ezuba;  iblowu; 
board	ibhodi;  uqweqwe lwephepha;  iqumrhu lophando; 
boards	iibhodi; 
boasts	iziqhayiso; 
bodies	 iibhodi; ukuyondelelana kweesuphu;  iziqu; imizimba; 
bodily	ngomzimba; 
body	 ibhodi;  isiqu; umzimba; 
bold	khaliphileyo;  ngqindilili;  nobunganga; cacileyo; 
bona fida	bona fide; 
bond	oonobumba; 
bonds	oonobumba; 
book	incwadi; 
books	iincwadi; 
boom	 ixhesha lendyebo; umqobo; 
boost	 inkuthazo;  isomelezo; inkxaso;  ukuqhubela phambili; 
border	umda;  umqukumbelo;  ukuqukumbela; 
borders	imida;  imiqukumbelo; 
born	vele;  zelwe; 
borne	thwele; 
borrow	 boleka; ukuboleka; 
borrowing	 boleka; ukuboleka; 
boss	ukuhombisa ngqukuva; 
botanical	eyebhotani;  eyolwazi lwezityalo; 
both	zombini; 
bottom	 umphantsi; umzantsi; 
bought	thengile; 
bound	ukubhayindisha; bopha; 
boundaries	imida; 
boundary	umda; 
box	 ityeya; ibhokisi;  ukunqinda; 
boy	inkwenkwe; 
boys	amakhwenkwe; 
brackets	oonokona;  izibiyeli; 
branch	 ingcambu engenelelayo;  yenza amasebe; isebe;  naba; 
branches	amasebe;  yenza amasebe;  amasebe angenelelayo; 
brand	uhlobo lwemveliso olulodwa; 
brave	khalipha; 
bravery	ubugorha; 
breach	 ulwaphulo;  ukutyhoboza; isithuba; 
breadth	ububanzi; 
break	ukwaphula umthetho;  aphula;  ukuguquka kwelizwi; 
breakdown	 ukwaphuka; ukonakala; 
breakfast	isidlo sakusasa; 
breaking	ukuqhekeza isonka; 
breakthrough	 ukutyhoboza; impumelelo; 
bridge	 umchankcatho;  ibhulorho; ibrorho; 
bridging	 ukwenza ibhulorho; ukwakha umchankcatho;  ukwenza ibrorho; 
brief	ukuchaza; 
briefed	ukuchaza; 
briefing	ingcaciso; 
briefly	ngokufutshane; 
briefs	ukuchaza; 
bring	zisa; 
bringing	ukuzisa; 
brings	uzisa; 
broad	-banzi; 
broad-based	enesiseko esibanzi; 
broadband	ibhanti elibanzi; 
broadcast	usasazo;  ukusasaza; 
broadcaster	umsasazi; 
broadcasters	abasasazi; 
broadcasting	ukusasaza; 
broaden	 ukutweza;  ukwenza banzi; ukuvula; 
broadening	 ukutweza;  ukwenza banzi; ukuvula; 
broader	-banzi; 
broadly	ngokubanzi; 
brochure	ibrowutsha;  incwandana; 
brochures	incwandana;  iibrowutsha+D269; 
brother	ubhuti;  umnakwethu; 
brothers	oobhuti;  abanakwethu; 
brought	zisile; 
brutal	nobungonyama; 
brutality	 ngobulwanyana; ngobungonyama;  ngengcwangu; 
budget	uqingqo-mali;  hlahla imali; 
budgetary	Eyohlahlo-mali;  Eyolwabiwo-mali; 
budgeted	yenzelwe uqingqo-mali;  kuhlahlwe imali; yenzelwe uhlahlo lwabiwo-mali; 
budgeting	uhlahlo lwabiwo-mali; ukuhlahla imali;  uqingqo-mali; 
budgets	amahlahlo-mali;  amahlahlo lwabiwo-mali;  amaqingqo-mali; 
buffalo	inyathi; 
build	 -akha; ukwakha; 
build-up	ukunyusa;  ukwanda;  ukuncoma; 
building	isakhiwo;  isitena sokwakha; 
buildings	izakhiwo;  izitena zokwakha; 
built	 -akha; ukwakha; 
bulk	 ngobuninzi; ngobukhulu;  isambuku; 
burden	umthwalo; 
bureau	iziko; 
buried	ngcwaba; 
burning	etshisayo;  evuthayo; 
bursaries	izibonelelo-mali zemfundo; 
bury	ngcwaba; 
bus	ibhasi;  uduladula; 
business	ishishini; 
businesses	amashishini; 
bust	umfanekiso oqingqiweyo womntla womntu; 
busy	ukuxakeka; 
but	kodwa;  koko; 
buy	 thenga; ukuthenga; 
by	 ngo;  nge; nga; 
cabinet	 isigqeba sombuso; ikhabhinethi; 
calculate	 ukubala; bala; 
calculated	balile; 
calculating	ukubala; 
calculation	ubalo; 
calendar	ikhalenda; 
call	 ukuhambela; ukubiza;  ukukhwaza;  ukumema; 
called	 memezile;  memile;  hambele; bizile;  khwazile; 
calling	ubizo; 
calls	 iihambelo; izimemo;  imikhwazo;  izimemezo; 
came	bezile;  ezile;  uzile;  izile; 
camp	misa intente;  inkampu;  ikampu; 
campaign	iphulo;  imfazwe;  iphulo lonyulo; 
campaigns	amaphulo;  iimfazwe; 
camps	 misa iintente;  iinkampu; iinkampu; 
campus	 wesikolo okanye weyunivesithi; umhlaba wekholeji; 
campuses	 yesikolo okanye yeyunivesithi; imihlaba yekholeji; 
can	inkonkxa; 
can't	asinakho;  andinakho; akanakho;  abanakho; 
cancel	ukuhlaba; 
cancellation	ukurhoxisa;  ukuhlaba; 
cancelled	ukuhlaba; 
cancer	umhlaza; 
candidate	umgqatswa;  umviwa; 
candidates	umgqatswa;  umviwa; 
cannot	abange- ; andinge-;  asinge-;  akange-; 
cant	ukuthambeka; Uhanahaniso; 
cap	umnqwazi;  ukuthweswa indwe; 
capabilities	izakhono;  amandla okwenza;  iziphiwo; 
capability	 isakhono; ulwazi;  isiphiwo;  ubuchule;  amandla okwenza; 
capacities	 umbilini; umthamo; 
capacity	 umbilini; umthamo; 
capacity-building	ukuxhobisa ngezakhono; 
cape	iphondo; 
capita	imali yomntu ngamnye; 
capital	inkunzi;  ikomkhulu; 
caps	iminqwazi;  ukuthweswa indwe; 
capture	ukuthatha; 
captured	xhwiliwe; ukuthatha; 
captures	ukuthatha; xhwila; 
car	inqwelo-mafutha; 
carbon	 ikhabhoni; isilahle; 
card	ikhadi; 
cards	 amakhasi;  isixhobo sokuchaza uboya; amakhadi; 
care	 inyameko; ukukhathalela;  ukunyameka; 
career	 ixesha lemfundo; uhlobo lomsebenzi; 
careers	 amaxesha emfundo; uhlobo lomsebenzi; 
carefully	 ngobulumko; ngocoselelo;  ngononophelo;  ngenyameko;  ngenkathalo; 
cargo	 umthwalo wenqanawa; umthwalo; 
caring	 inyameko; ukukhathalela;  ukunyameka; 
carnival	imidlalo nemigcobo eyenziwa ekuhleni; 
carpet	ikhaphethi; 
carried	phethwe;  thwelwe; 
carries	thwala; phatha; 
carry	thwala; phatha; 
case	ityala;  ibhokisi; 
cases	amatyala; amabhokisi; 
cash	imali esesandleni; 
cast	isibumbeli;  ukujula; ukulahla;  ukuphosa; 
catalogue	 ikhathalogu; uludwe; 
catalyst	isiphembeleli; 
catch	ubanjiso; 
categories	iindidi; 
category	udidi; 
cater	ukulungiselela ukutya;  ukubonelela ngokutya; 
catering	ukulungiselela ukutya;  ukubonelela ngokutya; 
cattle	iinkomo; 
caucus	igqugula; 
cause	isizathu;  unobangela; 
caused	isizathu;  unobangela; 
causes	isizathu;  oonobangela; 
causing	ebangela;  edala; 
cave	umqolomba; 
caves	umqolomba; 
cc	icc; 
cease	 nqumama;  phelisa;  phela; yeka; 
ceases	 nqumama;  phelisa;  phela; yeka; 
cedar	umsedare; 
celebrate	ukubhiyoza; 
celebrated	bhiyoza; ukubhiyoza; 
celebrates	imibhiyozo; 
celebrating	bhiyoza; ukubhiyoza; 
celebration	umbhiyozo; 
celebrations	imibhiyozo; 
cell	ibhetri;  iseli; 
cells	 iibhetri; iiseli; 
cellular	eneeseli; 
census	 ubalo lwabantu; ubalo; 
censuses	iinkqubo zobalo; 
cent	isenti; 
centenary	ikhulu leminyaka;  isikhumbuzo sekhulu leminyaka; 
center	 umbindi; iziko;  isazulu; 
central	esazulwini; 
centre	 umbindi; iziko;  isazulu; 
centres	 izazulu; amaziko;  imibindi; 
centuries	amakhulu;  iinkulungwane;  amakhulu eminyaka; 
century	 inkulungwane; inkulu; 
ceremonial	ngamatiletile; ngokusesikweni; 
ceremonies	amatheko; 
ceremony	itheko; 
certain	qinisekileyo; 
certainly	ngokuqinisekileyo; 
certainty	ingqiniseko; 
certificate	 ukuqinisela; isiqinisekiso; 
certificates	iziqinisekiso; 
certification	isiqinisekiso; 
certified	 qinisekisiwe; ngqinelwe; 
cession	unikelo; uyekelo; 
chain	 ityathanga; umxokelelwano; 
chair	isitulo; 
chaired	uchophele; 
chairman	usihlalo; 
chairperson	usihlalo; 
chairpersons	oosihlalo; 
challenge	 ukucela umngeni;  umceli mngeni;  ukubangisana ngebhola; umngeni; 
challenged	 ukucela umngeni;  umceli mngeni;  ukubangisana ngebhola; ubangiswano ngebhola; umngeni; 
challenges	imiceli mngeni; 
challenging	 ukucela umngeni;  umceli mngeni;  ukubangisana ngebhola; ubangiswano ngebhola; umngeni; 
chamber	igumbi leengxoxo; 
chambers	amagumbi; 
champion	intshatsheli; 
champions	iintshatsheli; 
championship	ubungqwayingqwayi;  ubuqhawe; ubuntshatsheli;  ;  ubunjuze; 
championships	 zobungqwayingqwayi;  zobunjuze; iinkqubo zobuntshatsheli; zobuqhawe; 
chance	ithuba;  ibhaqo;  ukulalela; 
change	 itshintshi;  inguquko; utshintsho;  ukutshintsha; 
changed	 itshintshi;  inguquko; utshintsho;  ukutshintsha; 
changes	iinguqu; 
changing	 itshintshi;  inguquko; utshintsho;  ukutshintsha; 
channel	ijelo;  inyoba; 
channels	imijelo; 
chapter	isahluko; 
chapters	izahluko; 
character	 umdlali;  isimilo; isimo;  umlinganiswa; 
characterised	ukulinganisa; 
characteristic	 eluphawu; uphawu; 
characteristics	iimpawu; 
characterize	ukulinganisa; 
characterized	ukulinganisa; 
characters	abalinganiswa; 
charge	 ukubekwa ityala; intlawulo;  ukuhlaziya;  isimangalo;  ukumangala; 
charges	iintlawuliso; 
charter	uxwebhu lwamalungelo;  iphepha lamalungelo; 
chartered	 ukwenza uxwebhu lwamalungelo; ukwenza iphepha lamalungelo; 
check	 ingqinisekiso; ukuqinisekisa; 
checked	qinisekisiwe; 
chemical	ngomchiza;  umchiza; 
cheque	itsheke;  itshekhi; 
chief	inkosi; 
child	umntwana; 
childhood	ubuntwana; 
children	abantwana; 
children's	abantwana; 
china	izitya zomdongwe; 
choice	ukukhetha; 
choices	ezikhethwayo; 
choir	ikwayari; 
choose	khetha; 
chose	khetha; 
chosen	khethiwe; 
chronic	engapheliyo; 
church	icawa; 
churches	iicawe; 
cinema	indawo yomfanekiso bhanya bhanya; 
cinemas	iisinema; 
circumstances	iimeko; 
cite	ukukhuphela isamani; 
cited	ukukhuphela isamani; 
cities	izixeko; 
citizen	ummi; 
citizenry	ubumi bomhlaba; 
citizens	abemi; 
citizenship	ubumi;  ulwazi ngentlalo; 
city	isixeko; 
civic	uhlalisano; ubom besixeko; 
civilian	umntu ongekho mkhosini;  ongekho mkhosini; 
claim	 isiqithi; ilungelo;  ukubanga; 
claimed	 bangiwe; bangile; 
claims	amabango; 
clarification	inkcazo;  ukucacisa; 
clarify	 cacisa;  ngcwengisa; ngcwenga; chaza; 
clarion	ixilongo; 
clarity	ukucaca; 
class	 ihlelo;  iklasi; udidi; 
classes	iindidi;  amahlelo;  iiklasi; 
classic	eyodidi; 
classics	ezodidi; 
classification	 ukuhlelwa; uhlelo;  ukuhlela; 
classroom	igumbi lokufundela; 
clause	umhlathi;  igatya; 
clauses	 imihlathi; amagatya; 
cleaning	ukucoca; 
clear	 cima; cacileyo;  lizolile;  zola; 
clearance	ukuphelisa;  ukucoca; 
clearing	ukucoca ibala; 
clearly	ngokucacileyo; 
clerk	 umabhalana; unobhala;  unobhala wenkundla; 
click	 yenza isandi; isiqhakancu; 
client	 umntu oncedwa yincutshe;  umxumi; umthengi; 
clients	abaxumi; 
climate	imozulu; 
clinic	iklinikhi;  isibhedlela sasemini;  ikliniki; 
clinical	eyesibhedlele; 
clinics	 izibhedlele zasemini; iikliniki; 
close	kufuphi;  lifuthile; 
closely	ngokusondeleyo; 
closer	kufuphi; 
closing	ukuvala; 
closure	uvaleleko; 
closures	imivalo; 
clothing	 izinxibo; impahla; 
club	iklabhu; 
clubs	iiklabhu; 
cluster	iqela;  isihloko; 
co	ico; 
co-operation	umanyano;  ukusebenzisana; 
co-ordinate	ukulungelelanisa; 
co-production	uveliso kunye; 
coach	 ibhasi ehambela iindawo ezikude; umqeqeshi;  ikhareji;  ukuqhelisa kwezemidlalo, izifundo, njl.njl.; 
coal	amalahle;  ilahle; 
coast	 ulwagcibe; unxweme; 
coastal	eyaselunxwemeni; 
coat	 mbathisa; uboya; 
code	uphawu;  ikhowudi; 
codes	 iikhowudi; iimpawu; 
coherent	namathelene; 
cohesion	ukunamathelana; 
cohesive	namathelana; 
cold	 kuyabanda; umkhuhlane;  kubanda;  ebandayo;  ingqele; 
collaborate	sebenza kunye; 
collaboration	intsebenziswano;  sebenzisana; 
collaborative	ngokusebenzisana;  ngokusebenza kunye; 
collapse	 ukubothoka; yiwa; 
colleagues	abalingane;  amaqabane;  amadlelane; 
collect	 ukubuthelana;  ukuqokelela ukukhongozela; qokelela; 
collected	 ukubuthelana;  ukuqokelela ukukhongozela; qokelela; 
collecting	 ukubuthelana;  ukuqokelela ukukhongozela; qokelela; 
collection	ingqokelela; 
collections	iingqokelela; 
collective	isininzi; ubumnini obudityanelweyo; 
collectively	ngesininzi; ngobumnini obudityanelweyo; 
college	ikholeji; 
colleges	iikholeji; 
colloquium	incoko; 
colonial	yesithanga; 
colonialism	ukwenziwa kwamathanga; 
colonies	ibutho lezilwanyana; izithanga; 
colony	 ibutho lezilwanyana; isithanga; 
colour	 umbala; ibala; 
coloured	-nebala; 
colours	imibala; 
column	uluhlu;  umsi onyukayo;  umsi wentabamlilo;  umhlathi;  intsika;  ucwangciso lwamasoldathi; 
com	icom; 
combat	ukulwa; 
combating	ukulwa; 
combination	 uhlanganiso; oonobumba; 
come	yiza; 
comedy	isiyoliso; 
comes	uyeza; 
coming	ukuza; 
comma	umsila;  isiphumlisi; 
command	umyalelo; 
commas	imisila;  iziphumlisi; 
commemorate	ukukhumbula; 
commemorating	ukukhumbula; 
commemoration	isikhumbuzo; 
commemorative	eyokukhumbuza; 
commence	sungula; qalisa; 
commenced	qalisile;  sungule; 
commencement	 isiqalo; ukuqala; 
commencing	 ukuqala;  ukusungula; ukuqalisa; 
commend	ncoma; nikela; 
commendable	ncomekayo; 
commensurate	lingeneyo; 
comment	amagqabantshintshi; 
comments	amagqabantshintshi; 
commercial	 orhwebo;  ezorhwebo; intengiso; 
commission	ikomishini; 
commissioned	ikomishini; 
commissioner	umfungisi; 
commissioners	iikhomishinala; abafungisi; 
commissions	iikomishini; 
commit	ukwenza into embi; 
commitment	ukuzibophelela;  isibophelelo; 
commitments	izibophelelo; 
commits	ukwenza; 
committed	wenze; 
committee	ikomiti; 
committee's	eyekomiti; 
committees	iikomiti; 
committing	ukuzibophelela; 
commodities	iimpahla zorhwebo; 
commodity	impahla yorhwebo; 
common	eqhelekileyo; 
commonly	ngokuqhelekileyo; 
commonwealth	umanyano lwezizwe ezinobudlelane ubudlelane bezizwe; 
communal	kawonke-wonke; 
communicate	uqhagamshelwano;  intlalo yobudlelane; 
communicated	uqhagamshelwano;  intlalo yobudlelane; 
communication	 iindlela zokuhamba; unxibelelwano; 
communication-related	enxulumene noqhagamshelwano; 
communications	iintungelwano; 
communities	imizi; uluntu; 
community	 umzi; uluntu; 
community-based	ngokusekwe kubudlelane;  ngokusekwe kumzi; 
companies	iinkampani; 
company	 ikhampani; inkampani; 
comparability	ukulinganiseka;  ukuthelekiseka; 
comparable	enokulinganiswa;  enokuthelekiswa; 
comparative	ngokuthelekisa;  ngokufanisa;  ngokulinganisa; 
compare	 ukuthelekisa; thelekisa; 
compared	 ukuthelekisa; thelekisa; 
comparison	uthelekiso; 
compassion	imfesane; 
compatriot	umkhaya; 
compatriots	abakhaya; 
compelled	nyanzelwe; 
compelling	nyanzelayo; 
compensate	buyisela;  buyekeza; 
compensation	imbuyekezo; 
compete	ukukhuphisana; 
competence	 isakhono; ubuchule; 
competencies	izakhono; 
competency	 isakhono; ubuchule; 
competent	ukuba nesakhono;  ukuba nobuchule; 
competition	ukhuphiswano;  umnyhadala; 
competitive	onokhuphiswano; 
competitiveness	ukumelana nokhuphiswano; 
compilation	uhlanganiso;  ingqokelelo; 
compile	ukuqokelela; 
compiled	ukuqokelela; 
complainant	ummangali; 
complaint	isikhalazo; 
complaints	isikhalazo; 
complement	ukongeza; 
complementary	efezekisayo;  ezalisayo; 
complete	 gqiba; epheleleyo; 
completed	 gqiba; gcwalisa; epheleleyo; 
completely	ngokupheleleyo;  ngokugqibeleleyo; 
completing	 ukufezekisa; ukugqiba;  ukugcwalisa; 
completion	 inzaliseko; ukugqiba;  imfezeko; 
complex	esisintsonkotho;  neenkcukacha ezininzi; 
complexity	uphixano; 
compliance	ukuthobela;  ukuvumela; 
complied	thobile;  vumele; 
complies	vumela;  thobela; 
comply	vumela;  thobela; 
complying	 ovumelayo; othobelayo; 
component	inxenye; 
components	iinxenye; amalungu; 
composed	bhalile;  qambile;  yilile; zibambile; 
composition	 ukuqamba;  ucwangciso emfanekisweni;  oonobumba;  ingoma; ukwakhiwa;  isincoko; 
comprehensive	 banzi; gabalala; 
comprehensively	ngokugabalala; ngokubanzi; 
comprise	quka; 
comprises	iquka; 
comprising	equka; 
compromise	ukuhlangabezana kwimpikiswano; 
compromised	hlangabezene kwimpikiswano; 
compulsory	enyazelekileyo; 
computer	ikhompyutha; 
computers	iikhompyutha; 
comrade	iqabane; 
comrades	iqabane; 
conceive	mitha; 
conceived	khawulwa; mitha; 
concentrated	engangxengwanga; 
concentration	uzikiso-ngqondo; 
concept	ingqikelelo; 
concepts	ingqikelelo; 
concern	 ishishini;  umcimbi; inxaxheba;  ixhala; 
concerned	ukuba nenkathalelo;  ukuba nexhala; 
concerning	 ngokuphathelele; malunga; 
concerns	amashishini;  amaxhala; 
concert	ikonsathi; 
conciliation	 uxolelwano; uxolelwaniso; 
conclude	shwankathela; 
concluded	shwankathela; 
concludes	shwankathela; 
conclusion	isigqibo; 
concrete	eziphathekayo;  isamente;  ikhonkrithi; 
concurrence	imvumelwano;  ukwenzeka ngaxeshanye; 
condemned	gwetyiwe; 
condemns	gweba; 
condition	imeko;  imo yempilo;  isixomekeko;  isimo; 
conditional	xhomekeke; 
conditions	isimo; 
condolences	uvelwano; 
condom	ikhondom; 
condoms	iikhondom; 
conducive	ngokuncedayo; 
conduct	ukunikezela;  ukuculisa;  isimilo;  ukuziphatha; 
conducted	ukunikezela;  ukuculisa;  isimilo;  ukuziphatha; 
conducting	ukunikezela;  ukuculisa;  isimilo;  ukuziphatha; 
conducts	ukunikezela;  ukuculisa;  isimilo;  ukuziphatha; 
confer	nika; 
conference	inkomfa; 
conferences	iinkomfa; 
conferred	nikelwe; 
confidence	 ukuthemba; ukuzithemba; 
confident	ukuzithemba; 
confidential	yimfihlo;  elihlebo; 
confidentiality	imfihlo; 
confirm	qinisekisa; 
confirmation	ukuzaliswa; 
confirmed	 vunyiwe; qinisekisile; 
confirms	qinisekisa; 
confiscation	uthimbo; 
conflict	 ungquzulwano; imbambano; 
conflicts	iimbambano;  iingxabano; 
confront	ukuhlangana;  jongana ngokuphikisana; 
congratulate	 vuyisana; ukuvuyisana; 
congratulates	uvuyisana; 
congratulating	 vuyisana; ukuvuyisana; 
congratulations	iimvuyiswano; 
congress	ingqungquthela; 
conjunction	isihlanganisi; 
connect	ukudibanisa;  hlanganisa; 
connected	 hlanganisene; dibanisene;  dibene; 
connection	uqhagamshelo; 
conscience	isazela; 
consecutive	ngokulandelelana; 
consensus	imvumelwano; 
consent	 vumela; imvume; 
consequence	isiphumo; 
consequences	iziphumo; 
consequential	ngokwesiphumo; ngokulandelayo; 
consequently	ngokwesiphumo; ngokulandelayo;  ngako oko; 
conservation	 ulondolozo lwendalo; ulondolozo; 
conserve	 ukunkonkxa;  londoloza; ukulondoloza;  khusela; 
consider	ukuqwalasela;  qiqa; 
considerable	kakhulu;  kaninzi;  balulekile; 
considerably	kakhulu;  kaninzi;  balulekile; 
consideration	 uvelwano; ingcamango; 
considerations	iingcamango; 
considered	 thathele ingqalelo; cingele; 
considering	ukuqwalasela;  qiqa; 
considers	ukuqwalasela;  iingqiqo; 
consist	ukuba na-; 
consistency	ukuyondelelana; 
consistent	ukuvumelana;  ukungaguquguquki; 
consistently	 ngokuvumelanayo; ngokungaguquguqukiyo; 
consisting	ukuba na-; 
consists	ukuba na-; 
consolidate	ukuzinzisa; 
consolidation	uzinziso; 
constantly	 ngokuzinzileyo; rhoqo; ngokungaguqukiyo;  qho; 
constitute	ukunyula; 
constituted	ukunyula; 
constitutes	nyula; 
constitution	imigaqo;  umgaqo-siseko; 
constitutional	 ngokomgaqosiseko; ngokwemigaqo; 
constitutions	imigaqo; imigaqo-siseko; 
constraint	umqathango; 
constraints	umqathango; 
construct	 akha; yakha; 
constructed	 akha; yakha; 
construction	 ulwakhiwo; ukwakhiwa; 
constructive	ngokwakhayo; 
construed	cacisile; chazile;  guqule; 
consult	 funa icebo; ukucebisana; 
consultant	umcebisi; 
consultants	abacebisi; 
consultation	 ucebiswano; ukubonisana; 
consultations	iingcebiswano; iimbonisano; 
consultative	 bonisana; lumana iindlebe;  cebisana; 
consulted	 fune icebo; cebisene; 
consulting	ukucebisana;  ukufuna icebo; 
consumable	etyiwayo; 
consumables	ezityiwayo; 
consumer	 umthengi; umsebenzisi; 
consumers	abasebenzisi;  abathengi; 
consumption	ukusebenzisa; 
contact	intlangano; 
contacts	iintlangano; 
contain	iqulethe; 
contained	iqulethe; 
container	 isikhongozelo; isiqulatho;  isigcini; 
containers	 izikhongozelao; izigcini;  izikhongozelo; iziqulatho; 
containing	iqulethe; 
contains	iqulethe; 
contemplated	 camngcile;  cingile; bukele; 
contemporary	-exesha elinye; 
contempt	unyembenyo; 
content	umxholo;  umthamo; 
contents	umbilini; 
context	imeko;  umxholo; 
continent	ilizwekazi; 
continental	 ngokwelizwekazi; eyelizwekazi; 
continents	amazwekazi; 
contingency	ukuxhomekeka;  ukuthandabuzeka; 
contingent	enokwenzeka;  isiqendu sabantu/ somkhosi; thandabuzekayo; 
continuation	 ukuqhubeka; ukuqhuba; 
continue	qhubeka; 
continued	qhubeka; 
continues	qhubeka; 
continuing	qhubeka; 
continuity	ukuqhubeka; 
continuous	ngcembe; 
continuously	 ngokuqhubekayo; rhoqo;  qho; 
contract	 ukufinyela; isibophelelo;  izibophelelo;  rhwaqelisa; 
contracted	bophelele;  finyele; rhwaqele; 
contracting	bophelela;  ukufinyela;  rhwaqelisa; 
contractors	iikontrakta; 
contracts	izibophelelo;  iikontraki; 
contractual	ngokwesigqibo;  ngokwemvumelwano; 
contrary	ngokuchasene;  ngokuphikisana; 
contrast	umahluko;  ukuthelekisa; 
contravenes	ukwaphula;  ukuchasa; 
contravention	 inkcaso; ulwaphulo; 
contribute	 ncedisa; nikela; 
contributed	ncedisile; nikele; 
contributes	 ncedisa; nikela; 
contributing	oncedisayo;  onikelayo; 
contribution	 inqaku; umrhumo;  umnikelo; 
contributions	 amanqaku;  iminikelo; imirhumo; 
contributor	 umbhaleli;  umrhumi; umnikeli; 
contributors	 ababhaleli; abanikeli;  abarhumi; 
control	 ukugcina; ulawulo;  ulawulo lombane; 
controlled	gciniwe; lawuliwe; 
controlling	ukugcina;  ukulawula; 
controls	izilawuli; 
convene	 ukubiza intlanganiso; ukuhlanganisa; 
convened	 ubize intlanganiso; uhlanganisile; 
convention	 indibano;  ingqungquthela; isithethe; 
conventions	 izithethe; iindibano;  iingqungquthela; 
convergence	ukuhlangabezana; 
conversation	incoko; 
conversations	iincoko; 
conversion	inguquko;  uguqulelo;  ugqobhoko; 
convert	 guqula;  igqobhoka;  ukuguqula; ukutshintsha; 
converted	 tshintshiwe; gqobhokile;  guquliwe; 
convey	 thutha; ukunika; 
conviction	isigwebo; 
convinced	qinisekisile;  wanezile; 
cookie	 iqebengwana; umqhathane; 
cooperation	intsebenziswano; 
cooperative	-sebenzisanayo; 
cooperatives	iimanyano; 
coordinate	ulungelelwano;  lungelelanisa; 
coordinated	ukulungelelanisa; 
coordinating	ukulungelelanisa; 
coordination	ukulungelanisa; 
cope	 ukuphumelela;  isinxibo somfundisi; ukumelana; 
copies	iikopi; 
copy	 ukukopa; ikopi; 
copyright	lungelo lombhali;  ilungelo lombhali okanye lomqambi elilelakhe; 
core	umphakathi; 
corner	 imbombo; ikona;  isondo lengubo; 
cornerstone	undoqo; 
corporate	imbumba; 
corporation	iqumrhu loshishino; 
corporations	amaqumrhu; 
corps	iqela lamajoni omsebenzi othile; 
correct	ukulungisa;  -lungileyo;  lungisa; 
correction	isilungiso;  ulungiso; 
correctional	 eyolungiso; eyoluleko; 
corrections	izilungiso; 
corrective	isiluleko; 
correctly	kakuhle; 
correspondence	ukulingana;  ukungqinelana; 
corresponding	engqinelana; 
corrupt	-onakele; 
corruption	urhwaphilizo; 
cost	ixabiso;  ukuxabisa; 
cost-effective	ecutha iindleko; 
costs	amaxabiso; 
could	iinkonkxa; ndinga-, unga-, singa-, anga-; 
council	iqumrhu;  ibhunga; 
councillor	 uceba; ilungu; 
councillors	ooceba; 
councils	amabhunga; 
counsel	 cebisa; ingcebiso;  icebo; 
counselling	ukunika icebo;  ukululekwa kwengqondo; 
count	 ukubala; bala; 
countdown	ukubalwa kweentsuku ezishiyekileyo;  umqondiso womgama oya kwisiphambuka; 
counter	umbali; 
counterclaim	 ukuphikisa ibango; ibango eliphikisayo; 
counterpart	ilungu elihamba nelinye; 
counterparts	amalungu afanayo; 
countries	amazwe; 
country	ilizwe; 
country's	eyelizwe; 
countrywide	kwilizwe lonke; 
couple	 ukumatanisa; isibini; 
coupled	dityanisiwe;  matanisiwe; 
coupon	ikuponi,; itikiti; 
courage	ukuba nesibindi; 
course	isiphako; 
courses	iindlela; 
court	inkundla; 
court's	eyenkundla; 
courtesy	imbeko; 
courts	iinkundla; 
cover	 gquma; isiciko;  vala;  khusela; 
coverage	ingxelo yeziganeko; ingxelo yoonondaba; 
covered	 ivaliwe; igqunyiwe; ikhuselwe; 
covering	 isigqubuthelo; isikhumba;  ukugquma; 
covers	 ikhusela;  igquma;  ivala; iquka; 
covet	ukunqwenela; 
coveted	ukunqwenela; 
cradle	umandlalo wosana; 
craft	ubugcisa;  umsebenzi wezandla; 
crafter	igcisa; 
crafters	amagcisa; 
crafts	imisebenzi yobugcisa; 
crater	umlomo wentabamlilo; 
create	yila; 
created	yila; 
creates	Idala, iyila; 
creating	yila; 
creation	indalo; 
creativity	ubuchule bokuyila; 
creator	umdali; 
creators	abayili; 
credibility	ukwamkeleka;  ukukholisa; 
credible	 ethembekileyo; eyamkelekayo; enokukholwa; 
credit	ityala; 
creditor	umbolekisi; 
creditors	ababolekisi; 
credits	amatyala;  iikhredithi; 
creed	ukholo; 
cricket	umdlalo weqakamba;  inyenzane; 
crime	ulwaphulo-mthetho; 
crimes	izono; 
criminals	izaphuli-mthetho; 
crisis	amanqam; 
criteria	umgaqo; 
criterion	umgaqo; 
critical	gwebayo;  thwibishayo; mandundu;  balulekileyo; 
critically	nzima;  mandundu; 
crop	isivuno;  indlelo; 
crops	izivuno; 
cross	umnqamlezo;  uphawu lovoto; 
cross-border	ukuwela umda; 
crucial	uvuthondaba;  balulekileyo; 
culminate	phelela; fikelela kwisiphelo; 
culmination	 incopho; isiphelo; 
cultural	yenkcubeko; 
culture	 impucuko; inkcubeko; 
cultures	iimpucuko; iinkcubeko; 
cup	ikomityi; 
curate	umfundisi oncedisayo; 
curators	abagcini-mafa emveli; 
currency	imali yelizwe elithile; 
current	 umsinga wombane; umsinga; 
currently	 okuqhubekayo; ngoku; 
curriculum	ikharityhulam; 
curve	igophe; 
custodian	umgcini; 
custodians	abagcini; 
custody	ukubanjwa;  ugcino; 
custom	isiko; 
customary	 eyesiqhelo; eyesiko; 
customer	umthengi; 
customers	abathengi; 
customs	amasiko; 
cut	 ukuphamba; icandelo;  ilungu lenyama;  inxeba; 
cutting	 uswazi lokumilisela; uswazi; 
cycle	umjikelo; 
daily	yonke imihla;  imihla ngemihla; 
dam	idama;  ukwakha idama;  ukudama; 
damage	umonakalo;  ukonakalisa; 
damages	iimonakalo; 
dance	 ukududa;  ukudadisa;  danisa; umdaniso; 
dancer	umdanisi; 
dancers	abadanisi; 
dances	abadudi;  abadanisi; imidaniso; 
danger	ingozi; 
dangerous	nengozi; 
dark	 limnyama; mnyama;  ubumnyama;  kumnyama; 
data	okwaziwayo; 
databases	oovimba beenkcukacha abakwikhompyutha; 
date	 umhla wenyanga; umhla; 
dated	eyomhla; ebekwe umhla; 
dawn	ukusa; 
day	usuku; 
days	iintsuku; 
de	ide; 
dead	umfi; 
deadline	ixesha elimiselwe ukugqiba into; 
deaf	ukungeva; 
deal	 ukwaba;  ulwananiso;  ukurhweba; intengiso; 
dealer	umrhwebi; 
dealers	abarhwebi; 
dealing	 ukwaba; ukurhweba;  ukwananisa; 
deals	 izigqibo zorhwebo; izivumelwano; 
dealt	uphethe kakubi/kakuhle; wabele; 
dear	 thandekayo; ukuxabiseka; duru;  isithandwa; 
death	ukufa; 
deaths	ukufa; 
debate	 ukuxoxa;  xoxa; ingxoxo; 
debated	 ukuxoxa;  xoxa; ingxoxo; 
debates	iingxoxo; 
debt	ityala; 
debtor	otyala imali; 
debtor's	eyomntu onetyala; 
debts	amatyala; 
decade	ishumi leminyaka; 
decades	amashumi eminyaka; 
deceased	umfi;  umntu obhubhileyo; 
decent	fanelekileyo; 
decide	ukugqiba; 
decided	 thathe isigqibo; gqibile;  gwebile; 
decides	izigqibo; 
deciding	ukugqiba; 
decision	isigqibo; 
decision-making	ukwenza isigqibo; 
decisions	izigqibo; 
declaration	isibhengezo;  ubhengezo; 
declare	bhengeza; 
declared	 memezile; bhengezile; 
declares	izibhengezo; 
decline	ukwala;  uncipho;  ukulandula; 
declined	walile;  ulandule; nciphile; 
declines	uyalandula; uyala;  iyancipha; 
declining	 enciphayo;  olandulayo; owalayo; 
decrease	ukunciphisa;  nciphisa;  ukwehla; 
decreased	 yehlisiwe; ncitshisiwe; 
decryption	ukufunda umbhalo ongacacanga;  ukutyhila into eyinqaba; 
dedicate	ukunikezela;  -zinikela; 
dedicated	ukunikezela;  -zinikela; 
dedication	ukuzinikela; 
deduct	ukuthabatha;  thabatha; 
deducted	thatyathiwe; 
deduction	 ukuthabatha; ukunciphisa; 
deductions	izinciphiso; 
deed	incwadi yesigqibo; 
deeds	iincwadi zesigqibo; 
deem	cinga; 
deemed	ucingile; 
deems	ucinga; 
deep	nzulu; 
deepen	ukwenza nzulu; 
deeper	nzulu nangakumbi; 
deeply	ngokunzulu; 
default	ukusilela; 
defect	 idlala; ukulahla;  isikreqo;  ukukreqa;  isiphene; 
defence	 umkhosi;  ukunqanda;  ukhuselo; ukukhusela;  ukuvingca amazibuko; 
defend	khusela; 
defendant	ummangalelwa; 
defiance	uqhankqalazo;  indelo; 
deficiencies	iintswelo; 
deficiency	intswelo; 
deficit	intsilelo; 
deficits	iintsilelo; 
define	ukuchaza; 
defined	ukuchaza; 
defines	iinkcazelo; 
defining	ukuchaza; 
definition	inkcazelo;  ingcaciso; 
definitions	 iingcaciso; iinkcazelo; 
degree	 idigri;  iqondo; umgangatho;  inqanam; 
degrees	 amaqondo;  amanqanam; imigangatho;  iidigri; 
delay	ulibaziseko; 
delayed	ulibaziseko; 
delays	ulibaziseko; 
delegate	 ukuthuma; umthunywa; 
delegated	thunyiwe; 
delegates	abathunywa; 
delegation	iqela labathunywa; 
delegations	iqela labathunywa; 
delete	cima; 
deleted	cinyiwe; 
deletion	ukuhlatywa;  ukucinywa; 
deliberate	 camngca;  ukuxoxa; cinga; 
deliberately	ngabom; 
deliberations	ingxoxo; 
delighted	wonwebe;  vuyile; chwayitile; 
deliver	-hambisa;  belekisa; 
delivered	-hambisa;  belekisa; 
delivering	-hambisa;  belekisa; 
delivers	-hambisa;  belekisa; 
delivery	ukubeleka; 
demand	imfuneko;  ukufuna;  ukubanga; 
demands	 amabango; iimfuneko; 
demarcation	ukucandwa kwemida; 
democracy	 ulawulo lwentando yesininzi; idemokhrasi; 
democratic	eyedemokhrasi;  eyolawulo-melo; 
democratically	ngokwedemokrasi; ngolawulo lwesininzi; 
demographic	ngokwamanani abazelweyo nabafileyo; 
demonstrate	ukubonisa;  bonisa;  bonisa ekuhleni isikhalazo; 
demonstrated	ukubonisa;  bonisa;  bonisa ekuhleni isikhalazo; 
demonstrates	ukubonisa;  bonisa;  bonisa ekuhleni isikhalazo; 
demonstration	umboniso;  umboniso ekuhleni wesikhalazo;  uqhankqalazo; 
denied	khanyela;  phika; 
dental	eyamazinyo; 
deny	phika;  khanyela; 
department	isebe;  isetyana; 
department's	eyesebe; 
departmental	eyesebe; 
departments	amasebe; 
departure	ukunduluka; 
depend	ukuxhomekeka; 
dependants	abaxhomekeki; 
dependence	ukuxhomekeka; 
dependency	ilizwe elilawulwa lelinye; 
dependent	umxhomekeki; 
depending	ukuxhomekeka; 
depends	uxhomekeke; 
deploy	ukuthumela kwenye indawo; 
deployed	thunyelwe ngomsebenzi; 
deployment	 ukumiselwa ukulwa; ukwabiwa kwamabutho/ kwabasebenzi; 
deposit	 intlenge;  intlenga; faka;  ukubeka imali ebhankini;  ebekwe phantsi; 
deposited	 intlenge;  beke imali ebhankini; diphozithe; ebekwe phantsi; shiye intlenga;  facile; 
depository	indawo yokugcina ngokhuseleko; 
deposits	iimali ezibekwe ebhankini; iidiphozithi;  iintlenga;  ezifakiwe;  ezibekwe phantsi; 
depreciation	ukuhla kwexabiso; 
depth	ubunzulu; 
deputies	 amasekela; ababambeli; 
deputy	umbambeli; isekela; 
derive	ukuzuza; 
derived	ufumene;  uzuze;  ivela; 
descent	 ukuthambeka; ukwehla;  umnombo; 
describe	 ukukrwela;  cacisa; ukucacisa; 
described	 ukukrwela;  cacisa; ukucacisa; 
description	ingcaciso;  inkcazo; 
desert	 inkqantosi; ukuqhwesha;  intlango; 
design	 uyilo;  yila; ukuyila; 
designate	ukwalatha;  ukutyumba;  ukunyula; 
designated	 otyunjiweyo;  owalathiweyo; onyuliweyo; 
designation	 ukubeka esikhundleni; iwonga; 
designed	 uyilo;  yila; ukuyila; 
designer	umyili; 
designers	umyili; 
designs	iziyilo; 
desirable	nqwenelekayo; nandiphekayo; 
desire	ukunqwenela; 
desired	enqwenelwayo; 
despite	nangona; 
destination	 indawo ekusingwa kuyo; indawo oya kuyo; 
destiny	 isihlelo; ikamva;  ulwazelelo;  isiphelo; 
destroy	tshabalalisa; 
destroyed	tshabalalisa; 
destruction	intshabalalo; 
detail	 ngokuzeleyo; inkcukacha; 
detailed	 ngokuzeleyo; inkcukacha; 
details	iinkcukacha; 
detained	bambezelwe; banjiwe libazisiwe; 
detainees	amabanjwa; 
detection	 ukubhaqa;  ubuntamnani;  ukuphawula; ubucuphi; ukufumana; 
detention	ukubamba; 
determination	ukuzimisela; 
determine	 ukuxela; qinisekisa; 
determined	ukuzimisela; 
determines	ukumisela;  ukuxela; 
determining	 ukuxela; qinisekisa; 
develop	ukukhula;  velisa;  ukuqhubela phambili; 
developed	ukukhula;  velisa;  ukuqhubela phambili; 
developing	ukukhula;  velisa;  ukuqhubela phambili; 
development	 inkqubela; uphuhliso; 
developmental	uphuhliso lwengqondo; 
developments	iinkqubela; 
develops	ukukhula;  velisa;  ukuqhubela phambili; 
device	 ukuyila; isixhobo; 
devices	izixhobo; 
devolution	 ukugunyazisa abanye;  ukunikelwa kwegunya; ukugqithiswa kwegunya; 
diagnosis	 ukufunyaniswa kwesifo; isiphumo sokuxilonga;  ukuqonda isifo ngokuxilonga; 
dialogue	incoko yababini; 
dialogues	iincoko zababini; 
diamond	ilitye elinqabileyo;  idayimani; 
diamonds	iidayimani; 
diaspora	 ubhaco; inkcithakalo; 
dictionary	isichazi-mazwi; 
did	wenzile; 
didn't	akenzanga; 
die	ukufa;  idayisi; 
died	ukufa;  idayisi; 
dies	iyafa; uyafa; 
differ	ahluka; 
difference	umahluko; 
differences	iimahluko; 
differently	ngokwahlukileyo; 
difficult	-nzima; 
difficulties	iingxaki; 
difficulty	ingxaki; 
digital	ulwazi olungamanani; 
dignified	ondilekileyo;  onesidima; obekekileyo; 
dignitaries	 iindedeba;  izikhakhamela; oosomaqhuzu; iziphathamandla; 
dignity	isidima; 
dimension	 umlinganiso; umlinganiselo; 
dimensions	 imilinganiso; imilinganiselo; 
dinner	idina;  isidlo sangokuhlwa; 
diploma	 idiploma; isiqinisekiso; 
diplomatic	ovela ngobuchule; 
direct	ngqo; 
directed	ngqo; 
directing	ukulawula; 
direction	icala; 
directions	iizalathiso; 
directives	imigaqo; 
directly	ngqo; 
director	 umlawuli womdlalo weqonga; umongameli;  ubongameli; 
director-general	umlawuli-jikelele; 
directorate	icandelo lolawulo; 
directors	 abongameli; abalawuli; 
directory	incwadi yoluhlu lweenkcukacha; 
directs	ulawula; 
disabilities	ubudalwa; 
disability	ubudalwa; 
disabled	 okhubazekileyo; sidalwa; 
disadvantage	ingxaki;  ukungalungi; 
disadvantaged	ingxaki;  ukungalungi; 
disaster	intlekele; 
disasters	iintlekele; 
discharge	 ukwetha; incindi yomzimba;  ukugwebela;  ukugwetyelwa;  ubuthuku; 
discharged	 ukhululwe;  ukhutshiwe;  lihlawulwe;  ugwetyelwe; wenziwe; 
disciplinary	 eyokohlwaya; eyenqqeqesho;  eyoluleko;  eyoqeqesho; 
discipline	ucwangco;  ingqeqesho; 
disciplines	iingqeqesho; 
disclaimer	 ukulandula; ukukhanyela; 
disclose	ukuxela;  ukutyhila;  ukubhengeza; 
disclosed	xeliwe;  tyhiliwe; bhengeziwe; 
disclosure	ubhengezo; utyhilo; 
discourse	 incoko;  intshumayelo; intetho;  isifundo; 
discover	ukufumanisa; 
discovered	ukufumanisa; 
discovery	ukubhaqa; 
discretion	ukuzibonela; 
discretionary	 ngengqiqo; ngobulumko; 
discuss	xoxa; 
discussed	xoxa; 
discussing	xoxa; 
discussion	ingxoxo; 
discussions	iingxoxo; 
disease	isifo; 
diseases	izifo; 
dismissal	 ukugxotha; ukundulula; 
disparities	 ukwahluka; ukungalingani;  ukungafani; 
dispensation	ixesha lombuso; 
display	 isiboniso; ukubonisa;  bonisa;  umboniso; 
displayed	 isiboniso; ukubonisa;  bonisa;  umboniso; 
displaying	 isiboniso; ukubonisa;  bonisa;  umboniso; 
disposal	ukulahla; 
dispose	lahla; 
disposed	lahliwe; 
dispossession	ukuhlutha; 
dispute	impikiswano;  ukuphikisana; 
disputes	 iimpikiswano; iingxabano; 
disqualified	alele; thintele; 
dissatisfied	 nganelisanga;  ngakholisanga; krokrisayo; 
dissemination	 uhlwayelo; uhlakazo; usasazo; 
dissolution	 ukuqhawula; ukuphelisa;  ukuchitha; 
dissolve	 ukuchitha iPalamente; nyibilikisa;  ukunyibilikisa; 
dissolved	ichithiwe iPalamente;  phelisiwe; nyibilikisiwe; 
distance	umgama; 
distant	-kude; 
distinct	cacileyo;  ahlukileyo; 
distinction	umahluko;  ukwahluka;  ubuntshatsheli; 
distinctions	iimahluko; 
distinctive	ahlukileyo; 
distinguished	balulekileyo; khethekileyo; 
distribute	 ukwabela; yaba; 
distributed	 ukwabela; yaba; 
distribution	 ukwaba;  ukumiwa kwelizwe; usasazo; 
district	isithili; 
districts	izithili; 
distrust	ukungathembi; 
diverse	ezahluka-hlukeneyo; 
diversion	ukuba ziintlobo ngeentlobo;  ahlukileyo; ngafaniyo; 
diverted	 phazamisiwe; phambukisiwe; 
divide	 ukwahlula-hlula;  ahlula; yahlula; 
divided	 yahlula; ukwahlula-hlula;  ahlula; 
dividend	inzala;  isahlulwa;  isahlulo; 
dividends	izahlulo;  izahlulwa;  iinzala; 
division	 ukwahlula; icandelo;  ukwahlulwa;  ulwahlulo; 
divisions	 izahlulo; amacandelo; 
divorce	 uqhawulo-mtshato; ukuqhawula umtshato; 
do	yenza; 
doctor	ugqirha; 
doctorate	isidanga sobugqirha-lwazi; 
doctors	oogqirha; 
document	uxwebhu; 
documentation	amaxwebhu okungqina; 
documented	uxwebhu; 
documenting	uxwebhu; Ukungqinela ngoxwebhu; 
documents	amaxhwebhu; 
does	uyenza; 
doesn't	akenzi; 
doing	ukwenza; 
dollar	idola; 
domains	imimandla; 
domestic	eyasekhaya; 
domination	uvelelo; ulawulo; 
don	 umfundisi omdala weyunivesithi; umhlekazi; 
don't	musa; 
donation	ilizo; 
donations	amalizo; 
done	yenziwe; 
donor	umnikeli;  umphi; 
donors	abanikeli;  abaphi; 
door	ucango; 
doors	iingcango; 
double	ukuphinda;  ephindaphindwe kabini; 
doubt	thandabuza; 
down	phantsi; 
download	khuphela; 
downtown	embindini wedolophu; 
downturn	ukwehla;  ukujika;  ukuwa; 
draft	utsalo;  uyilo; uvandlakanyo; 
drafted	 vandlakenye; tsalile;  yilile; 
drafting	ukubeka;  ukuyila;  ukuvandlakanya;  ukutsala; 
drama	idrama; 
dramatic	ukuvusa umxhelo;  ukubaxa; 
draw	 ukukrwela;  ukuzoba;  ukukhupha;  ukulingana;  zoba; ukwenza; 
drawing	umzobo;  ukuzoba;  isazobe; 
drawn	 zobile; tsalile; 
dream	iphupha; 
dreams	amaphupha; 
drew	 ukukrwela;  ukuzoba;  ukukhupha; ukuba ntanganye;  ukulingana;  zoba; ukwenza; 
drink	 isiselo; ukusela; 
drinking	ukusela; 
drive	indlela; 
driven	indlela; 
driver	umqhubi; 
driver's	eyomqhubi; 
drivers	abaqhubi; 
driving	indlela; 
drop	 ithontsi;  ichaphaza; ukuhlela; 
drug	ichiza;  iyeza eliphilisayo;  isiyobisi; 
drugs	 amayeza eliphilisayo;  iziyobisi; amachiza; 
drum	umgqomo;  amagubu;  igubu; 
dry	 yomisa;  -omile; ukoma;  ukomisa;  lomile; 
dual	entlantlu-mbini; 
due	-lityala; 
duly	 ngokufaneleyo;  ngokwelungelo; ngokulindelekileyo; 
duplicate	 uphindo kabini; ukuphinda kabini; 
duplication	 ukuphinda kabini;  ukwenza iikopi; uphindaphindo; 
duration	 ubungakanani bexesha; ubude;  ubude bexesha;  ixesha eliqingqelwe umdlalo; 
during	ngexesha;  ngelixa; 
duties	 imisebenzi;  iirhafu; iimfanelo; 
duty	 irhafu;  rhafu;  uxanduva; umsebenzi; 
dynamic	intshukumo; 
dynamics	amandla;  iintshukumo; 
e-mail	ukuthumela imbalelwano ngeimeyili; unxibelelwano ngamaz'omoya; 
each	nganye; 
earlier	ngaphambili; 
earliest	eyona iphambili;  eyona isekuqaleni; 
early	 kusasa; ngexesha;  ekuseni; 
earmarked	phawulwe; 
earn	fumana; 
earned	fumana; 
earning	isamkelo; 
earnings	 iinzuzo; imivuzo; 
earth	umhlaba;  isikhuseli mbane;  ihlabathi; 
ease	ubukhaphu-khaphu; 
easier	lula; 
easily	lula; 
east	impumalanga;  ngasempumalanga;  impuma; 
eastern	esempumalanga; 
easy	lula; 
economic	ezinxulumene nobutyebi belizwe; 
economically	 ngokobutyebi belizwe; ngokoqoqosho; 
economics	ufundo ngezoqoqosho; 
economies	amaqoqosho; ubutyebi belizwe; 
economists	usoqoqosho; 
economy	 ubutyebi belizwe; uqoqosho; 
ecosystems	ubudlelane bezinto eziphilayo nokuzingqongileyo; 
edge	 umphetho wegqabi; isiphelo; 
edit	hlela; 
editing	hlela; 
edition	uhlelo; 
editor	umhleli; 
editors	abahleli; 
educate	ukufundisa; 
educated	ukufundisa; 
educating	ukufundisa; 
education	 ukufundisa; imfundo; 
educator	ititshala; 
educators	iititshala; 
effect	 isiphumo; ukwenza; 
effected	 wenzile; uphumezile; 
effective	 enesiqhamo; esebenzayo; 
effectively	 ngokunesiqhamo; ngokunesiphumo; 
effectiveness	 ukuthabathekisa; ukusebenza; 
effects	iziphumo; 
efficacy	 amandla; ukusebenza; 
efficiency	ugqibeko; 
efficient	ukusebenza ngokwaneleyo; 
efficiently	ngobuchule;  ngenkuthalo;  ngokusebenzayo; 
effort	umzamo;  umgudu; 
efforts	imizamo; 
eight	isibhozo; 
either	nayiphi kwezimbini; nawuphi kwababini; 
elderly	khulileyo; 
elders	 abadala; amagosa; 
elect	ukunyula;  nyula; 
elected	ukunyula;  nyula; 
election	unyulo; 
elections	unyulo; 
electoral	 eyonyulo; eyokhetho;  ; 
electrical	eyombane; 
electricity	umbane; 
electrification	ufakelo lombane; 
electronic	ene-elektroni; 
electronically	ngokwe-elektroniki; 
elects	ukunyula;  nyula; 
element	ilungu;  isiqalelo;  inxenye; 
elements	iziqalelo; 
elevate	nyusa izinga; 
eleven	ishumi elinanye; 
eligible	fanelekileyo;  nokunyulwa; 
eliminate	ukushenxisa;  ukuguba; 
eliminated	ukushenxisa;  ukuguba; 
elimination	ukususa; 
eloquently	ngobuciko; 
else	omnye;  enye; 
elsewhere	kwenye indawo; 
email	unxibelelwano ngamaz'omoya; 
emanating	evela;  ephuma; 
emancipation	inkululo; 
embark	 khwela enqanaweni; qalisa; 
embarked	uqalise;  ukhwele enqanaweni; 
embarking	 ukukhwela enqanaweni; ukuqalisa; 
embassies	amaziko oonozakuzaku; amaziko ezozakuzo; 
embedded	Zinzisiwe; 
emblem	imbasa;  indwe; 
embodiment	 ukuqulathwa; ukuqukwa; 
embrace	ukwamkela;  ukwanga; 
embraced	ukwamkela;  ukwanga; 
embraces	ukwamkela;  ukwanga; 
emerge	ukuvela; 
emerged	uvelile; 
emergence	ukuvela; 
emergency	ithuba lokuxakeka;  ithuba likaxakeka; 
emergent	evelayo; 
emerging	evelayo; 
eminent	dumileyo; balaseleyo; 
emission	ukuvelisa; 
emissions	iimveliso; 
emoluments	 iinzuzo; imivuzo; 
emotion	uvakalelo; 
emotional	echukumisayo;  enovakalelo; 
emotions	iimvakalelo; 
emphasise	cinezela; 
emphasised	cinezelwe;  gxininisiwe; 
emphasises	cinezela;  gxininisa; 
employ	ukuqesha; 
employed	ukuqesha; qeshiwe; 
employee	umsebenzi; 
employees	abasebenzisi; 
employer	umqeshi; 
employers	abaqeshi; 
employing	ukuqesha; -qesha; 
employment	 ingqesho; umsebenzi; 
employs	ukuqesha; -qesha; 
empower	gunyazisa; 
empowered	gunyazisiwe; 
empowering	gunyazisayo; ukugunyazisa; 
empty	 engenanto; khupha; 
emulate	ukulinganisa;  ukwenzisa; 
enable	 yenza akwazi; ukwenza ubenakho; 
enabled	 yenze akwazi; wenze ubenakho; 
enables	 yenza akwazi; ukwenza ubenakho; 
enabling	 yenza akwazi; ukwenza ubenakho; 
enacted	 ulinganise; udlale;  uwise umthetho; 
enacting	ukudlala;  ukuwisa umthetho;  ukulinganisa; 
enactment	 ulinganiso;  uwiso-mthetho; umdlalo; 
enactments	 ukuwiswa kwemithetho;  imilinganiso; imidlalo; 
encourage	 khuthaza; ukukhuthaza; 
encouraged	 khuthaza; ukukhuthaza; 
encourages	 iinkuthazo; ukukhuthaza; 
encouraging	 khuthaza; ukukhuthaza; 
end	isiphelo;  isiphetho; 
endangered	ezisengozini; 
endeavor	ukuzama; 
endeavour	ukuzama; 
endeavours	iinzame; 
ended	iphelile; 
ending	isiphelo; 
endorse	ukungqina;  ukuqinisela; ukusayina itsheki; 
endorsed	 usayinile; ungqinile;  uqinisele; 
endorsement	 uqiniselo;  usayino; ungqino; 
ends	iziphelo; 
enduring	 ukuxononoza; ukunyamezela; 
energy	amandla; 
enforce	nyanzela; 
enforced	unyanzelisile; 
enforcement	 unyanzelo; isinyanzelo;  unyanzeliso; 
engage	ukuqesha;  ukubophelela;  xakeka;  thembisa; 
engaged	xakekile;  thembisile;  qeshile; bophelele;  ; 
engagements	amadinga; 
engaging	 qeshayo;  xakekisayo; bophelelayo;  thembisayo; 
engender	 dala; banga; 
engendering	edalayo;  ebangayo; 
engine	 intloko kololiwe; injini; 
engineer	 injineli; ukuphembelela; 
engineering	ubunjineli; 
engineers	uphembelela;  iinjineli; 
enhance	ukukhulisa; 
enhanced	ukukhulisa; 
enhancement	 ukukhulisa; ukongeza;  ukwandisa;  ukunyusa; 
enhancing	ukukhulisa; 
enjoy	 yonwabela; vuyela; xhamla;  nambitha; 
enjoyed	 yonwabele;  xhamlile; nambithile; vuyele; 
enormous	khulukazi; nkulu kakhulu; 
enough	kwanele; 
enquiries	amaphando; 
enquiry	ukubuza; 
enrich	tyebisa; 
enrol	bhalisa; 
enrolled	bhalisile; 
enshrined	fakiwe;  gcinwe; 
ensue	ukulandela; 
ensuing	ukulandela; 
ensure	ukuqinisekisa; 
ensured	ukuqinisekisa; 
ensures	ukuqinisekisa; 
ensuring	ukuqinisekisa; 
entail	ukubanga; 
entails	ukubanga; 
enter	qalisa; 
entered	qalisa; 
entering	qalisa; 
enterprise	ishishini; 
enterprises	amashishini; 
enters	qalisa; 
entertainment	izinto zokonwabisa; 
entirely	ngokupheleleyo; 
entities	izinto ezikhoyo; 
entitled	 ukuba nelungelo;  ukubizwa; isihloko; 
entity	into ekhoyo; 
entrance	isango;  umnyango; 
entrepreneur	umrhwebi; 
entrepreneurial	eyorhwebo; 
entrepreneurs	abarhwebi; 
entrepreneurship	ukurhweba; 
entries	amasango;  iminyango; 
entrusted	ukuphathisa ngethemba; 
entry	ukungena; 
envelope	imvulophu; 
environment	ubume bemeko yendawo;  okungqongileyo;  indalo nokusingqongileyo;  okusingqongileyo; 
environmental	eyokusingqongileyo; 
environments	 indalo nezisingqongileyo; ezisingqongileyo;  ubume bemeko yendawo; 
envisaged	zimisele; cingile; 
envisages	 zimisela; cinga; 
epidemic	 indyikityha yesifo esosulelayo;  indyikitya yokufa;  indyikitya yesifo esisulelayo endaweni ethile okwexesha; ubhubhane; 
equal	ukulingana;  ngokulinganayo; 
equally	ngokulinganayo; 
equals	zilingana; 
equipment	 izixhobo zokusebenza; impahla; 
equipped	lungiselelwe; xhotyisiwe; 
equitable	elungileyo;  enobulungisa; 
equity	ubulungisa; 
equivalent	ukulingana; 
era	ixesha elithile ezimbalini; 
eradicate	 ukuphelisa; ukutshabalalisa; 
eradicating	 ephelisayo; etshabalalisayo; 
eradication	ukutshabalalisa; 
error	isiphosiso; 
errors	iziphosiso; 
escape	ukugcagca;  gcagca; 
escapes	imiphuncuko; iintsabo; 
especially	ngakumbi; 
essence	isinongo; 
essential	efunekayo;  okufunekayo; 
essentially	ngokufunekayo; ngokubalulekileyo; 
establish	ukuseka; 
established	ukuseka; sungulwe; 
establishes	ukuseka; sungula; 
establishing	ukuseka; sungula; 
establishment	 iziko elimisiweyo; isiseko; 
establishments	 amaziko amisiweyo; iziseko; 
estate	umhlaba;  ilifa; 
estates	umhlaba;  ilifa; 
esteemed	ethandwayo;  ehlonelwayo;  ecingelwa phezulu; 
estimate	uthelekelelo;  qikelela; 
estimated	uthelekelelo;  qikelela; 
estimates	iingqikelelo;  iintelekelelo; 
ethical	eyeenqobo ezisesikweni; eyemikhwa esesikweni; 
ethics	indlela yokuziphatha;  indlela yokuziphatha esulungekileyo; 
ethnic	 ngokobuzwe; ngokobuhlanga; 
ethnicity	ubuhlanga; 
ethos	imithetho yentlalo yabantu abathile; 
evaluate	hlola; 
evaluated	hlolile; 
evaluating	ukuhlola; 
evaluation	 ukuhluza; ukuvavanywa; 
eve	ukuhlwa phambi kosuku oluthile; 
even	ukulingana; 
evening	ngorhatya;  ukuhlwa; 
event	isiganeko; 
events	iziganeko; 
eventually	ekugqibeleni; 
ever	 nakha; nanini;  wakha; 
every	onke; 
everybody	wonke ubani; 
everyone	bonke; 
everything	yonke into; 
evidence	 ingqinisiso; ubungqina; 
evident	cacileyo;  ahlukileyo; 
evolve	ukudala;  velisa; 
evolved	ukudala;  velisa; 
evolving	ukudala;  velisa; 
exactly	kanyekanye; ncam; 
examination	 uviwo;  ukuxilonga; uvavanyo; 
examinations	iimvavanyo;  iimviwo; 
examine	vavanya; 
examined	 viwe; vavanyiwe; 
example	umzekelo; 
examples	imizekelo; 
exams	iimviwo; iimvavanyo; 
exceed	gqithisa; 
exceeded	gqithisile;  ngaphezu kwa-; 
exceeding	dlulisileyo;  gqithisileyo; 
exceeds	gqithisa; ngaphezu kwa-; 
excelled	 ncamisileyo; balaseleyo;  gqwesileyo; 
excellence	ukugqwesa; 
excellent	-hle kwaphela; 
except	-ngaphandle; 
exception	isinxaxhi;  isiphambuko; 
exceptional	khethekileyo;  ngokungaqhelekanga; 
excess	into engaphezu komlinganiselo; 
excessive	ngokugqithileyo; 
exchange	 ulwananiso; utshintshiselwano; 
exchanges	 ulwananiso; utshintshiselwano; 
excise	 irhafu yezinto zasekhaya;  irhafu yelizwe; ukukhupha; 
excitement	ihlombe; 
exciting	ebang' ihlombe; 
exclude	shiya; 
excluded	thintele; 
excludes	shiya; 
excluding	thintela; 
exclusion	uthintelo; 
exclusions	izithintelo; 
exclusive	 ekhethekileyo; eyodwa; 
exclusively	ngokukodwa;  ngokukhethekileyo; 
execute	ukuphumeza;  ukuqabelisa; 
executed	uphumezile ;  uqabelisile; 
executing	ukuphumeza;  ukuqabelisa; 
execution	ukubulala; 
executive	 umlawuli oyintloko; isigqeba; 
executor	umabi welifa; 
exempted	khululekile; 
exemption	ukhululo; 
exemptions	ukhululo; 
exercise	umsebenzi;  uthambo; 
exercised	thamba; umsebenzi;  uthambo; 
exercises	imisebenzi;  ukuziqhelisa;  imithambo; 
exercising	thamba; umsebenzi;  uthambo; 
exhibit	isiboniso;  into engqinelayo; 
exhibition	umboniso; 
exhibitions	iimboniso; 
exile	 ukufuduswa; ukugxothwa; 
exist	 ukubakho; bakho; 
existed	ukubakho;  ubekho; 
existence	ubukho; 
existing	ekhoyo; 
exists	 ukubakho; bakho; 
exit	 isango lokuphuma; ukuphuma; 
expand	 anda; ukwandisa; 
expanded	 anda; ukwandisa; 
expanding	 anda; ukwandisa; 
expansion	 ulwandiso; ukwanda; 
expect	ukulindela; 
expectation	okulindelweyo; 
expectations	okulindelweyo; ulindelo; 
expected	ukulindela; 
expedient	encedayo; elicebo; 
expenditure	inkcitho; 
expense	iindleko; 
expenses	iindleko; 
expensive	-dulu; 
experience	amava; 
experienced	amava; 
experiences	amava; 
experiencing	amava; 
expert	ingcali; 
expertise	ingcaphephe; 
experts	iingcali; 
expired	 iphelelwe lixesha; uphefumlele ngaphandle; 
expiry	ukuphelelwa lixesha; 
explain	chaza; 
explained	chaza; 
explains	chaza; 
explanation	inkcazo; 
explanatory	echazayo; 
explicit	cacileyo;  ahlukileyo; 
exploitation	ukuzisebenzisela; 
explore	 ukuhlola ilizwe; ukuhlola; 
explored	 ukuhlola ilizwe; phonononga; ukuhlola; 
explores	 ukuhlola ilizwe; phonononga; ukuhlola; 
exploring	 ukuhlola ilizwe; phonononga; ukuhlola; 
expo	umboniso; 
export	 ukuthunyelwa kwamaxwebhu ngekhompyutha;  uthumelo; iimpahla ezithunyelwayo;  thumela kwelinye ilizwe; 
exports	ezorhwebo eziphumayo; 
expose	tyhila;  velisa; 
exposed	tyhila;  velisa; 
exposure	utyhileko; 
expressed	 xelile;  ukubonisa ngamazwi; 
expression	 ubalo; imbonakalo;  inkupho; 
expressions	 iimbonakalo; ubalo;  inkupho; 
expressly	 ngokucacileyo; kanye; 
extend	 andisa; yandisa; 
extended	 andisa; yandisa; 
extending	 andisa; yandisa; 
extends	 andisa; yandisa; 
extension	ubukho; 
extensive	isoluli; 
extent	indima; 
external	ngaphandle; 
extra	ngaphezu;  isongezo; 
extract	 isicatshulwa;  incindi;  ukukhupha izinyo; ukukhupha; 
extraordinary	ngokungaqhelekanga; 
extremely	ngokugabadeleyo; ngokugqithileyo; 
eye	 intunja; iliso; 
eyes	amehlo; 
face	 umphezulu;  ubuso;  umphandle welaphu; imbonakalo; 
faced	 umphezulu;  ubuso;  umphandle welaphu; imbonakalo; 
faces	iimbuso;  imiphezulu; iimbonakalo;  umphandle welaphu; 
facie	uluvo; 
facilitate	 ukulungisela; ukubhexesha; 
facilitated	 ubhexeshile; ulungiselele; 
facilitates	ulungisela;  ubhexesha; 
facilitating	 ukulungisela; ukubhexesha; 
facilitation	ulungiselelo; 
facilities	amancedo; 
facility	useko; 
facing	ukujongana; 
facsimile	umfanekiso; 
fact	 inqaku; inyaniso; 
factor	imeko;  inani elingena kwelinye;  unobangela; 
factors	iimeko; iifekta;  oonobangela;  amanani angena kwamanye; 
factory	 umzi-mveliso; ifektri; 
facts	 iinyaniso; amanqaku; 
fail	ukungaphumeleli;  ukuwa phantsi; 
failed	 uwe phantsi; akaphumelelanga; ufeyilishile; 
failing	ukungaphumeleli;  ukufeyilisha;  ukuwa phantsi; 
fails	uyafeyilisha; akaphumeleli;  uwa phantsi; 
failure	ukungaphumeleli; 
failures	ukungaphumeleli; 
fair	ngobulungisa; 
fairly	ngokulungileyo noko; 
fairness	ubulungisa; 
faith	ukholo; 
fall	ukuwa; 
fallen	uwile; 
falling	ukuhla; 
falls	uyawa; 
families	 iindidi; iintsapho; 
family	 ezihlobo lunye; usapho;  udidi; 
famous	ukuduma; 
fan	 ifeni; isiniki-moya; 
fans	 iziniki-moya; iifeni; 
far	kude; 
farewell	 hamba kakuhle;  umbuliso; ndlela-ntle; 
farm	ifama;  iplazi;  lima; 
farmer	umfama; 
farmers	umfama; 
farming	ulimo; 
farms	 iplazi; iifama;  lima; 
fashion	isimbo;  ifashoni; 
fast	ukuzila; 
faster	ukuzila; 
father	utata; 
fathers	ootata; 
fault	 hlaba amadlala; idlala;  isiphene embaneni;  iingcamba ezaphukileyo; 
favorite	 into ethandwayo; into ekhethwayo; 
favorites	iintandokazi; 
favour	umsa; 
favourable	 ncedayo; amkelekayo;  lungeleyo; 
favourite	 into ethandwayo; into ekhethwayo; 
fax	ifeksi; 
faxed	ifeksiwe; 
fear	ukoyika; 
fears	ukoyika; 
feasibility	 ukuba nokwamkeleka; ukuba nokwenzeka; 
feature	uphawu;  elona nqaku liphambili; 
featured	uphawu;  elona nqaku liphambili; 
features	iimpawu;  uphawu; 
featuring	uphawu;  elona nqaku liphambili; 
federal	eyomanyano; 
federation	umanyano-zizwe; 
fee	umrhumo; 
feed	tyisa;  dlisa; 
feeds	dlisa;  tyisa; 
feel	ukuva; 
fees	imirhumo; 
fell	wile; 
fellow	 umfo; iqabane;  umlingane; 
felt	vile; 
female	owasetyhini;  -yimazi;  imazi; 
females	 -yimazi; abasetyhini;  ababhinqileyo; 
festival	umbhiyozo;  umbhiyozo weentsuku;  umgcobo; 
festivals	 imigcobo; imibhiyozo; 
festive	umsitho;  umbhiyozo;  itheko; 
fever	 ifiva; umkhuhlane; 
few	mbalwa; 
fewer	mbalwa; 
field	 inkampu; intsimi; 
fields	amasimi;  iinkampu; 
fifth	eyesihlanu; 
fifty	amashumi amahlanu; 
fight	ukulwa; 
fighter	 inqwelomoya yokuhlasela; umlwi; 
fighters	abalwi;  iinqwelomoya zokuhlasela; 
fighting	ukulwa; 
figure	 isafobe; umnwe;  umzobo; 
figures	izafobe; imizobo; 
file	 gudisa;  ifayili; ifili; 
filed	 ifayiliwe; gudisiwe; ifili;  ; 
files	 gudisa; ifili;  iifayili; 
filing	ukufayila; gudisa; 
fill	 hluthisa; gcwalisa; zalisa; 
filled	gcwalisiwe; zalisiwe;  hluthisiwe; 
filling	intlama; 
film	isigqumi; 
filmmakers	abenzi bemiboniso-bhanyabhanya; 
filmmaking	ukwenza ifilimu; 
films	imiboniso-bhanyabhanya;  izigqumi; 
finalisation	ugqibezelo; 
finalise	gqibezela; 
finalised	gqibezele; 
finalising	ukugqibezela; 
finally	ekugqibeleni; 
finance	imali;  ezemali;  ukuxhasa ngemali; 
financed	imali;  ezemali;  ukuxhasa ngemali; 
finances	imali;  ezemali;  ukuxhasa ngemali; 
financial	ezemali; 
financially	ngokwezemali; 
financing	imali;  ezemali;  ukuxhasa ngemali; 
find	fumana; 
finding	isiphumo; 
findings	iziphumo; 
finds	fumana; 
fine	isohlwayo;  lilihle;  sulungeka;  isiphelo; 
fines	 iziphelo; isohlwayo;  lilihle; udliwo;  sulungeka; 
finest	isohlwayo; Eyona intle;  lilihle;  sulungeka;  isiphelo; 
fingerprints	izinyatheliso zomnwe; 
fire	umlilo; 
firearm	umpu; 
firearms	imipu; 
firm	 -qinile; eqinileyo; 
firmly	 ngokomeleleyo; ngokuqinileyo; 
firms	 -qinile; eqinileyo; 
first	okokuqala; 
firstly	okokuqala; 
fiscal	emali kaRhulumente; 
fish	intlanzi; 
fisheries	ishishini leentlanzi; 
fishing	ukuloba;  ulobo lweentlanzi; 
fit	ukuphila; 
fitting	ukulingana; 
five	isihlanu; 
five-year	iminyaka emihlanu; 
fixed	lungisiwe; 
flag	iflegi;  ibhanile; 
flags	 iiflegi; iibhanile; 
flagship	into ebalulekileyo;  inqanawa ebalulekileyo; 
flame	idangatye; 
flexibility	ubumvoco; 
flexible	epetyepetye; 
flood	isikhukula;  zalisa ngamanzi; 
floods	 isikhukula; zalisa ngamanzi; 
floor	 isibelekana; umgangatho;  umzantsi; 
flora	 izihluma; uhlaza; 
flow	ukumpompoza; 
flower	intyatyambo; 
flows	ukumpompoza; 
fly	 impukane; bhabha; 
flying	ukubhabha; 
focused	gqalisela;  ukugqalanisa; 
focuses	gqalisela;  ukugqalanisa; 
focusing	gqalisela;  ukugqalanisa; 
follow	ukulandela; 
follow-up	ukulandelela; 
followed	ukulandelwa; 
following	-landelayo; 
follows	ilandela; 
food	ukutya; 
foot	unyawo; 
football	ibhola; 
footsteps	izingqi; 
for	ukwenzela; 
force	 ukunyanzela; amandla; 
forced	nyanzelwe; 
forces	 izinyanzelo; amandla; 
forebears	ookhokho; 
forefront	umphambili; 
foreign	 elinye ilizwe; yelinye ilizwe; 
foreigner	 umphambukeli; umntu welinye ilizwe; 
foreigners	 abantu belinye ilizwe; abaphambukeli; 
forensic	eyasenkundleni; 
forest	ihlathi; 
forestry	ulwazi-mahlathi; 
forests	amahlathi; 
forever	ngonaphakade; 
forfeit	lahlekelwa; 
forfeited	lahlekelwa; 
forfeiture	ukulahlekelwa; 
forged	 sayine ngenkohliso; ukudibanisa ngomlilo; khandile; 
forget	ukulibala; 
form	 isitulo eside;  ukuyila;  bumba;  imo;  imilo; ifomu; 
formal	ngokwasemthethweni; 
formally	ngokusemthethweni;  ngokusesikweni; 
format	 ukumila; ukwakheka; 
formation	 uyilo;  ihlelo labadlali; ukubumba; 
formations	 iziyilo;  amahlelo abadlali; izintlu zeemilo ezenziwa ngabadanisi; izakhiwo; 
formed	 isitulo eside;  ukuyila;  bumba;  imo;  imilo; ifomu; 
former	yangaphambili; 
formerly	 yamandulo; ngaphambili; 
forms	 ukuyila; imo;  imilo;  izimo;  iifomu;  izitulo ezide; 
formula	iformula; 
formulation	 uyilo; ukwakheka; 
forth	 ukususela ngoku; njalo; 
forthcoming	ezayo; 
forthwith	 kamsinya; kwangoko;  kwangoku; 
forum	iqonga; 
forums	amaqonga; 
forward	phambili;  thumela; 
forwarded	thumele; 
foster	ukukhuthaza; 
fostering	ukukhuthaza; 
fought	ukulwa; 
found	misa; 
foundation	isiseko; 
foundations	iziseko; 
founded	misa; 
founder	umseki; 
founding	misa; 
four	isine; 
fourth	 owesine; eyesine; 
frame	isakhelo;  uphahla; 
framework	inkqubo-sikhokelo;  uphahla; 
frameworks	amaphahla; iinkqubo-sikhokelo; 
franchise	 amalungelo obumi; ilungelo lokuvota; 
fraternity	ubuzalwane; 
fraud	 inkohliso; ubumenemene; 
fraudulent	nobuqhophololo; 
free	khululekile; 
freed	khululwe; 
freedom	inkululeko;  ukushukuma ngokukhululekileyo; 
freedoms	 ukushukuma ngokukhululekileyo; iinkululeko; 
freely	ngokukhululekileyo; 
freight	umthwalo;  impahla ethuthwa yinqanawa, uloliwe okanye inqwelo-moya; 
frequency	ukuphinda-phinda;  isitishi samaz'omoya; 
frequently	rhoqo; 
fresh	 tsha; pholileyo;  qaqambile; hlaziyekile; 
friend	umhlobo; 
friendly	ngobuhlobo; 
friends	abahlobo; 
friendship	ubuhlobo; 
from	 isuka; ivela; 
front	umphambili; 
fruit	iziqhamo; 
fruitful	enempumelelo;  eneziqhamo; 
fuel	 izibaso; amafutha; 
fuels	 izibaso; amafutha; 
fulfil	feza;  zalisekisa; 
fulfilling	 zalisekisayo; fezayo; 
full	ezeleyo; 
full-time	isigxina;  ixesha lonke; 
fully	ngokupheleleyo; 
function	 umsebenzi othile; umsebenzi;  sebenza;  isiphumo sentsebenziswano yamanani; 
functional	esebenzayo; 
functionality	isakhono sokusebenza; 
functioning	 umsebenzi othile; umsebenzi wamaqhosha ekhompyutha; umsebenzi;  sebenza;  isiphumo sentsebenziswano yamanani; 
functions	 imisebenzi ethile; imisebenzi yamaqhosha ekhompyutha; imisebenzi;  iziphumo sentsebenziswano yamanani;  sebenza; 
fund	ingxowa-mali; 
fundamental	isiseko; 
fundamentally	ngokwesiseko; 
funded	ingxowa-mali; 
funding	ingxowa-mali; 
funds	iingxowamali; 
funeral	umngcwabo; 
furnish	 ukuxhobisa ngempahla; ukufaka impahla; 
furnished	ifakwe impahla;  ixhotyiswe ngempahla; 
furniture	 imphala yendlu; ifenitshala; 
further	 ngaphezu koko; ngaphaya; 
furthermore	ngaphaya koko; 
future	 ixesha eliya kuza;  ixesha elizayo; ixesha eliza kuza; 
gain	inzuzo;  ukuzuza; 
gained	inzuzo;  ukuzuza; 
gains	iinzuzo;  ukuzuza; 
gala	umsitho; 
galleries	isakhiwo sokubonisa ngobugcisa; iigalari; 
gallery	 igalari; isakhiwo sokubonisa ngobugcisa; 
gamble	ukugembula; 
gambling	ukugembula; 
game	 iinyamakazi; umdlalo;  iinyamakazi neentaka ezizingelwayo; 
games	imidlalo yokudibanisa; 
gap	isikhewu; 
gaps	izikhewu; 
garden	isitiya; 
gardens	izitiya; 
garnishee	ukuthinjelwa ukwanelisa ibango; 
gas	igesi; 
gateway	isango; 
gather	ukuhlangana; 
gathered	ukuhlangana; 
gathering	intlanganiso; 
gave	nikile; 
gazette	igazethi; 
gear	igiye; 
geared	igiye; 
gender	isini; 
gender-based	ngokusekelwe kwisini; 
general	ngokubanzi;  injengele; 
generally	ngokubanzi; 
generate	velisa; 
generated	velisa; 
generating	velisa; 
generation	imveliso;  isizukulwana; 
generations	 izizukulwana; iimveliso; 
genres	iindidi zobugcisa; 
gentlemen	amanene; 
geographic	eyejografi; 
geographical	okwemimandla;  ngokwejografi; 
geography	 ijografi;  inzululwazi ngezelizwe; ezelizwe; 
get	fumana; 
gets	ufumana; 
getting	ukufumana; 
giant	 isigebenga; ingxilimbela;  izim; 
gift	isipho;  isiphiwo; 
girl	intombazana; 
girls	amantombazana; 
give	nika; 
gives	unika; 
giving	ukunika; 
glad	vuya; 
glass	iglasi; 
global	 izwelonke; kwehlabathi; 
globally	ilizwe jikelele; 
globe	ingqukuva;  iglobhu;  ilizwe jikelele; 
glory	uzuko; 
go	hamba; 
goal	 inqaku; injongo; 
goals	 amanqaku; iinjongo; 
goes	uyahamba; 
going	ukuhamba; 
gold	igolide; 
golden	eyegolide; 
gone	uhambile; 
good	ilungile; 
goods	 iimveliso; impahla; 
google	ugoogle; 
gore	 ihlwili;  ukugwaza; ukubhovula;  ukuhlaba; 
gospel	 umculo wenkolo; umculo wezenkolo; 
got	fumene; 
govern	ukulawula;  lawula; 
governance	ulawulo; 
governed	ukulawula;  lawula; 
governing	ukulawula; 
government	urhulumente; 
government's	ekarhulumente; 
governments	oorhulumente; 
governor	irhuluneli; 
governors	iirhuluneli; 
grace	ufefe; 
grade	isigaba;  ihlelo;  ukuhlela; 
grades	iigreyidi;  amabanga;  izigaba; ukuhlela; 
grading	ukuhlela; 
gradually	kuhle; 
graduate	indanga;  fumana isidanga; 
graduates	izidanga;  fumana isidanga; 
grand	 ebalaseleyo; enkulu; 
granted	nikwe isibonelelo;  nikwe uncedo ; 
granting	Ukunika isibonelelo; uncedo ngemali; 
grants	izibonelelo; 
graphic	Eyokuzoba; 
grass	ingca; 
grassroots	amaxhwitha-ntamo; 
grateful	anombulelo; 
gratitude	umbulelo; 
grave	ingcwaba; 
graves	amangcwaba; 
great	nkulu; phakamileyo; 
greater	nkulu kune-; phakeme kune-; 
greatest	eyona iphakamileyo;  eyona inkulu; 
greatly	kakhulu; 
green	 yenza luhlaza; luhlaza; 
greetings	imibuliso; 
grew	 ukutyala; ukukhula; 
grind	ukusila;  ukuguba; 
gross	 iidazini ezilishumi elinambini; ewonke; 
ground	ukusila;  ukuguba; 
ground-breaking	ukuqalisa; 
groundbreaking	ukuqalisa; 
grounds	izizathu;  amabala; 
group	 amanani angamaqela ngokuzalana; misa ngokwamaqela; 
groups	amaqela; 
grow	 ukutyala; ukukhula; 
growing	 ukutyala; ukukhula; 
grown	 ukutyala; ukukhula; 
growth	 iqhuma; ukukhula; 
guarantee	isiqinisekiso; 
guaranteed	qinisekisiwe; 
guarantees	iziqinisekiso; 
guard	 abalindi; umlindi; 
guardian	umgcini;  umlondolozi; 
guest	undwendwe; 
guests	undwendwe; 
guidance	inkokelo; 
guide	isikhokelo;  khokela; 
guided	khokhelwe; isikhokelo; Khokhelwe;  khokela; 
guideline	isikhokelo; 
guidelines	izikhokelo; 
guides	 abakhokeli; izikhokelo+D945; abakhokeli;  khokela; 
guiding	isikhokelo;  ukukhokhela; ukukhokhela;  khokela; 
guilt	isazela; 
guilty	ukuba netyala; 
gun	umpu; 
had	ubenayo; 
hail	isichotho; 
hailed	isichotho; 
hails	isichotho; 
half	isiqingatha; 
hall	iholo; 
hand	isandla;  usiba; 
handed	isandla;  usiba; 
handing	isandla;  usiba; 
handled	iphethwe; 
handling	ukuphatha; 
handover	nikezela; 
hands	 iintsiba; izandla; 
happen	ukwenzeka; 
happened	kwenzekile; 
happening	ukwenzeka; 
happens	kuyenzeka; 
happy	ukonwaba;  ikhaya elonwabileyo; 
harassment	 intshutshiso; ubandezelo;  ukukhathaza; ukuhlupha; 
hard	lukhuni; 
hare	umvundla; 
harm	umonakalo;  enzakalisa; 
harmful	inobungozi;  -nengozi; 
harmony	 ukuvana; imvisiswano;  ungqinelwano-zandi; 
has	unayo; 
hatred	inzondo; 
have	unayo; 
having	ukuba nayo; 
hazardous	enengozi; 
he	yena; 
head	intloko; 
headed	ikhokelwe; 
heading	intloko;  isihloko; 
headline	inqaku eliphambili; 
headlines	amanqaku aphambili; 
heads	iintloko; 
heal	ukuphila; 
healing	 ukuphilisa; ukunyanga; 
health	impilo; 
healthcare	inkathalelo yempilo; 
healthy	philileyo; 
hear	yiva; 
heard	vile; 
hearing	 ukuva; uvavanyo; 
hearings	iimvavanyo; 
hears	uyeva; 
heart	 umbindi welizwe;  intliziyo; iziko; 
heavy	enzima; 
hectare	ihektare; 
hectares	iihektare; 
height	 umphakamo; ubude;  ukuphakama; 
heights	imiphakamo; 
held	qulatha; 
help	uncedo; 
helped	ncedile; 
helping	ukuphinda; 
helps	unceda; 
hence	 ngoko ke; kususela ngoku;  kusukela ngoku; 
her	yena; 
heraldry	inzululwazi ngeembasa; 
here	apha; 
hereby	ngokwenjenje; 
hereinafter	emva koku; 
heritage	ilifa;  amafa emveli;  ilifa lemveli; 
hero	igorha;  iqhawe; 
heroes	 amagorha; amaqhawe; 
heroine	iqhawekazi; 
heroines	amaqhawekazi; 
herself	ngokwakhe; 
hi	molo; 
hidden	isikhumba; 
hide	isikhumba; 
hierarchies	izintlu zobukhulu; 
high	iphakamile; 
high-level	umphakamo ophezulu; 
higher	phezulu; 
highest	iphakamile; 
highlighted	dontsa amehlo; 
highlights	dontsa amehlo; 
highly	kakhulu; 
hill	induli; 
hills	iinduli; 
him	yena; 
himself	ngokwakhe; 
his	eyakhe; 
historians	ababhali-mbali; 
historic	eyembali; 
historical	yasembalini; 
historically	ngokwembali; 
histories	iimbali; 
history	imbali; 
hit	betha; 
hoc	injongo; 
hold	qulatha; 
holders	izipatho; 
holding	egcinayo; 
holdings	ezigcinayo; 
holds	qulatha; 
holiday	iholide; 
holidays	iiholide; 
holistic	epheleleyo; 
homage	 ukubusa; imbeko; 
home	ikhaya; 
homelessness	ukubangabinakhaya; 
homepage	iphephe lasekhaya; 
homes	amakhaya; 
honorary	isidanga esinikwe ngegama; 
honour	 imbeko; isidima; 
honourable	Obekekileyo; 
honoured	owongwayo; 
honouring	ukuwonga; 
honours	iimbeko; 
hope	ithemba; 
hoped	ithemba; 
hopefully	ngethemba; 
hopes	amathemba; 
hospital	isibhedlele;  isibhedlela; 
hospitality	 ukubuka iindwendwe; isisa kwiindwendwe; 
hospitals	izibhedlele; 
hosted	Gcine iindwendwe; 
hosting	Ukugcina iindwendwe; 
hosts	Abagcini beendwendwe; 
hotel	ihotele; 
hotels	iihotele; 
hour	iyure; 
hours	iiyure; 
house	 umzi; indlu; 
housed	hlalisile;  umzi; indlu; 
household	 umzi; indlu; 
households	izindlu; imzi; 
houses	hlalisa;  imizi; izindlu; 
housing	indawo yokuhlala;  ulwakhelo-zindlu; 
how	njani; 
however	nangona kunjalo; 
http	ihttp; 
https	iihttps; 
hub	eyona ndawo ixakeke kakhulu;  umphakathi wevili; 
huge	khulukazi; khulu kakhulu; 
human	 ebubuntu;  ngokoluntu;  womntu; umntu; 
humane	 nemfesane;  unobuntu; nenceba; 
humanities	abantu; 
humanity	 ubuntu; uluntu; 
humankind	uluntu; 
humans	abantu; 
humble	 zithobileyo; lulamileyo; 
humbled	 zithobile; lulamile; 
humility	 ubulali; ukuzithoba; 
hundred	ikhulu; 
hundreds	amakhulu; 
husband	umyeni; 
icon	isikhombi-nkqubo; 
iconic	eyemifanekiso ezukileyo; 
icons	izikhombi-nkqubo; 
id	i-id; 
idea	ingcamango; 
ideal	eyona-yona; 
ideals	eyona-yona; 
ideas	ingcamango; 
identical	fana nqwa; 
identified	chonga; 
identifies	chonga; 
identify	chonga; 
identifying	chonga; 
identities	ubuwena; 
identity	ubuwena; 
if	ukuba; 
ill	gula; 
illegal	okungekho mthethweni; 
illness	isigulo;  ukuqula; 
illustrate	 zekelisa; umzekelo;  bonisa; 
illustrated	 zekelisa; umzekelo;  bonisa; 
image	umfanekiso; 
images	umfanekiso; 
imagination	ingqikelelo;  intelekelelo; 
imbalances	ukungalingani; 
immediately	kwangoku;  ngoko nangoko; 
immensely	kakhulukazi; 
immigration	ungenelelo; 
imminent	kufuphi; 
immovable	engashenxisekiyo; 
immunisation	ukugonya; 
impact	ukungqubana; 
impacts	amandla okungqubana;  ingqubana; 
impaired	onakalisiwe; thothisa;  nciphisa; 
impediments	izithintelo; 
imperative	uhlobo lokuyalela; 
imperatives	uhlobo lokuyalela; 
implement	phumeza;  isixhobo sokusebenza; 
implementation	ukuphunyezwa; 
implemented	phumeza;  isixhobo sokusebenza; 
implementing	phumeza;  isixhobo sokusebenza; 
implements	phumeza;  isixhobo sokusebenza; 
implications	iingxaki; 
implies	iquka; 
import	 isingeniso ngorhwebo;  ukungenisa elizweni; ngenisa elizweni; 
importance	ukubaluleka; 
important	balulekileyo; 
importantly	ngokubalulekileyo; 
imported	ukungenisa elizweni;  isingeniso ngorhwebo;  ngenisa elizweni;  ukungenisa ngorhwebo; 
importer	umrhwebi-mngenisi; 
imports	iimpahla ezingeniswa elizweni; 
impose	 ukubeka phezu; ukunyakathisa; 
imposed	 nyakathisiwe; bekiwe; 
imposing	 ukubeka phezu; ukunyakathisa; 
imposition	unyakathiso; ubeko phezu; 
impossible	engenakwenzeka; 
impressed	ushicilele;  wenze uphawu; 
impressive	chukumisayo; 
imprison	faka entolongweni;  ukufaka entolongweni; 
imprisoned	faka entolongweni;  ukufaka entolongweni; 
imprisonment	ukufakwa entolongweni; 
improper	ngokuphosisekileyo; ngokungafanelekanga; 
improve	phucula;  ukuqhubela phambili; 
improved	phucula;  ukuqhubela phambili; 
improvement	ukuphucuka; 
improvements	iimpuculo; 
improving	phucula;  ukuqhubela phambili; 
in	ukufaka; 
inability	ukungabinako; 
inadequate	nganelanga; 
inappropriate	ngafanelekanga; 
inaugural	 ukubeka esikhundleni; ukungenisa esikhundleni; 
inauguration	ukubekwa esikhundleni; 
incapable	ukungabinako; 
incapacity	ukungabinako;  ukungabinamandla; 
incarceration	ukufaka entolongweni; 
incentive	ekhuthazayo; 
incentives	izikhuthazi; 
inception	isiqalo; 
incidence	isehlo; 
incident	isiganeko;  isehlo; 
incidental	nokuhla; 
incidents	 izehlo; iziganeko; 
include	ukuquka;  quka; 
included	ukuquka;  quka; 
includes	ukuquka;  quka; 
inclusion	ubandakanyo; 
inclusive	equkayo; 
inclusivity	ukuquka; 
income	ingeniso; 
incomes	ingeniso; 
incomplete	engaphelelanga; 
incorporate	ukufakelela; 
incorporated	ukufakelela; 
incorporates	ukufakelela; 
incorporation	 ukubandakanya; umanyano; 
incorrect	inxaxhile; 
increase	 unyuso;  yandisa; ukwandisa; 
increased	 unyuso;  yandisa; ukwandisa; 
increases	 unyuso;  yandisa; ukwandisa; 
increasing	 unyuso;  yandisa; ukwandisa; 
increasingly	ngaphezulu nangaphezulu; 
inculcate	 milisela; ukubethelela; 
incurred	 ukuzenzela ityala;  ukungena etyaleni; engxakini; 
indeed	ngokwenene; 
independence	 uzimele geqe; ukuzimela; 
independently	ngokuzimeleyo; 
index	 isalathisi; isalathiso; 
indicate	ukuqondisa;  bonakalisa; 
indicated	 ukuqondisa; bonakalisa; 
indicates	 ukuqondisa; bonakalisa; 
indicating	 ukuqondisa; bonakalisa; 
indication	umqondiso; 
indications	imiqondiso; 
indicative	eqondisayo;  ebonisayo; 
indicator	 isalathisi; isibonisi; 
indicators	izalathisi; izibonisi; 
indices	 izalathiso; izalathisi; 
indigenous	-emveli;  nkulelane; 
indirectly	ngokungathanga ngqo; 
individual	omnye; 
individually	ngokuzimeleyo; 
individuals	abantu ngabanye; 
industrial	yamashishini; 
industries	amashishini; 
industry	 ushishino; ishishini; 
inequalities	ukungalingani; 
inequality	ukungalingani; 
infected	ukusuleleka; 
infection	usuleleko;  ukusuleleka;  usulelo; 
infections	amasulelo; 
inflation	ukunyuka kwamaxabiso; 
inflows	izingeniso; 
influence	impembelelo; 
influenced	uphembelelwe; 
info	ulwazi; 
inform	azisa; 
information	ulwazi; 
informed	oluqondwayo; 
informing	azisa; 
infrastructure	izinto zokusebenza; 
inherent	eyemvelo; esegazini; 
inherit	fumana ilifa;  ukudla ilifa; 
inherited	 fumana ilifa; ukudla ilifa; 
initial	lokuqala;  elokuqala; 
initially	ekuqaleni; 
initiate	umkhwetha;  yalusa; 
initiated	umkhwetha;  yalusa; 
initiative	 ilinge; isantya;  inyathelo lokuqala; 
initiatives	amalinge;  amanyathelo okuqala;  izantya; 
initiator	umsunguli; umqali; 
injuries	amanxeba; izenzakalo; 
injury	 umenzakalo; isilonda; 
injustice	intswelo-bulungisa; 
injustices	iintswelo-bulungisa; 
inmate	umhlali; 
inmates	abahlali; 
inner	ephakathi; 
innovative	ukuba nokungenisa izinto ezintsha; 
input	 iinkcukacha ezifakiweyo;  ukufaka iinkcukacha; umfakwa; 
inputs	 iinkcukacha ezifakiweyo;  ukufaka iinkcukacha; izifakelo; 
inquest	uphando ngokufa; 
inquiry	uphando; 
inscribed	bhaliweyo; 
insert	faka; 
inserted	fakile; 
insertion	isongezo;  umfakelo; 
inserts	izifakelo; 
inside	ngaphakathi; 
insight	ukuqonda;  ingqiqo; 
insights	iingqiqo; 
insolvency	ukungabinakuhlawula amatyala; ukutshona; 
inspect	ukuva;  hlola; 
inspection	 uviwo; ukuhlola; 
inspections	iimvavanyo;  iimviwo; 
inspector	umhloli; 
inspectorate	umbutho wabahloli; 
inspectors	abahloli; 
inspiration	ukukhuthaza; 
inspire	phembelela; khanyisela;  phefumlela; 
inspired	 phefumlelwe; khanyiselwe;  phembelelwe; 
inspiring	 ephefumlelayo; ekhanyiselayo;  ephembelelayo; 
install	ukufakela; 
installation	ufakelo; 
installed	ifakelwe; 
instalment	isavenge; 
instalments	izavenge; 
instance	umzekelo; 
instances	imizekelo; 
instead	endaweni yoku; 
institute	iziko; 
instituted	isekiwe; 
institution	iziko; 
institutional	eyeziko ; 
institutions	amaziko; 
instruction	imfundiso;  umyalelo; 
instructional	eyokuyalela;  eyokwazisa; eyokufundisa; 
instructions	 iimfundiso; imiyalelo; 
instrument	 isixhobo somsebenzi;  isikhaliso; isixhobo; 
instruments	izixhobo;  izixhobo zomsebenzi; izikhaliso; 
insurance	i-inshorensi; 
insurer	umnikeli weinshorensi; 
intangible	engabambekiyo; engenakuchukunyiswa; 
integral	inani elizeleyo; 
integrate	 fakelela; ukubumba; 
integrated	 fakelela; ukubumba; 
integration	ukumanya; 
integrity	ubulungisa;  imfezeko; 
intellectual	ingqondi; 
intellectuals	iingqondi; 
intelligence	uhlakanipho;  ubuntlola; 
intend	ukuzimisela; 
intended	ukuzimisela; 
intends	ukuzimisela; 
intensify	 andisa;  yenza ngaphezulu;  khulisa; qinisa; 
intensive	isicokisisi; 
intent	ukuzimisela;  inyameko; 
intention	injongo; 
intentionally	ngenjongo; 
inter	ukungcwaba; 
interact	sebenzisana;  -sebenzisana; 
interacting	sebenzisana;  -sebenzisana; 
interaction	ukuzamazamana; 
interactive	ezinxibelelanayo; 
interception	ukukhawulela;  ukunqanda;  ukubamba; ukuthintela; 
interdepartmental	phakathi kwamasebe; 
interest	umdla;  ukuba nomdla;  inzala; 
interested	ukubanomdla; 
interesting	enomdla; 
interests	imidla; -banenxaxheba;  iinzala;  ukuba nomdla; 
interfaith	phakathi kweenkolo; 
interfere	ukuphazamisa; 
interference	uphazamiso; 
intergenerational	phakathi kweenzala; 
intergovernmental	phakathi koorhulumente; 
interim	 ixesha eliphakathi kweziganeko; okwexeshana;  eliphakathi; 
intermediaries	 abathetheleli;  abalamleli; oonozakuzaku; 
intermediary	umlamleli;  unozakuzaku; umthetheleli; 
intermediate	ophakathi; 
internal	 engaphakathi; ngaphakathi; 
international	ngokwamazwe ngamazwe; 
internationally	ngokwezizwe; 
internet	i-inthanethi; 
interns	oogqirha abatsha abafunda kwisibhedlele; 
interpret	 tolika; ukutolika; 
interpretation	utoliko-ngoma; 
interpreted	itolikiwe; 
interrogate	ukubuza; 
interval	isithuba; 
intervals	izithuba; 
intervene	ukulamla;  ukungena phakathi; 
intervention	ukulamla;  ukungena phakathi; 
interventions	iinkqubo zokulamla; 
interview	 ukubonana;  dlana indlebe; udliwano-ndlebe;  udliwanondlebe; 
interviews	ukubonana;  dlana indlebe; amadliwano-ndlebe; 
intestate	ukufa ungayolelanga; 
into	ngaphakathi; 
introduce	faka;  ukwazisa;  ukuqalisa;  zisa;  azisa; 
introduced	faka;  ukwazisa;  ukuqalisa;  zisa;  azisa; 
introducing	faka;  ukwazisa;  ukuqalisa;  zisa;  azisa; 
introduction	intshayelelo; 
invalid	 ngekhomthethweni; ngenagunya; lambathayo; 
inventory	uluhlu lweempahla zendlu; 
invest	ukuzalisa imali;  tyala imali; 
invested	tyala imali;  ukuzalisa imali; 
investigate	ukuphanda; 
investigated	iphandiwe; 
investigating	ukuphanda; 
investigation	uphando; 
investigations	amaphengululo; 
investigative	ecikidwayo;  ephengululwayo; 
investigator	umphengululi; 
investigators	abaphengululi; 
investing	tyala imali;  ukuzalisa imali; 
investment	isixa semali etyaliweyo; 
investments	iinzaliso-mali; 
investors	abatyali-mali; 
invitation	isimemo; 
invite	mema; 
invited	mema; 
invites	mema; 
inviting	mema; 
involve	bandakanyeka; 
involved	bandakanyekile; 
involvement	ubandakanyo; 
involves	ibandakanya; 
involving	ibandakanya; 
iron	intsimbi;  iayoni;  iayini;  ukuayina; 
irregularities	izinto ezichasene nomthetho; 
irregularity	ukuchasana nomthetho; 
irrespective	 kungakhathaliseki; kungakhathaleli ziphumo; 
irrigation	 unkcenkceshelo; ukunkcenkceshela; 
is	i; 
island	isiqithi; 
issue	 uphumo; umba; 
issued	 uphumo; umba; 
issues	imiba; imicibi; 
issuing	 uphumo; ukukhupha; 
it	yona; 
it's	yi; 
item	 umcimbi; into;  ilungu; 
items	izinto;  imicimbi; 
its	eyayo; 
itself	ngokwayo; 
jazz	umngqungqo; 
jewellery	 isihombo sentsimbi; izihombiso zamatye anqabileyo; 
job	umsebenzi; 
jobs	imisebenzi; 
join	 ukudibanisa amalaphu; ukudibanisa; 
joined	 ukudibanisa amalaphu; ukudibanisa; 
joining	 ukudibanisa amalaphu; ukudibanisa; 
joint	ilungu;  umxokomezelo;  isidibaniso;  isidibanisi; 
jointly	kunye; 
journalism	ukubhala emaphepheni; 
journalist	intatheli; 
journalists	iintatheli; 
journey	ukuhamba;  uhambo; 
joy	uvuyo; 
judge	 gweba;  ukugweba; ijaji; 
judgement	isigwebo; 
judges	iijaji;  ukugweba;  abagwebi; 
judgment	isigwebo; 
judgments	izigwebo; 
judicial	-enkundla; 
junior	omtsha; 
jurisdiction	 uphatho; igunya; 
jurisdictions	amagunya; 
juristic	eyomthetho; 
just	 enobulungisa; nje; 
justice	ubulungisa;  ubulunga; 
justified	enokugwetyelwa; 
justify	ukugwebela; 
kb	ukb; 
keen	nzulu; zondelele;  bukhali;  nomdla; 
keep	gcina; 
keeping	ukugcina; 
kept	gcinile; 
key	isikhokelo;  iqhosha;  amazinyo;  isitshixo; 
keynote	inqaku eliphambili; 
kick	khaba; 
kick-off	ukuqalisa komdlalo; 
kill	ukubulala; 
killed	ukubulala; 
kilometre	ikhilomitha; 
kilometres	iikhilomitha; iikhilometha; 
kind	ukuba nobuntu; 
kindly	ngobubele; 
kinds	iintlobo; 
king	ukumkani; 
kingdom	ubukumkani; 
kings	ookumkani; 
km	ikm; 
knew	ubesazi; 
know	ukwazi; 
knowing	ngokwazi; 
knowingly	ngokwazi; 
knowledge	ulwazi; 
known	ukwaziwa; 
knows	uyazi; 
laboratories	iilebhu; 
laboratory	ilebhu; 
labour	 ukusebenza nzima;  ukusebenza;  ukubeleka; umsebenzi; 
lack	 intswelo; ukuswela; 
ladies	abasetyhini;  amanenekazi; 
laid	 beka iqanda; ukubekela; 
lake	ichibi; 
land	 ukuhla; umhlaba;  intsimi;  ilizwe; 
landfill	itiphu; 
lands	imihlaba; 
landscape	imbonakalo-mhlaba; 
language	ulwimi; 
languages	ulwimi; 
lapse	ukuphela kwexesha; 
large	-khulu; 
large-scale	ngobuninzi; 
largely	kakhulukazi; 
larger	-khulu; 
largest	-khulu; 
last	eyokugqibela; 
lasting	ngokuthatha ixesha elide; ngokuqhubayo; 
lastly	okokugqibela; 
late	mva; 
later	kamva; 
latest	okutsha; 
latter	eyamva; 
laughter	uhleko; 
launch	 ukuphehlelela; ukundulula; 
launched	 ukuphehlelela; ukundulula; 
launches	izindululo;  ukuphehlelela; 
launching	 ukuphehlelela; ukundulula; 
laundering	utshintshiselwano ngemali; 
laureate	othweswe ngesithsaba; 
laureates	abathweswe ngesithsaba; 
law	umthetho; 
law-making	ukwenza umthetho; 
lawful	esemthethweni; 
lawfully	ngokusemthethweni; 
laws	imithetho; 
lawyer	igqwetha; 
lawyers	amagqwetha; 
lay	 beka iqanda; ukubekela; 
laying	 beka iqanda; ukubekela; 
lead	ilothe;  umsizi;  intambo yombane; 
leaders	iinkokheli; 
leadership	iinkokheli;  ubunkokeli; 
leading	ukukhokela; 
leads	 iintambo zombane;  umsizi; iilothe; 
leaflet	igqatyana; 
leaflets	amagqatyana; 
league	umanyano; 
learn	ukufunda; 
learned	fundile; 
learner	umfundi; 
learners	abafundi; 
learning	fundayo; 
learnt	fundile; 
lease	ingqeshiso; 
leased	ingqeshiso; 
leasehold	umhlaba oqeshisileyo; 
least	eyona incinci; 
leave	ikhefu; 
leaves	amakhefu; 
leaving	ikhefu; 
lecture	imfundiso; 
led	ilothe;  umsizi;  intambo yombane; 
left	ekhohlo; 
leg	 umlenze; umjikelo; 
legacies	amafa; 
legacy	ilifa; 
legal	 semthethweni; ngokomthetho; 
legally	ngokusemthethweni; 
legend	ilivo; 
legendary	eyelivo; 
legends	amavo; 
legislation	 umiso-mithetho; uwiso-mthetho; 
legislative	eyowisomthetho; 
legislature	indlu yowiso-mthetho; 
legislatures	izindlu zowiso-mthetho; 
legitimacy	ukuba semthethweni; 
legitimate	esemthethweni; 
lend	boleka; 
lending	boleka; 
length	ubude;  ubude besifundo; 
less	 nganeno; ngaphantsi; 
lesser	enganeno; 
lesson	isifundo; 
lessons	izifundo; 
let	vumela; qeshisa; 
let's	masithi; 
letter	incwadi;  unobumba; 
letters	iileta; 
level	 umphakamo;  isindindanisi;  umlinganiselo;  ukundinda; umgangatho; 
levels	 imilinganiselo; imigangatho;  ukundinda;  izindindanisi; -the tyaba;  imiphakamo; 
levied	erhafisiweyo; 
levies	iirhafu; 
levy	irhafu; 
liabilities	okulityala; 
liability	okulityala; 
liable	melwe; 
liaise	dibanisa;  manya; 
liaison	umanyano; 
liberalisation	inkululeko;  ukukhulula; 
liberation	ukukhulula; 
librarian	umsebenzi wethala leencwadi; 
librarians	abasebenzi bethala leencwadi; oononcwadi; 
libraries	 amathala eencwadi;  amagumbi amacwecwe; izindlu zeencwadi; 
library	 igumbi lamacwecwe; indlu yeencwadi;  ithala leencwadi; 
licence	ilayisenisi;  isiqiniselo; 
licences	iilayisenisi;  iziqiniselo; 
license	iphepha-mvume; 
licensed	ukubanelayisensi; 
licensee	umnini layisensi; 
licensees	abanini layisensi; 
licensing	iphepha-mvume; 
lie	ukulala; 
lies	ukulala; 
life	ubomi; 
lifetime	eyobude bobomi bomntu; 
light	 ukulumeka; lula;  ukukhanya;  likhanya; 
lighting	isikhanyisi; 
like	efana; 
likely	efaneleyo; 
limit	umda; 
limitation	umda; 
limitations	imida; 
limited	nemida; 
limiting	umda; 
limits	imida; 
line	 ukwaleka; umgca; 
line'	 ukwaleka; umgca; 
line-up	ukudwelisa; 
lines	imigca yeleli; 
link	 isingqamaniso; ukudibanisa;  ikhonkco; 
linkage	uqhagamshelwano; 
linkages	uqhagamshelwano; 
linked	 isingqamaniso; ukudibanisa;  ikhonkco; 
linking	 isingqamaniso; ukudibanisa;  ikhonkco; 
links	amakhonkco; 
liquid	 bumanzirha; ulwelo;  -lulwelo; 
liquidation	ukutshitshiswa kweshishini; 
liquidator	 umthengisi wempahla ethinjiweyo; unothimba; 
liquidity	 ukuba nemali yokuhlawula; ukuba lulwelo; 
liquor	utywala; 
list	uluhlu; 
listed	uluhlu; 
listen	 phulaphula; mamela; 
listing	uluhlu; 
lists	 amabala okulwa; izintlu; 
literacy	ubuchule bokufunda nokubhala; 
literally	ngokwamagama; 
literary	ngokoncwadi; 
literature	uncwadi; 
litigation	umangalelwano; 
little	ncinane; 
live	 iingcingo ezinombane; ukuphila; 
lived	 iingcingo ezinombane; ukuphila; 
livelihood	impiliso; 
livelihoods	iimpiliso; 
lives	ubomi; 
livestock	imfuyo; 
living	philayo; 
load	umthwalo; 
load-shedding	ukunciphisa umthwalo; 
loan	 imbolekiso; imali-mboleko; 
loans	 iimbolekiso; iimali-mboleko; 
local	-kwengingqi; 
locally	kwindawo ethile;  engingqini; 
locals	yakuloo ndawo; ezengingqi; 
located	miswe; bekwe; 
location	 ilokishi; indawo; 
lock-up	tshixa; 
lodge	indawo yokuhlala; 
lodged	qeshe indawo yokuhlala; 
lodging	indawo yokuhlala; 
logistics	amalungiselelo ezothutho; 
long	inde; 
long-term	ixesha elide; 
longer	inde; 
look	jonga; 
looked	jongile; 
looking	ukujonga; 
looks	ujonga; 
loop	isango;  irhintyela; 
lose	ukubethwa; 
loss	ilahleko;  ilahleko ekhulwini; 
losses	iilahleko; 
lost	ukubethwa; 
lot	impilo namava omntu; 
lottery	iLotho; 
love	thanda; 
loved	thandiwe; 
lovers	abathandani;  izithandwa; 
low	elisezantsi; 
low-income	ingeniso ephantsi; 
lower	ngaphantsi; 
lowest	elona lisezantsi; 
ltd	iltd; 
lump	iqhuma; 
mace	intonga yegunya; 
machine	umatshini; 
machinery	oomatshini; 
machines	oomatshini; 
macro-economic	uqoqosho olukhulu; 
macroeconomic	uqoqosho olukhulu; 
made	 umhlobo; yenza; 
magazine	 ulindixesha; imagazini; 
magazines	 oolindixesha; iimagazini; 
magisterial	ekamantyi; 
magistrate	umantyi;  imantyi; 
magistrate's	eyemantyi; 
magistrates	oomantyi; 
magnificent	enobuqhawe; 
magnitude	ubukhulu; 
mail	iposi;  ukuposa; 
main	eyintloko; 
mainly	ikakhulu; 
mainstream	intsingiselo eyintloko; 
mainstreaming	ukuhlela ngentsingiselo eyintloko; 
maintain	ukugcina;  londoloza; 
maintained	ukugcina;  londoloza; 
maintaining	ukugcina;  londoloza; 
maintains	ukugcina;  londoloza; 
maintenance	 ukugcinwa; ulondolozo;  isondlo; 
major	 -khulu;  eyona inkulu; umntu omkhulu; 
majority	 ubuntu; uninzi;  isininzi; 
make	 umhlobo; yenza; 
makers	abenzi; 
makes	 iintlobo; yenza; 
making	 umhlobo; yenza; 
malaria	 imalariya; icesina; 
male	ubuduna;  iduna; 
males	 amaduna; amadoda; 
mall	udederhu lweevenkile; 
man	indoda; 
manage	lawula;  kwazile; 
managed	lawula;  kwazile; 
management	ukulawula;  impatho;  abalawuli; 
manager	umphathi; 
managers	abaphathi; 
manages	lawula;  kwazile; 
managing	lawula;  kwazile; 
mandate	 igunya lokuphumeza okuthile; igunya; 
mandated	 igunya lokuphumeza okuthile; igunya; 
mandates	 amagunya okuphumeza okuthile; amagunya; 
mandatory	egunyazisayo;  eyalelayo; 
manifestations	iimbonakalo;  iingcaciso; 
manner	indlela yokwenza; 
manual	 wezandla; incwadi; 
manufacture	 ukuvelisa; ukwenza; 
manufactured	velisiwe; kwenziwe; 
manufacturer	umvelisi; 
manufacturing	imveliso; 
manuscript	umbhalo-ngqangi; 
manuscripts	imibhalo-ngqangi; 
many	 ninzi; eninzi; 
map	 imaphu; imephu; 
mapping	ukuzoba imaphu; 
maps	iimaphu; 
march	umngcelele;  yenza umngcelele; 
marched	kumatshiwe; umngcelele;  yenza umngcelele; 
margin	 udini; ungqameko; 
marginal	 ekwinyele; ekwidini; 
marginalised	ukuthathwa ungenamsebenzi; 
marginalized	ukuthathwa ungenamsebenzi; 
marine	-yaselwandle; 
maritime	eyaselwandle; 
mark	 ukuphawula; uphawu;  inqaku;  yiphawule; 
marked	iphawulwe; 
market	 ukuthengisa emarikeni;  ukuthengisa;  imarike; abathengi; 
marketing	ukurhweba;  uthengiso emarikeni; 
markets	 iimarike;  ukuthengisa emarikeni;  ukuthengisa; abathengi; 
marking	ukumaka; 
marks	 ukuphawula; iimpawu;  amanqaku;  yiphawule; 
marriage	 ukutshata; umtshato; 
marriages	imitshato; 
married	utshatile; 
mass	 ubunto;  imfumba;  inkitha; ubunzima; 
massive	 ininzi; inkulu;  inzima; 
master	 inkosi; igcisa; 
master's	 eyenkosi; eyegcisa; 
match	 ukufanisa; umdlalo;  imatshisi;  umati;  hambelana;  ukuhambiselana;  ngqinelelanisa; 
matches	imatshisi; 
material	ilaphu; 
materially	ngokwezinto eziphathekayo; 
materials	iimathiriyeli; amalaphu; 
maternal	ekanina; ekamama;  eyonina; 
mathematical	ngokwemathematika;  ngokwezibalo; 
mathematics	 imathematika; izibalo; 
matric	imatriki; 
matrimonial	eyomtshato; 
matter	 ububovu; into; 
matters	 ububovu; imicimbi; iinkqubo; 
maturity	 ukuvuthisa; ukukhula;  ukuvuthwa; 
max	eyona inkulu; 
maximise	khulisa; 
maximum	ngokomlinganiselo ophezulu;  elona nani likhulu;  eyona inkulu; 
may	singa-;  banga-;  anga-; 
maybe	mhlawumbi; 
mayor	usodolophu; 
mayors	 izibonda zedolophu; oosodolophu; 
me	mna; 
mean	ovimbayo;  ;  ongenasisa; 
meaning	 intsngiselo; intsingiselo; 
meaningful	enentsingiselo; 
meaningfully	ngokunentsingiselo; 
meanings	iintsingiselo; 
means	 ithi;  amandla; iindlela;  ithetha ukuthi; 
meant	ibisithi; 
measurable	enokulinganiswa; 
measure	 umlinganiso; umlinganiselo;  ukulinganisa; 
measured	linganisiwe; 
measurement	 isilinganiso; umlinganiselo; 
measures	 ukulinganisa;  imilinganiso; imilinganiselo; 
measuring	ukulinganisela; 
mechanical	ngokuzenzekela; 
mechanism	umatshini womsebenzi othile; 
mechanisms	oomatshini bomsebenzi othile; iintsebenzo-mashini; 
mediation	ulamlo; 
medical	ekagqirha;  -onyango; 
medicine	iyeza;  ichiza; 
medicines	amayeza;  amachiza; 
medium	izinga eliphakathi;  ulwimi ekufundiswa ngalo; 
medium-term	ixesha eliphakathi; 
meet	dibana; 
meeting	intlanganiso; 
meetings	iintlanganiso; 
meets	udibana;  yanelisa; 
mega	enkulu; 
melting	ukunyibilika; 
member	ilungu; 
member's	eyelungu; 
members	amalungu; 
membership	ubulungu; 
memorandum	imemorandamu; 
memorial	isikhumbuzo; 
memories	iinkumbulo;  amagumbi okuthwala; 
memory	 igumbi lokuthwala; inkumbulo; 
men	amadoda; 
mental	 -engqondo; ngokwasengqondweni; 
mentally	ngengqondo; 
mention	xela; 
mentioned	xela; 
menu	imenyu; 
merchant	umrhwebi; 
mere	 kuphela;  kodwa; nje; 
merely	 kuphela;  kodwa; nje; 
merger	umanyano;  ukudibana; 
merit	umvuzo;  isidima;  imfaneleko; 
merits	iimfaneleko;  izidima; imivuzo; 
message	umyalezo; 
messages	imiyalezo; 
messenger	umthunywa; 
met	dibene; 
metal	intsimbi;  isinyithi; 
metals	 izinyithi; iintsimbi; 
method	indlela yokwenza;  umgaqo wokwenza; 
methodology	ulwazi-nkqubo; 
methods	iindlela;  imigaqo; 
metro	 imetro; isixeko esikhulu;  isithili esikhulu;  ikomkhulu; 
metropolitan	ummi wesixeko esikhulu;  umphathi wesixeko esikhulu; 
mg	img; 
micro	isixhobo esincinci seentlobo ngeentlobo zezinto; 
middle	ephakathi; 
midst	isazulu; 
might	amandla;  mhlawumbi; 
migration	imfuduko; 
milestone	isiganeko esibalulekileyo ebomini; 
milestones	iziganeko ezibalulekileyo ebomini; 
military	amajoni;  yasemkhosini; 
milk	ubisi;  ubusi; 
millennium	iwaka leminyaka; 
million	isigidi; 
millions	izigidi; 
mind	ingqondo; 
mindful	 ukunyamekela; ukucingela; 
minds	iingqondo; 
mine	 umgodi;  yimba; ukumba umgodi; 
mineral	 iminerali; isimbiwa; 
minerals	 iiminerali; izimbiwa; 
mines	imigodi;  ukumba umgodi;  yimba; 
minimise	nciphisa; 
minimum	 eyona incinane;  buncinane; ubuncinane; 
mining	 ukwemba emgodini; ishishini lezimbiwa; 
minister	umphathiswa;  umfundisi; 
minister's	 eyomphathiswa; eyomfundisi; 
ministerial	ubuphathiswa; 
ministers	abaphathiswa;  abafundisi; 
ministry	 intshumayelo nomsebenzi weNkosi yethu; iOfisi yoMphathiswa; 
minor	 ngaphantsi; umntwana;  osengumntwana; 
minority	 ubuntwana;  igcuntswana; ubumbalwa; 
minutes	ingxelo-micimbi; 
misconduct	ukuziphatha kakubi; 
misleading	elahlekisayo; 
missing	engekhoyo; 
mission	umnqophiso; 
missions	iminqophiso; 
mitigate	dambisa; thomalalisa;  nciphisa;  pholisa; 
mitigation	 ukuthomalalisa;  ukupholisa;  unciphiso; ukudambisa; 
mix	ukuxuba; 
mixed	 xubene; vangiwe; dibene;  xutyiwe; 
mm	imm; 
mobile	ehambayo; 
mobilisation	hlanganisa; 
mobility	ukushukuma;  ushukumiseko; 
model	umzekelo;  ukubumba;  umfuziselo; 
models	imizekelo;  imifuziselo;  ukubumba; 
moderate	phakathi;  umoya ophakathi ovela; 
modern	amaxesha angoku;  eyezimini; eyangoku; 
modernisation	ukwezela amaxesha angoku; 
modify	 guqula; ukuphucula; 
moment	umzuzwana; 
moments	umzuzwana; 
momentum	amandla; amandla okuzihambela; 
monetary	eyemali; 
money	imali; 
moneys	iimali; 
monies	iimali; 
monitor	 beka iliso; jonga;  imonitha; 
monitored	 beka iliso; jonga;  imonitha; 
monitoring	 beka iliso; jonga;  imonitha; 
monitors	 beka iliso; jonga; iimonitha; 
month	inyanga; 
monthly	ngenyanga; 
months	iinyanga; 
monument	ilitye lesikhumbuzo; 
monuments	amatye ezikhumbuzo; 
moral	 -ziphatha kakuhle;  imfundiso; isifundo; 
more	ngaphezulu; 
moreover	ngaphezu koko; 
morning	kusasa;  intsasa; 
mortality	ubulungisa;  indyikitya yokufa; 
mortgage	ukubambisa ngendlu; 
most	uninzi; 
mostly	ikakhulu; 
mother	umama; 
mothers	oomama; 
motion	intshukumo;  isindululo;  isiphakamiso; 
motions	iintshukumo;  izindululo;  iziphakamiso; 
motivation	ukukhuthaza; 
motor	injini; 
motto	isaci; 
mountain	intaba; 
mountains	iintaba; 
mouth	 ichweba lomlambo; umlomo; 
movable	eshenxisekayo; 
move	 shenxisa; inyathelo; 
moved	 shenxisa; inyathelo; 
movement	iqela;  intshukumo; 
movements	amaqela;  iintshukumo; 
moves	 shenxisa; amanyathelo; 
movie	umboniso bhanyabhanya; 
moving	ehambayo; 
much	 ninzi; ngokugqithisileyo; 
multi-party	amaqela amaninzi; 
multilateral	amacala amaninzi; 
multilingual	iilwimi ezininzi; 
multilingualism	ukuthethwa kweelwimi ngeelwimi; 
multimedia	unxazonke; 
multiple	isiphindwa; 
municipal	-yedolophu;  -masipala; 
municipalities	oomasipala;  amabhunga edolophu; 
municipality	umasipala;  ibhunga ledolophu; 
mural	umzobo oxhonywe eludongeni; 
murals	imizobo exhonywe eludongeni; 
murder	ukubulala;  imbulalo-mntu; 
museum	iziko lolondolozo lwembali; 
museums	iimuziyam; amaziko olondolozo lwembali; 
music	umculo;  ingoma; 
musical	umdlalo onomculo nomdaniso; 
musician	imvumi; 
musicians	iimvumi; 
must	 incindi yediliya eqala ukubila; kumele; 
mutandis	iinguqu ezifunakayo; 
mutatis	zenziwe; 
mutual	ngemvano; vanayo; 
mutually	ngokuvana; 
my	eyam; 
myself	mna ngokwam; 
name	 ukuthiya igama; igama; 
named	 ukuthiya igama; igama; 
namely	oko kukuthi; 
names	amagama;  ukuthiya igama; 
narrative	imbaliso; 
narrow	mxinwa; 
natal	okuzalwa; 
nation	isizwe; 
nation-building	ulwakhiwo lwesizwe; 
national	-yesizwe; 
nationality	ubuzwe; 
nationally	eyesizwe; 
nationals	zesizwe;  -zesizwe; 
nationhood	ubuzwe; 
nations	izizwe; 
native	inzaka; 
natural	 -yendalo;  isiqalelo; yendalo; 
nature	ubume;  indalo; 
near	kufuphi; 
nearest	eyona ikufuphi; 
nearly	phantse; 
necessarily	funekayo; 
necessary	-funeka; 
need	imfuneko;  isidingo;  funa; 
needed	imfuneko;  isidingo;  funa; 
needs	 iimfuneko; izidingo;  funa; 
negative	isilandulo; 
negatively	ngokulandulayo; ngokugxekayo; 
neglect	utyeshelo;  ukutyeshela; 
neglected	utyeshelo;  ukutyeshela; ngahoyi; 
negligence	ukungakhathali;  ukunganaki; 
negotiate	 ukuthethana; thetha-thethana; 
negotiated	kunqophisenwe;  thetha-thethenwe; 
negotiating	 ukuthethana; thetha-thethana; 
negotiation	uthethathethwano; 
negotiations	uthethathethwano; 
neighbouring	engummelwane; 
neither	akukho namnye kubo bobabini; 
net	uthungelwano;  umnatha; 
network	uthungelwano; 
networking	uthungelwano; 
networks	amathungelwano; 
never	soze; 
nevertheless	kodwa ke; 
new	ntsha; 
newly	entsha; 
news	iindaba; 
newsletter	incwadana yeendaba; 
newsletters	iincwadana zeendaba; 
newspaper	 iphepha-ndaba; iphephandaba; 
newspapers	amaphepha-ndaba; 
newsroom	igumbi leendaba; 
next	elandelayo; 
night	ubusuku; 
nine	ithoba; 
no	hayi; 
noble	balaseleyo;  phakamileyo;  bekekileyo; 
nominal	ekhoyo ngegama; 
nominate	 -nyula;  tyumba; ukutyumba; 
nominated	 -nyula;  tyumba; ukutyumba; 
nomination	 utyumbo; ukutyumba; 
nominations	 utyumbo; ukutyumba; 
non	akukhonto; 
non-compliance	ukungathobeli; 
non-governmental	engeyiyo karhulumente; 
non-profit	engeyiyo yenzuzo; 
non-racial	engenabo ubuhlanga; 
non-refundable	engenayo imbuyiselo; 
non-sexism	engakhethi ngokwesini; 
non-sexist	engakhethi ngokwesini; 
non-tax	engenayo irhafu; 
none	akukhonto; 
nor	okanye; 
normally	ngokuqhelekileyo; 
norms	iziqhelo; 
north	ngasentla;  emantla;  entla;  umntla; 
northern	umntla; 
not	hayi; 
notable	balulekileyo; qapheleka; 
notably	ngokubalulekileyo; 
note	 ukuphawula;  inowuthi;  imali eliphepha;  isikhumbuzisi; qaphela; 
noted	qaphele;  ukuphawula;  inowuthi;  imali eliphepha;  isikhumbuzisi; qaphela; 
notes	amanqakwana ezifundo; 
nothing	into engekhoyo; 
notice	 isaziso; ingqalelo; 
notices	 izaziso; ukunaka; ingqalelo; 
notification	 ukwazisa; isaziso; 
notified	wazisiwe; 
notify	ukwazisa;  azisa; 
noting	 ukuphawula;  inowuthi;  ukuqaphela;  isikhumbuzisi; qaphela; 
notion	ingqiqo;  ingcinga; 
notwithstanding	nangona; 
novel	inoveli; 
now	ngoku; 
null	akukho nto; phuthile; 
number	inani;  ubunani;  inombolo;  ubungaphi; 
numbers	amanani; 
numerous	 ninzi;  inyambalala; eziliqela; 
nurse	 umongi; umongikazi;  yonga; 
nurses	abongikazi;  uyonga; 
nursing	ukonga; 
nurture	ukondla; 
nurturing	ukondla;  ukukhulisa; 
nutrition	isondlo; 
oath	isifungo; 
object	 ukwala;  injongosenzi; into; 
objection	inkcaso; 
objections	iinkcaso; 
objective	 ephathekayo; injongo; 
objectives	 ephathekayo; iinjongo; 
objects	 ukwala; izinto;  injongosenzi; 
obligation	iimfanelo; 
obligations	iimfanelo; 
obliged	 nyanzelekile; bophelelekile; 
observatory	isakhiwo sokulolonga isibhakabhaka nezinye izinto; 
observe	ukuqwalasela; 
observed	ukuqwalasela; 
obsolete	elingasasetyenziswayo; 
obtain	fumana; 
obtained	fumana; 
obtaining	ukufumana; 
obvious	cacileyo; 
obviously	ngokucacileyo; 
occasion	ithuba; 
occasions	amathuba; 
occupation	umsebenzi;  ukuthimba ilizwe; 
occupational	eyomsebenzi; 
occupied	thatha; 
occupy	thatha; 
occur	ukwenzeka;  ukufunyanwa; 
occurred	kwenzekile;  kufunyenwe; 
occurrence	isiganeko; 
occurring	kuyenzeka; 
occurs	kuyenzeka; 
ocean	ulwandlekazi; 
of	 ye; ka; 
off	phetha; 
offence	ulwaphulo-mthetho; 
offences	izenzo zolwaphulo-mthetho; 
offender	umoni; 
offenders	aboni; 
offered	nikeza; 
offering	umnikelo; 
offerings	iminikelo; 
offers	nikeza; 
office	 iofisi; isikhundla; 
office-bearers	abaphathi bezikhundla; 
officer	 umphathi-mkhosi; igosa; 
officers	amagosa; abaphathi-mkhosi; 
offices	izikhundla;  iiofisi; 
official	 umphathi;  eyoburhulumente; igosa; 
officially	ngokusesikweni; 
officials	 abaphathi;  eyoburhulumente; amagosa; 
offset	linganisa; 
offshore	kude nonxweme; 
often	rhoqo; 
oil	ioyile;  ioli; 
old	dala; 
older	dadlana; 
oldest	oyena mdala; 
omission	ukungenzi; ukushiya; 
omissions	iimpazamo; 
on	kwi; 
once	kube kanye; 
once-off	kube kanye; 
one	inye;  isinye; 
ones	izinye; 
ongoing	qhubekayo; 
online	eqhagamshelekileyo; 
only	kuphela; 
onto	kwi; 
op	iop; 
open	vula; 
opened	vuliwe; 
opening	intunja; 
opens	iyavula; 
opera	 umdlalo womculo; iopera; 
operate	tyanda; 
operated	tyandiwe; 
operates	tyanda; 
operating	tyanda; 
operation	 ukubala;  ukuhlinzwa;  uqhaqho;  inkqubo yamajoni emfazweni;  utyando;  intsebenzo; umsebenzi; 
operational	esebenzayo; 
operations	 ukubala;  iintsebenzo;  ukuhlinzwa;  inkqubo yamajoni emfazweni; umsebenzi;  imisebenzi yoqhaqho; amatyando; 
operator	umbhexeshi wento ethile; 
operators	ababhexeshi; 
opinion	uluvo; 
opinions	izimvo; 
opportunities	amathuba; 
opportunity	ithuba; 
opposed	phikiswa; 
opposite	isichasi;  eliphikisayo; 
opposition	amaqela aphikisayo;  abachasi; 
oppressed	cinezelwe; 
oppression	 imbandezelo;  ucinezelo; ingcinezelo; 
optimal	eyona ithandwayo; 
optimism	ukulindela okuhle; 
option	ukhetho; 
options	izinto zokhetho; 
or	okanye; 
oral	oluthethwayo; 
orange	i-orenji;  iorenji; 
order	 iodolo;  ulungelelwano;  ukuodola; ucwangciso;  ukulandelelana;  umyalelo;  ulungelelwaniso; 
ordered	 iodolo;  ulungelelwano;  ukuodola; ucwangciso;  ukulandelelana;  umyalelo;  ulungelelwaniso; 
orders	 imimiselo yemihlangano yenkolo; iiodolo; imiyalelo; 
ordinance	ummiselo;  umthetho wephondo; 
ordinarily	ngokuqhelekileyo; 
ordinary	qhelekile; 
organ	 uhadi; ilungu;  ilungu lomzimba;  amalungu omzimba; 
organisation	 ulungiselelo; iqumrhu; 
organisational	 eyombutho; eyolungiselelo; 
organisations	amalungiselelo;  imibutho; 
organised	lungiselelwe; 
organisers	abaququzeleli;  abalungiseleli; 
organising	 ukuququzelela; ukulungiselela; 
organization	umbutho;  ulungiselelo; 
organizations	amalungiselelo;  imibutho; 
organized	lungiselelwe; ququzelelwe; 
organizers	abaququzeleli;  abalungiseleli; 
organs	amalungu okuthetha; 
orientation	uqhelaniso; 
origin	 isiqalo;  intsusa; imvelaphi; 
original	imo yemvelo;  eyeyakhe; 
originally	entlandlolo; 
origins	 iintsusa; iimvelaphi;  iziqalo; 
other	omnye;  enye; 
others	ezinye;  abanye; 
otherwise	okanye kungenjalo; 
ought	kufuneka;  melwe; 
our	eyethu; 
ours	ezethu; 
ourselves	thina ngokwethu; 
out	phandle; 
outcome	isiphumo; 
outcomes	iziphumo; 
outdoor	-phandle; 
outgoing	 ophumayo; ohambayo; 
outline	 uphahla lwemaphu; isicwangciso;  ukugqabaza; 
outlined	 uphahla lwemaphu; isicwangciso;  ukugqabaza; 
outlines	izicwangciso;  amagqabantshintshi;  ukugqabaza; 
outlook	umbono; 
output	iziphumo; 
outputs	iziphumo; 
outreach	ufikelelo; 
outside	umphandle;  kumphandle;  phandle; 
outsourced	thunyelwe phandle; 
outstanding	balulekileyo; qapheleka; 
outward	ngokuphandle; 
oval	 bumbhoxo; embhoxo; 
over	 ngaphaya; ngaphezulu; 
overall	iovaroli; 
overarching	ukwenza intlondi ngokugqithisileyo; 
overcome	ukoyisa; 
overseas	 phesheya kolwandle; phesheya; 
oversee	ukongamela; ukubeka iso; 
overseeing	ukongamela; 
oversight	ubongameli;  isiphosiso; 
overview	ukujonga ngokubanzi; 
overwhelming	oyisa; 
owed	ukukwelitwa; 
owing	ukukwelita; 
own	ukuba ngumnini;  ukuba nento;  fuya; 
owned	fuyile; 
owner	 umfuyi; umnini; 
owners	abanini;  abafuyi; 
ownership	ubunikazi; 
p	p+B1561; 
pace	isantya somdlalo; 
package	impahla; 
packages	iimpahla; 
page	iphepha; 
pages	amaphepha; 
paid	 hlawula; intlawulo;  ukuhlawula; 
pain	 ubuhlungu; intlungu; 
painful	buhlungu; 
painting	umzobo;  umzobo owenziwe ngepeyinti;  ukuzoba ngepeyinti; 
paintings	ukuzoba ngepeyinti; imizobo;  imizobo eyenziwe ngepeyinti; 
palace	ibhotwe; 
panel	 igqiza labagwebi; igqiza; 
paper	iphepha;  iphepha-ndaba; 
papers	 iphepha loviwo;  iphepha-ndaba; amaphepha; 
paragraph	umhlathi; 
paragraphs	imihlathi; 
parameters	 ubunjani obunokubalwa; iimpawu ezinokulinganiswa; 
parent	umzali; 
parental	enobuzali; 
parenting	umzali; 
parents	abazali; 
park	ukumisa;  ipaki;  ipaka; 
parking	ukumisa;  ipaka; 
parks	 iipaka; ukumisa; 
parliament	ipalamente; 
parliament's	eyepalamente; 
parliamentarians	amalungu epalamente; 
parliamentary	eyepalamente; 
parliaments	iipalamente; 
parole	ingqawule; isithembiso sokungabaleki kwebanjwa; 
part	 isigaba sentetho; indawo; 
part-time	 hayi imini yonke; inxenye yemini;  ngamaxesha athile; 
partial	enxalenye; 
partially	ngenxalenye; 
participant	umthathi nxaxheba; 
participants	abadlali; 
participate	ukuthatha inxaxheba; 
participated	uthathe inxaxheba; 
participates	uthatha inxaxheba; 
participating	ukuthatha inxaxheba; 
participation	ukuthatha inxaxheba; 
participatory	ngokuthatha inxaxheba; 
particular	ethile; 
particularly	ngokukodwa;  ngokukhethekileyo; 
particulars	iimpawu; 
parties	amaqela;  amaqela ezopolitiko; 
partly	ngokwenxalenye; 
partner	umlingane;  umahlulelane; 
partnered	umlingane;  umahlulelane; 
partners	abalingane;  abahlulelane; 
partnerships	amahlulelwano; 
parts	amalungu; 
party	iqela;  iqela lezopolitiko; 
pass	ukunikezela;  ukuphumelela;  ipasi;  ukupasa ibhola; 
passed	ukunikezela;  ukuphumelela;  ipasi;  ukupasa ibhola; 
passenger	umkhweli;  ipasenjari; 
passengers	abakhweli; 
passes	ukunikezela;  ukuphumelela;  ipasi;  ukupasa ibhola; 
passing	ukugqitha; 
passport	incwadana yokundwendwela; 
path	indlela; 
patient	 umguli; isigulane; 
patients	 abaguli; izigulane; 
patriotism	ukuthand'izwe; 
pattern	 ipatroni; umfuziselo; 
patterns	imifuziselo; 
paved	kwenziwe umgangatho;  indlela igangathiwe; 
pavilion	isakhiwo kwibala lemidlalo; 
pay	 hlawula; intlawulo;  ukuhlawula; 
payable	iyahlawuleka; 
paying	 hlawula; intlawulo;  ukuhlawula; 
payment	intlawulo;  uhlawulo; 
payments	iintlawulo; 
pays	 hlawula;  ukuhlawula; iintlawulo; 
pdf	ipdf; 
peace	uxolo; 
peaceful	ngoxolo; 
peak	incopho; 
penalties	izohlwayo; 
penalty	isohlwayo; 
pending	misiwe;  xhonyiwe; 
pension	umhlalaphantsi; 
pensions	iipenshini;  imihlalaphantsi; 
people	abantu; 
people's	eyabantu; 
peoples	abantu; 
per	ngokwe; 
perceived	boniwe;  qwalaselwa; 
percent	ekhulwini;  ipesenti; 
percentage	ekhulwini;  ipesenti; 
percentages	ekhulwini;  iipesenti; 
perception	imbonakalo;  imbono; 
perceptions	 iimbonakalo; iimbono; 
perform	ukwenza; 
performance	 ukonwabisa ababukeli nabaphulaphuli;  ukwenza umculo; ukwenza; 
performances	 ukonwabisa ababukeli nabaphulaphuli;  ukwenza umculo; ukwenza; 
performed	onwabisile; ukwenza; 
performer	umonwabisi; 
performers	abonwabisi; 
performing	onwabisa; ukwenza; 
performs	onwabisa; ukwenza; 
perhaps	mhlawumbi; 
period	 isigaba sexesha;  ixesha elithile; ixesha;  isithuba;  ithuba lezifundo; 
periodical	 ulindixesha;  -hlal' ivele; iphepha-ncwadi; 
periods	amaxesha; 
perjury	ityala lokuxoka ufungile; 
permanent	isigxina;  -sigxina; 
permanently	ngokungenasiphelo ngonaphakade; 
permission	imvume; 
permit	 ukuvumela; imvume; 
permits	iimvume; 
permitted	uvunyelwe; 
perpetuate	ukuqhubeka ukugcina; 
person	 umntu ekuthethwa naye;  umntu othethayo; umntu;  umntu ekuthethwa ngaye; 
person's	eyomntu; 
personal	yomntu; 
personally	ngokobuqu; 
personnel	 abaqeshwa;  isitafu; abasebenzi; 
persons	abantu; 
perspective	ingqikelelo-mgama; 
perspectives	iingqikelelo-mgama; 
pertaining	 ngokuphathelele; malunga; 
petition	isibongozo;  uxwebhu lwezikhalazo; 
petitions	uxwebhu lwezibongozo;  izibongozo; 
petrol	 amafutha enqwelo; ipetroli; 
petroleum	ipetroleum; 
pharmaceutical	ezokuphithikeza amayeza; 
pharmacist	umphithikezi-mayeza; 
pharmacy	 indlu ethengisa amayeza; umzi wamachiza; 
phase	isigaba; 
phased	ngezigaba; 
phases	izigaba; 
phenomenon	 isimanga; isenzeko; 
philosophy	ifilosofi; 
phone	 ifowuni; umnxeba; ifoni; 
photo	ifoto; 
photograph	ifoto; 
photographers	abafoti; 
photographic	eyokufota; 
photographs	iifoto; imifanekiso; 
photography	ubuchule bokufota; 
photos	iifoto; 
physical	 ezemvelo;  ngokomzimba; yomzimba;  ngomzimba;  inzululwazi ngemvelo; 
physically	 ngokuphathekayo; ngomzimba; 
piano	 ipiyano; ngokuzolileyo; 
picture	umfanekiso; 
pictures	imifanekiso; 
piece	intwana; 
pieces	iingceba; 
pillar	intsika; 
pillars	iintsika; 
pilot	 umalathi-ndlela; umqhubi; 
pioneer	umanduleli; 
pioneers	abanduleli; 
piracy	ukuba; 
pivotal	enesikhonkwane esijikelezayo; 
place	indawo; 
placed	imiselwe;  ibekiwe; 
placement	ingqesho;  ukwalathelwa; 
places	iindawo; 
placing	ukwalathelwa; 
plain	ithafa; 
plains	amathafa; 
plaintiff	ummangali; 
plaintiff's	ekandimangele;  eyommangali; 
plan	 -ceba;  uyilo;  ukuyila; isicwangciso;  iplani;  ukuceba; 
planet	iplanethi; 
planned	 -ceba; izicwangciso;  uyilo;  ukuyila;  iplani;  ukuceba; 
planning	ukuyila;  ukucwangcisa; 
plans	 -ceba; izicwangciso;  uyilo;  ukuyila;  ukuceba; 
plant	 ukutyala; isityalo;  iplanti;  usinga lwesityalo; 
plants	 ukutyala;  usinga lwesityalo; izityalo; 
plastic	 yeplastiki; iplastiki; 
plate	ipleyiti; 
platforms	iiplatfomu; 
play	umdlalo; 
played	umdlalo; 
player	umdlali; 
players	abadlali; 
playhouse	igumbi lemidlalo yeqonga; 
playhouses	amagumbi emidlalo yeqonga; 
playing	umdlalo; 
plays	imidlalo; 
plea	 ingxelo yommangalelwa; isicelo; 
pleading	ukubongoza;  ukungxengxeza; 
pleadings	 izibongozo; izingxengxezo; 
please	nceda;  ngesicelo; 
pleased	 yolileyo; vuyile; 
pleasure	ukonwaba; 
pledge	bambisa; nyanisekisa; 
pledged	bambisile; nyanisekisile; 
plenary	amagunya ngokupheleleyo; 
plight	ingxaki; 
plus	 udibanisa; dibanisa; 
pm	emalanga; 
poaching	ukuzingela; 
poem	 umhobe; umbongo; 
poet	imbongi; 
poetry	isihobe; 
poets	iimbongi; 
point	inqaku;  ingongoma;  ikona; 
pointed	 ibeke iingongoma;  ibekwe amanqaku; ikona; -khombisile; 
points	 iingongoma; amanqaku;  iikona; -khombisa; 
police	amapolisa;  ipolisa; 
policies	iipolisi; inkqubo;  imigaqo-nkqubo;  iipolisi; 
policing	amapolisa; 
policy	 umgaqo-nkqubo; inkqubo;  ipolisi yeinshorensi;  ipolisi; 
political	ezombuso; 
politics	 iipolitiki; ezopolitiko;  ipolitiki; 
pollution	 ukungcolisa; ungcoliseko; 
pool	ichibi; 
poor	 -hlwempu; ubuhlwempu; 
poorer	 -hlwempu; ubuhlwempu; 
poorest	 -hlwempu; ubuhlwempu; 
poorly	 ngokuthobekileyo; ngobuhlwempu; 
population	 abemi;  iqela lilonke ekuthathwe kulo isampuli; abantu; 
pornography	izinto zoburheletya; 
port	izibuko; 
portfolio	 inkcazelo edandalazisa isakhono somntu; isikhundla; 
portion	inxalenye;  isahlulo; 
portray	ukuzoba; 
portrayed	ukuzoba; 
ports	amazibuko; 
pose	misela ukuthatha umfanekiso; 
posed	misele ukuthatha umfanekiso; 
position	indawo; 
positions	iindawo; 
positive	exabiso ngaphezu kwento engekhoyo; 
positively	ngokunethemba; 
possess	yiba ngumnini; 
possession	ubunini;  ukufumana ibhola; 
possibilities	okunokwenzeka; 
possibility	okunokwenzeka; 
possible	kunokwenzeka; 
possibly	mhlawumbi; 
post	 iposi;  ukuthumela; isikhundla; 
post-apartheid	emva kwenkqubo yocalu-calulo; 
postal	eyeposi; 
postgraduate	izifundo emva kwesidanga sokuqala; 
postponed	rhoxisa; 
postponement	urhoxiso; 
posts	izikhundla;  iiposi;  ukuthumela; 
pot	 ingqayi; imbiza; 
potential	enokwenzeka; 
potentially	ngokunokwenzeka; 
poverty	ubuhlwempu; 
power	amandla;  igunya;  amandla okulawula; 
powerful	-namandla; 
powers	 amagunya; amandla; amandla okuziphindaphinda;  amandla okulawula;  ukuziphindaphinda kwenani; 
practicable	enokwenzeka; 
practical	owenziwayo; 
practice	 isiqhelo;  ukuqhelisa;  uqheliso; isikhundla; 
practices	 ukuqhelisa;  iziqhelo;  uqheliso; izikhundla; 
practise	ukuziqhelisa;  phindaphinda;  qhelisa; 
practitioner	ingcali; 
practitioners	iingcali; 
praise	ukuncoma; 
prayer	umthandazo;  Umthandazo; 
pre-colonial	 phambi kwezithanga; phambi kobukoloniyali; 
pre-trial	phambi kolingo; 
preamble	 imbulambethe; intshayelelo; 
precede	ukwandulela; 
preceded	ukwandulela; 
preceding	ukwandulela; 
precinct	indawo ebiyelweyo; 
precincts	iindawo ezibiyelweyo; 
precious	xabisekileyo; nqabileyo; 
precisely	ngokuthe ngqo; 
preference	ukhetho; 
preferential	ekhethwayo; 
preferred	ekhethwayo; 
pregnancy	ukukhulelwa; 
pregnant	ukukhulelwa; 
prejudice	ukuqal' ugwebe;  udlelondlala; 
preliminary	eyokuqala; 
premier	inkulumbuso; 
premised	isindululo sesiseko sengxoxo; 
premises	imizi; 
preparation	amalungiselelo;  uzifozonke; 
preparations	amalungiselelo;  uzifozonke; 
preparatory	wokulungiselela; 
prepare	 -lungisa; ukulungiselela; 
prepared	lungisiwe; 
preparing	 -lungisa; ukulungiselela; 
prescribe	ukumisela; 
prescribing	ukumisela; 
prescription	ummiselo;  umyalelo; 
prescripts	imimiselo;  imiyalelo; 
presence	ubukho; 
present	ubukho;  unikelo; 
presentation	 intetho ecwangcisiweyo; ukwaziswa; 
presentations	 iintetho ezicwangcisiweyo; ukwaziswa; 
presented	nikele; 
presenting	ukunikela; 
presently	njengangoku; 
presents	nikela; 
preservation	ukugcina;  ulondolozo; 
preserve	londoloza; 
preserved	londoloza; 
preserving	londoloza; 
preside	ukuchophela; 
presidency	ubongameli; 
president	umongameli;  iprezidanti; 
president's	eyomongameli; 
presidential	eyomongameli; 
presidents	abongameli; 
presiding	ukuchophela; 
press	cofa;  abashicileli;  cudisa;  ukuayina; 
pressing	cinezelayo; 
pressure	uxinzelelo; 
pressures	amaxinzelelo; 
prestigious	nesidima;  nodumo; 
presumed	cingelwe; 
pretty	ntle; hle; 
prevail	ukubakho jikelele;  ukubakho kakhulu; 
prevailing	qhelekileyo; khoyo; 
prevalence	ukuxhaphaka jikelele; 
prevent	 thintela; ukukhusela;  khusela; 
prevented	 thintele; khusele; 
preventing	 ukukhusela; ukuthintela; 
prevention	ukhuselo;  uthintelo; 
previous	ngaphambili; 
previously	ngaphambili; 
price	ixabiso; 
prices	amaxabiso; 
pricing	ukuxabisa; 
pride	iqhayiya;  ikratshi; 
priest	umbingeleli; 
prima	okuqala; 
primarily	okokuqala; 
primary	okuqala; 
prime	odidi lokuqala; 
principal	 unozala;  ingqonyela; inqununu; 
principals	iinqununu; 
principle	 umongo; isikhokelo; 
principles	 iinqobo; izikhokelo; 
print	 okushicilelweyo; ukushicilela;  ukuprinta;  iprinti; 
printed	 okushicilelweyo; ukushicilela;  ukuprinta;  iprinti; 
printing	 okushicilelweyo; ukushicilela;  ukuprinta;  iprinti; 
prior	intloko yomzi woonongendi;  okuqala; ngaphambili; 
priorities	eziphambili; 
prioritise	ukuhlela ngolandelelwano lokubaluleka; 
prioritised	kuhlelwe ngolandelelwano lokubaluleka; 
priority	okuphambili; 
prison	intolongo; 
prisoner	 umbanjwa; ibanjwa; 
prisoners	amabanjwa; 
prisons	iintolongo; 
privacy	 ingasese; imfihlo; 
private	bucala; 
privilege	ilungelo elilodwa; 
privileged	unelungelo elithile; 
privileges	amalungelo; 
prize	ibhaso; 
prizes	amabhaso; 
pro	ukuxhasa; 
proactive	ukuphepha kwangaphambili;  ukuthintela kwangaphambili; 
probably	mhlawumbi; 
probation	ukulingwa phambi kokuqeshwa; 
probe	ukuphanda; 
problem	ingxaki;  iqhina;  ingxaki efuna ingqondo; 
problems	 amaqhina;  iingxaki ezifuna ingqondo; iingxaki; 
procedural	ngokwenkqubo; 
procedure	inkqubo; 
procedures	iinkqubo; 
proceed	qhuba; 
proceeding	inkqubo; 
proceedings	iingxoxo; 
proceeds	iziphumo;  iinzuzo; iingeniso; 
process	 ukwenzeka; inkqubo;  ulandelelwano lwezenzeko;  ukutshintsha imo; 
processed	sompa;  ukwenzeka; inkqubo;  ulandelelwano lwezenzeko;  ukutshintsha imo; 
processes	 ukwenzeka;  ulandelelwano lwezenzeko; iinkqubo;  ukutshintsha imo; 
processing	sompa;  ukwenzeka; inkqubo;  ulandelelwano lwezenzeko;  ukutshintsha imo; 
procession	umngcelele;  ukrozo; 
proclamation	 isimemezo; isibhengezo; 
procurement	 ukuthenga; ukufumana;  ukuxhobisa; 
produce	imveliso;  ukuvelisa; 
produced	imveliso;  ukuvelisa; 
producer	 umlawuli-mdlalo; umvelisi; 
producers	abalawuli-mdlalo; abavelisi;  abavelisi-midlalo; 
produces	imveliso;  ukuvelisa; 
producing	imveliso;  ukuvelisa; 
product	imveliso; 
production	ukuvelisa;  isivuno; 
productions	iziveliso; ukuvelisa;  izivuno; 
productive	nemveliso; 
productivity	imveliso; 
products	 iziphumo zophindaphindo; iziphinda-phindo; iimveliso; 
profession	ikhondo; 
professional	oqeqeshelwe umsebenzi; 
professionals	amachule omsebenzi; 
professions	iingcali; 
professor	njingalwazi; 
profit	inzuzo; 
profits	iinzuzo; 
profound	nzulu; 
program	 inkqubo sikhokelo; inkqubo;  isikhokelo; 
programme	 inkqubo sikhokelo; inkqubo;  isikhokelo; 
programmed	 inkqubo sikhokelo; inkqubo;  ehleliweyo; 
programmes	 iinkqubo sikhokelo; iinkqubo; 
programming	ulungelelwaniso lweenkqubo zosasazo; 
programs	 iinkqubo sikhokelo; iinkqubo; 
progress	 inkqubela; ukuqhuba;  inqubela; 
progression	ukuqhubela phambili; 
progressive	-nenkqubela;  enenkqubela; 
prohibit	thintela; 
prohibited	thintelwe; 
prohibition	isithinteli; 
project	 ukuhlomela; iprojekthi; 
projected	 ukuhlomela; iprojekthi; umsebenzi omsiselweyo; 
projection	ukubonisa;  ihlomelo; 
projections	izihlomelo;  ukubonisa okuzayo; 
projects	iiprojekthi; 
prominent	balulekileyo; qapheleka; 
promise	thembisa; 
promised	thembisile; 
promises	izithembiso; 
promote	 khuthaza; ukukhuthaza; 
promoted	 khuthaza; ukukhuthaza; 
promotes	 khuthaza; ukukhuthaza; 
promoting	 khuthaza; ukukhuthaza; 
promotion	ukunyuselwa;  unyuselo; 
promptly	ngokukhawuleza; 
promulgated	bhengezile; 
promulgation	ubhengezo; 
proof	ubungqina; 
proper	lungeleyo; fanelekileyo; 
properly	ngokufanelekileyo; ngokulungeleyo; 
properties	 ipropati;  iimo; iimpahla; 
property	 imo; impahla;  ipropati; 
proportion	 umlinganiselo wamagunya;  ulinganiselo; umlinganiselo; 
proposal	isindululo;  isiphakamiso; 
proposals	isindululo;  isiphakamiso; 
propose	ukuphakamisa; 
proposed	ukuphakamisa; 
proposes	ukuphakamisa; 
prosecute	tshutshisa; 
prosecuted	tshutshisile; 
prosecuting	ukutshutshisa; 
prosecution	ukumangalela; 
prosecutions	ukumangalela; 
prosecutor	umtshutshisi; 
prosecutors	abatshutshisi; 
prospect	ukufunisela izimbiwa; 
prospecting	ukufunisela izimbiwa; 
prospective	okulindelweyo; 
prospects	ukufunisela izimbiwa; 
prospectus	isaziso esibhaliweyo; 
prosperity	ulonwabo nempumelelo; 
prosperous	ukuphumelela; 
prostitution	ukuhenyuza; 
protect	ukukhusela;  khusela; 
protected	ukukhusela;  khusela; 
protecting	ukukhusela;  khusela; 
protection	ukhuselo; 
protective	ekhuselayo; 
protector	umkhuseli; 
protest	inkcaso;  uqhankqalazo;  ukuchasa; 
protests	izikhalazo;  uqhankqalazo;  iinkcaso;  ukuchasa; ugwayimbo; 
protocols	iinkqubo-sivumelwano;  izicwangciso-nkqubo zonyango; 
proud	neqhayiya; 
proudly	ngokuzidla; 
prove	ngqina; 
proved	ngqinile; 
proven	kungqiniwe; 
provide	nika; 
provided	 kuxhomekekile; kubonelelwe; 
provident	ubonelelo; 
provider	umboneleli; 
providers	ababoneleli; 
provides	nika; 
providing	nika; 
province	iphondo; 
province's	eyephondo; 
provinces	amaphondo; 
provincial	ngokwephondo; 
provisional	yokuvavanya-nje; 
provisions	amalungiselelo; 
proviso	ngonobambiso; 
proxy	ilungelo lokumela; 
prudent	lumkileyo; nobulumko; 
prudential	yobulumko; 
psychological	yenzululwazi ngengqondo; 
public	uwonke-wonke;  -kawonke-wonke; 
publications	izipapasho; 
publicly	ngokuphandle;  esidlangalaleni; 
publish	papasha; 
published	papasha; 
publisher	umpapashi; 
publishers	abapapashi; 
publishes	ipapasha; 
publishing	papasha; 
punishment	isohlwayo; 
purchase	thenga; 
purchased	thenga; 
purchases	thenga; 
purporting	ukwenza ngokungathi;  ukuthetha ngokungathi; 
purpose	injongo; 
purposes	iinjongo; 
pursuant	 ukulandela; ukusukela; 
pursue	 sukela; landela; 
pursued	sukele; landele; 
pursuing	 sukela; landela; 
pursuit	 landela; ukusukela; 
push	ukutyhala; 
put	beka; 
puts	ubeka; 
putting	ukubeka; 
qualification	 uchazo; isiqinisekiso soqeqesho; 
qualifications	iziqiniselo; 
qualify	 ukuvumeleka kumangenelo;  ubunjani; ukuchaza; 
qualifying	 ukuphumelela;  ukuvumeleka kumangenelo;  ubunjani; ukuchaza; 
qualitative	 ubulunga bohlobo; udidi lohlobo; 
qualities	imigangatho; 
quality	umgangatho; 
quantitative	ubuninzi; 
quantity	 ubungakanani; isixa; 
quarter	ikota; 
quarterly	ngekota; ngonyanga-ntathu; 
quarters	iikota; 
queen	ukumkanikazi; 
queries	imibuzo; 
quest	ukukhangela; 
question	umbuzo; 
questioned	buziwe; 
questionnaire	uluhlu lwemibuzo; 
questionnaires	uluhlu lwemibuzo; 
questions	imibuzo; 
quickly	ngokukhawuleza; 
quinine	ikhwinini; 
quite	 eneneni; noko;  ngokwenene; 
quorum	ikoram; 
quotation	isicatshulwa; 
quotations	izicatshulwa; 
quote	ukucaphula; 
race	uhlanga;  umdyarho; 
races	 imidyarho; iintlanga; 
racial	-hlanga; 
radical	ukuxhasa iinguquko ezigqibeleleyo; 
radio	 unxibelelwano ngomoya;  iwayalesi; unomathotholo; 
raid	uhlaselo;  ukuhlasela; 
rail	umnqiwu; 
railway	 isiporo sikaloliwe; umzila kaloliwe; 
rain	 netha; imvula;  iyana; 
rainbow	umnyama; 
rainfall	ukuna kwemvula; 
raise	ukuphakamisa; 
raised	ukuphakamisa; 
raises	ukuphakamisa; 
raising	ukuphakamisa; 
rally	ingxikela yendibano; 
rand	irandi; 
range	 umnabo welizwi;  uludwe; ubungakanani; 
ranges	 umnabo welizwi;  uludwe; ubungakanani; ulandelelwano lweenowuthi; 
ranging	 umnabo welizwi;  uludwe; ubungakanani; ulandelelwano lweenowuthi; 
rank	 amanqanaba; indawo;  ukubeka; 
ranks	 izintlu; iindidi; 
rape	ukudlwengula;  ubudlwengu;  dlwengula;  udlwengulo; 
rapid	ingqokozo;  ingxangxasana; 
rapidly	ngokukhawuleza; 
rare	nqabileyo; 
rate	 irhafu yedolophu;  ukukhawuleza; ukuxabisa; 
rates	irhafu; 
rather	ndaweni yoko; 
ratification	ukuqinisekisa; 
ratified	qinisekisiwe; 
rating	ukuhlela; 
ratings	ukuhlela; 
ratio	ukwalamana;  umlimganiselo; 
rationalisation	ulungelelaniso; 
raw	luhlaza;  krwada; 
re	 ngokuphathelele; malunga; 
reach	fikelela; 
reached	fikelele; 
reaching	ukufikelela; 
read	ukufunda; 
reader	umlesi; 
readers	 iincwadi zokuqala zokufuna; abafundi; 
readily	ngokulungileyo; 
readiness	ukulungela; 
reading	 ufundo; ukufunda; 
ready	ukulunga; 
reaffirm	ukuqinisekisa kwakhona; 
real	ngokwenene; 
realisation	ukuqonda; 
realise	ukuqonda; 
realised	qaphele; 
realising	ukuqaphela; 
realities	iinyaniso; 
reality	inyaniso; 
realization	uqaphelo; 
realize	ukuqaphela; 
really	ngokwenene; 
reason	isizathu;  ukucabanga; 
reasonably	ngokwamkelekileyo; 
reasons	izizathu; 
reburial	ukungcwaba kwakhona; 
recall	ukususwa esikhundleni; 
recapitalisation	ukuxhobisa kwakhona; 
receipt	irisithi; 
receipts	iirisithi; 
receive	fumana;  ukwamkela; 
received	fumana;  ukwamkela; 
receives	fumana;  ukwamkela; 
receiving	fumana;  ukwamkela; 
recent	kutshanje; 
recently	kutshanje; 
reception	ulwamkelo; 
recession	 ukuphela kwemisebenzi; ukurhoxa; 
recipient	umamkeli; 
recipients	umamkeli; 
reclaim	ukubanga ukubuyiselwa; 
recognise	 ukuvuma;  ukunakana; qaphela; 
recognised	ukuqondwa;  ukunakanwa; 
recognises	ukuqonda;  ukunakana; 
recognising	ukuqonda;  ukunakana; 
recognition	ulwazi;  ukuqonda; 
recognize	ukuqonda;  ukunakana; 
recognized	ukuqondwa;  ukunakanwa; 
recommendation	ingcebiso; 
recommendations	imiyalezo; 
recommended	ukuyaleza; 
recommends	ukuyaleza; 
reconciliation	uxolelwano;  uxolelaniso; 
reconstruction	ukwakha ngokutsha; 
record	 irejista yempahla;  ulwazi olubhaliweyo; irekhodi;  ukubhala; 
recorded	 irejista yempahla;  ulwazi olubhaliweyo; irekhodi;  ukubhala; rekhodile; 
recording	ukunqakula; 
records	 irejista yempahla;  ulwazi olubhaliweyo; rekhoda; irekhodi;  ukubhala; 
recover	ukufumana kwakhona;  phila; 
recovered	ukufumana kwakhona;  phila; 
recovery	ukuchacha;  ibuyambo; 
recreation	ukuzonwabisa;  ulwakhiwo ngokutsha; 
recreational	ezolonwabo; 
recruitment	ugayo lwabasebenzi; 
rectify	ukulungisa; 
red	bomvu; 
redistribution	ulwabiwo kwakhona; 
redress	ulungiso; 
reduce	 ukusa;  thoba; ukunciphisa; 
reduced	 ukusa;  thoba; ukunciphisa; 
reducing	 ukusa;  thoba; ukunciphisa; 
reduction	unciphiso; 
reductions	unciphiso; 
refer	ukubhekisa; 
reference	isalathiso; ireferensi; 
references	izalathiso; iireferensi; 
referral	incwadi yesalathiso; 
referred	ukwalathiswa; 
referring	ukwalathisa; 
refers	izibhekiso; 
reflect	ukubonakalisa; 
reflected	ukubonakalisa; phindisile; 
reflecting	ukubonakalisa; phindisa; 
reflection	 ukucamngca; ubuyiso-kukhanya; 
reflective	ukuhlaziya; 
reflects	ukubonakalisa; phindisa; 
reform	 uguquko; inguqu;  ukuguquka; 
reforms	 uguquko; inguqu;  ukuguquka; 
refund	 imbuyiselo; buyisela; 
refurbishment	ukuxhobisa kwakhona; 
refusal	ukulandula; 
refuse	 ukwala; inkunkuma; 
refused	 ukwala; inkunkuma; 
refuses	 ukwala; inkunkuma; 
regard	ukukhathalela;  ukuthathela ingqalelo; 
regarded	khathalelwe;  thathelwe ingqalelo; 
regarding	malunga; 
regardless	ngokungakhathaliyo; 
regards	iinkathalelo; 
regeneration	uhlaziyo ngokutsha; 
regime	umbuso; 
region	ummandla; 
regional	yommandla; 
regions	ummandla; 
register	ukubhala;  irejista yoluhlu lwamagama;  irejista; 
registered	ukubhala;  irejista yoluhlu lwamagama;  irejista; 
registering	ukubhala;  irejista yoluhlu lwamagama;  irejista; 
registers	ukubhala;  irejista yoluhlu lwamagama;  irejista; 
registrar	uMbhalisi; 
registration	ubhaliso; 
registries	iiofisi zobhaliso; 
registry	ubhaliso; 
regular	ngokomgaqo; 
regularly	rhoqo; 
regulate	ukulawula;  lawula; 
regulated	ukulawula;  lawula; 
regulates	ukulawula;  lawula; 
regulating	ukulawula;  lawula; 
regulation	 ummiselo; umgaqo; 
regulations	imimiselo;  imigaqo; 
regulator	umlawuli; 
regulators	abalawuli; 
regulatory	elawulayo; 
rehabilitation	uhlaziyo;  ukubuyisela kwimeko yesiqhelo; 
rehearsal	ukuziqhelisa; 
rehearsals	ukuziqhelisa; 
reinforce	isomelezo; 
reintegration	ukumanya kwakhona; 
reiterate	ukucacisa kwakhona; 
reiterated	ucacisile kwakhona; 
reject	ukwala;  imveliso enesiphene; 
rejected	ukwala;  imveliso enesiphene; 
relate	balisa; 
related	ukuzalana; 
relates	ukubalisa; 
relating	ngokunxulumana; 
relation	ukunxulumana; 
relations	ukunxulumana; 
relationship	ubudlelwane;  ubudlelane;  unxulumano; 
relationships	ubudlelwane;  ubudlelane;  unxulumano; 
relative	 isibaluli; isihlobo;  umzalwana; 
relatively	ngokuthelekisiweyo; 
relatives	yokuxhomekeke;  abazalwana; izihlobo;  izibaluli; 
release	khupha;  khulula; 
released	khupha;  khulula; 
releases	khupha;  khulula; 
relevance	 ngokuphathelele; malunga; 
relevant	esemxholweni; 
reliable	uthembekile; 
relief	 ukwakheka kwelizwe; isiqabu; 
religion	inkolo;  ingqobhoko; 
religions	iinkolo;  ingqobhoko; 
religious	 -zokholo; kwenkolo;  -enkolo; 
rely	thembela; 
remain	sala; 
remainder	intsalela; 
remained	sala; 
remaining	sala; 
remains	intsalela; 
remand	buyisela entolongweni; 
remarkable	balulekileyo; qapheleka; 
remarks	amanqakwana; 
remedies	amancedo; 
remedy	uncedo; 
remember	khumbula; 
remembered	khumbula; 
remembrance	inkumbulo; 
remind	khumbuza; 
reminded	khumbuzile; 
reminder	isikhumbuzo; 
reminders	izikhumbuzo; 
remote	kude; 
removal	ukufudusa; 
remove	 khupha; susa;  khulula; 
removed	 khutshiwe;  susiwe; khululwe; 
removing	 ukususa;  ukukhulula; ukukhupha; 
remuneration	intlawulo; 
renaissance	ibuyambo; 
rename	thiya ngokutsha; 
renamed	thiya ngokutsha; 
renaming	thiya ngokutsha; 
render	 guqulela;  nika; yenza; 
rendered	yenzile;  nikile; guqulele; 
rendering	 ukuguqulela;  ukunika; ukwenza; 
renew	yenza ntsha;  hlaziya; 
renewable	ehlaziyekayo; 
renewal	uhlaziyo; 
renewed	hlaziya;  yenza ntsha; 
renovations	izihlaziyo; 
renowned	dumileyo;  zukileyo; 
rent	 -ukurhafa; irhafu;  irenti; 
rental	imali yengqesho; 
repair	ukukhanda; 
repairs	ukukhanda; 
repatriation	ukugodusa umfi; 
repeal	bhangisa; 
repealed	bhangisiwe; 
repeals	bhangisa; 
repeat	ukuphinda;  phinda; 
replace	 fakela endaweni yenye into;  buyisela; ukubuyisela; 
replaced	 fakela endaweni yenye into;  buyisela; ukubuyisela; 
replies	iimpendulo; 
reply	impendulo; 
report	ingxelo;  umbiko; 
report-back	ukwenza ingxelo; 
reported	ingxelo;  umbiko; 
reporting	ingxelo;  umbiko; 
reports	iingxelo;  umbiko; 
reposition	ukuzolisa;  ukuphumza;  ukulalisa; 
repositioning	ukuzolisa;  ukuphumza;  ukulalisa; 
repository	indawo ekugcinwa kuyo izinto; 
represent	mela; 
representation	umelo; 
representations	umelo; 
representative	ummeli; 
representatives	abameli; 
represented	mela; 
representing	mela; 
represents	mela; 
repressive	 thibazayo; cinezelayo; 
republic	iriphablikhi; 
republics	iiriphablikhi; 
request	ukucela; 
requested	ukucela; 
requester	umceli;  umenzi wesicelo; 
requesting	ukucela; 
requests	izicelo; 
require	ukufuneka; 
required	ukufuneka; 
requirement	imfuneko; 
requirements	imfuneko; 
requires	ukufuneka; 
requiring	ukufuneka; 
requisite	imfuneko;  into efunakayo; 
rescue	ukuhlangula;  hlangula; 
research	uphando;  -phanda; 
researcher	umphandi; 
researchers	abaphandi; 
reservation	ukugcina; 
reserve	ukugcina;  ilalela; 
reserved	gciniwe; 
reserves	amalalela; 
residence	 umzi;  ikhaya; indlu; 
resident	umhlali; 
residential	indawo yokuhlala; 
residents	abahlali; 
resides	uhlala; 
residing	ohlalayo; 
resilience	ukomelela;  ukuxhathisa; 
resistance	 ukumelana nesifo; inkcaso;  ukuxhathisa; 
resolution	 Isigqibo; isigqibo; 
resolutions	izigqibo; 
resolve	sombulula; 
resolved	sombulula; 
resolving	sombulula; 
resounding	ukuhlokoma;  ukunkenteza; 
resource	ubutyebi; 
resources	ubutyebi; 
respect	 hlonipha; intlonipho; 
respected	 hlonipha; intlonipho; 
respective	 ezizezabo; ezizezakhe; 
respectively	ngokulandelelanayo; 
respects	 hlonipha; intlonipho; 
respond	phendula; 
responded	phendula; 
respondent	ummangalelwa; 
respondents	abamangalelwa; 
responding	phendula; 
responds	iimpendulo; 
response	impendulo; 
responses	iimpendulo; 
responsibilities	amaxanduva;  iimfanelo; umthwalo; 
responsibility	 umthwalo;  imfanelo; uxanduva; 
responsible	 -nobutyala; -nokuthenjwa; 
responsive	 sabelayo; phendulayo; 
rest	ukuphumla; 
restitution	ukubuyelana kwabatshatileyo; 
restoration	ukubuyisela; 
restorative	ebuyiselayo; 
restore	vuselela; 
restored	vuselela; 
restoring	vuselela; 
restraint	 ukuzibamba;  ukunqandwa; ukunqanda; 
restricted	nyiniwe;  thintelwe; 
restriction	 unyino; uthintelo; 
restrictions	imida;  izithintelo; 
restructuring	 ukwakha ngokutsha; ukulungisa ngokutsha; 
result	isiphumo;  isahlulo; 
resulted	isiphumo;  isahlulo; 
resulting	isiphumo; isiqhamo;  isahlulo; 
results	iziphumo;  iziphumo; 
retail	intengiso; 
retain	ukugcina; 
retained	gciniwe; 
retention	ulondolozo; 
retire	thatha umhlalaphantsi; 
retired	thatha umhlalaphantsi; 
retirement	umhlalaphantsi; 
retrieval	ukufumana kwakhona; 
return	 ukubuya; ukubuyela; 
returned	buyisiwe;  buyele; 
returns	iziphumo;  iinzuzo; iingeniso; 
reveal	tyhila; 
revealed	tyhilile; 
revenue	ingeniso;  ingeniso karhulumente; 
revenues	ingeniso;  ingeniso karhulumente; 
reviewed	ihloliwe; 
reviewing	isigxeko-ncomo; 
reviews	izigxeko-ncomo; 
revise	ukuhlaziya; 
revised	ukuhlaziya; 
revision	uhlaziyo;  ukuzikhumbuza; 
revisions	uhlaziyo;  ukuzikhumbuza; 
revitalisation	vuselela kwakhona; 
revoke	rhoxisa; 
revolution	uvukelo;  uvukelo-mbuso; 
revolutionary	yovukelo;  umvukeli-mbuso; 
reward	vuza; 
rhino	umkhombe; 
rich	tyebileyo; qaqambileyo; 
right	 lungileyo; ekunene; 
rightful	lungileyo; chanekileyo; 
rights	amalungelo; 
rise	 nyuka; ukunyuka; 
rising	ukuphakama; 
risk	ingozi; 
risks	iingozi; 
river	umlambo; 
rivers	imilambo; 
road	 umgaqo; indlela; 
roads	iindlela;  imigaqo; 
robust	 philileyo; omeleleyo; 
rock	ilitye elikhulu; 
rod	 uswazi; intonga;  isilinganiso sobude; 
role	indima; 
role-players	abadlali bendima; 
roles	iindima; 
roll	umqulu;  inani lilonke; 
roll-out	ukunikela; 
rolled	umqulu;  inani lilonke; 
rolling	ukuqengqeleka; 
rollout	ukunikela; 
rolls	imiqulu; 
room	igumbi; 
rooms	amagumbi; 
root	ingcambu; 
rooted	yendele; 
roots	iingcambu; 
rose	 nyuka; ukunyuka; 
round	 -ngqukuva; ngqukuva;  jikelisa; 
rounded	ingoma yolindwano;  -ngqukuva;  jikelezayo; ngqukuva;  jikelisa; 
roundtable	itafile engqukuva; 
route	indlela; 
routes	iindlela; 
routine	 ukuziqhelisa kwabadanisi; isiqhelo; 
royal	ubukumkani;  -obukumkani; 
royalties	imivuzo yababhali; 
royalty	umvuzo wombhali; 
rugby	umbhoxo; 
rule	 irula;  ulawulo; umthetho; 
rules	 imithetho; ulawulo; 
ruling	isigqibo; 
rulings	izigqibo; 
run	umjikelo; 
running	ukugcinwa; 
runs	imijikelo; 
rural	 -yasemaphandleni; yasemaphandleni; 
sacred	 ngcwele; -ngcwele; 
sacrifice	 ukuncama; idini;  ncama; 
sacrifices	idini;  ncama;  amadini; 
sad	-lusizi; 
saddened	 silusizi; sidangele; 
safe	 isefu; -khuselekileyo; 
safeguard	ukukhusela; 
safeguarding	ukukhusela; 
safety	 ugcino; ukhuseleko; 
said	utshilo; 
salaries	imivuzo; 
salary	umvuzo; 
sale	intengiso; 
sales	iintengiso; 
salute	khahlela;  ukubulisa ngentlonipho;  bulisa ngentlonipho; 
same	fanayo; 
sample	 isiboniso; isampulu;  isampuli; 
samples	iziboniso;  iisampulu; 
sampling	ukuthatha isampuli; 
san	isan; 
sanction	isohlwayo; 
sanctions	ukohlwaya; 
sanitation	ugutyulo;  ezococeko; 
sap	incindi; 
saps	iincindi; 
satellite	 isathelayithi; isatelite; 
satisfaction	ukwaneliseka; 
satisfactory	ngokwanelisayo; 
satisfied	ukwanelisa; 
satisfies	ukwanelisa; 
satisfy	ukwanelisa; 
save	ukuhlangula;  onga; 
saving	 ukuhlangula; onga; 
savings	imali eqwetyiweyo; 
saw	isarha; 
say	yitsho; 
saying	ukutsho; 
says	uthi; 
scale	 isilinganiso;  isikali;  ixolo; umlinganiselo;  ileli;  isilinganisi-mgama;  uqweqwe lentlanzi; 
scene	 inkangeleko; umboniso; 
scenes	 iinkangeleko; imiboniso; 
schedule	ishedyuli;  isicwangciso somsebenzi; 
scheduled	ishedyuli;  isicwangciso somsebenzi; 
schedules	 izicwangciso zomsebenzi; iishedyuli; 
scheduling	ishedyuli;  isicwangciso somsebenzi; 
scheme	umsebenzi;  ukuceba; 
schemes	izikimu; imisebenzi;  ukuceba; 
scholar	umfundi; 
scholars	abafundi; 
scholarship	inkxaso-mali yomfundi; 
school	isikolo; 
schooling	ukufunda; 
schools	 izikolo zesekondari;  izikolo zeprayimari engezantsi; izikolo; izikolo zaseprayimari engentla; 
science	inzululwazi; 
sciences	iinzululwazi; 
scope	umhlaba; 
score	 ukufaka inqaku;  ukukrwela;  isiphumo somdlalo;  amashumi amabini;  inqaku;  ukuskora; amanqaku; 
scorecard	ibhodi yamanqaku; 
scoring	 ukufaka inqaku;  ukukrwela;  isiphumo somdlalo;  amashumi amabini;  inqaku;  ukuskora; amanqaku; umbhalo wemyuziki; 
screen	 ukupopola; isikrini; 
screening	ukuhluza; 
script	ubhalo;  inkcazo yomxholo; 
scrutinise	ukuphicotha; 
scrutinize	ukuphicotha; 
scrutiny	ukuphicotha; 
sculpture	ukuqingqa;  ukrolomatye;  umfanekiso oqingqiweyo; 
sea	ulwandle; 
seal	inja yaselwandle;  ukuvingca; 
sealed	inja yaselwandle;  ukuvingca;  itywiniwe; 
search	ukufuna; 
searched	funile; 
season	ixesha lonyaka lezemidlalo;  ixesha lomnyaka;  ixesha lonyaka; 
seasonal	ngamaxesha onyaka; 
seasons	 ixesha lonyaka lezemidlalo;  amaxesha omnyaka; amaxesha onyaka; 
seat	isihlalo;  ikomkhulu; 
seats	 ikomkhulu; izihlalo; 
sec	umzuzwana; 
second	 sibini; ukuxhasa;  wesibini;  umzuzwana; 
secondly	okwesibini; 
secret	imfihlo; 
secretariat	iqumrhu lolawulo; 
secretary	unobhala;  usiba-lukhulu; 
secretary-general	uNobhala-Jikelele; 
section	 inxalenye yomsebenzi; icandelo; 
sectional	eyecandelo; 
sections	 inxalenye yomsebenzi; amacandelo; 
sector	icandelo; 
sectors	icandelo; 
secure	ukufumana; 
secured	-qinileyo; ukufumana; 
securing	-qinileyo; ukufumana; 
securities	izibambiso; 
security	 isibambiso; ukhuseleko; 
see	jonga; 
seeing	ukubona; 
seek	funa; 
seeking	ukufuna; 
seeks	ufuna; 
seem	ingathi; khangeleka; 
seems	 ukhangeleka; ingathi; 
seen	uboniwe; 
segment	ilungu; 
seize	thimba; 
seized	thimbile; 
seizure	uthimbo; 
select	khetha; 
selected	khetha; 
selection	ukhetho; 
self	inkqu; 
self-determination	ukuzimela; 
self-sufficiency	ukuzimela; 
selfless	ukungazikhathaleli; 
sell	 thengisa; ukuthengisa; 
selling	ukuthengisa; 
seminar	iklasi yabafundi notitshala; 
seminars	iiklasi zabafundi notitshala; 
send	thumela; 
sending	ukuthumela; 
sends	uthumela; 
senior	omdala; 
sense	isiva-mvo; 
sensitive	-buthathaka; 
sent	thumele; 
sentence	isigwebo;  ukugweba;  isivakalisi; 
sentenced	ukugweba; gwetyiwe;  isivakalisi; 
sentences	 izivakalisi; izigwebo;  ukugweba; 
sentencing	isigwebo;  ukugweba;  isivakalisi; 
separate	ukwahlula;  -ahlukene; 
separated	ukwahlula; zimeleyo;  -ahlukene; 
separately	ngokwahlukeneyo; 
separation	ukwahlula; 
sequestration	ukuthimba; 
series	uluhlu; 
serious	nendili; 
seriously	ngendili; 
servant	isicaka; 
servants	izicaka; 
serve	 ukuphaka; ukunceda;  thumela; 
served	 ukuphaka; ukunceda;  thumela; 
serves	 ukuphaka; ukunceda;  thumela; 
service	iinkonzo;  inkonzo; 
serviced	iinkonzo;  inkonzo; 
services	iinkonzo; 
serving	 ukuphaka; ukunceda;  thumela; 
session	iseshoni; 
sessions	iiseshoni; 
set	 indawo ekwenzelwa kuyo umdlalo; iqela;  ukudeka;  beka; 
seta	iseta; 
sets	 indawo ekwenzelwa kuyo umdlalo; iisethi; iqela;  ukudeka;  ingqokelela ngokofano;  beka; 
setting	ukuseta; 
settle	hlala;  ukuzinza; 
settled	uhleli; 
settlement	 indawo yokuhlaliswa kwabantu;  ithanga; ukuma; 
settlements	 indawo yokuhlaliswa kwabantu; ukuma; 
settlers	Abemi kwilizwe elitsha; 
seven	isixhenxe; 
several	ngaphezu kwesibini; 
severe	kakhulu; 
sew	ukuthunga;  thunga; 
sewing	ukuthunga;  thunga; 
sex	isini; 
sexual	okuphathelene nesondo;  zokulalana; 
sexually	ngezesondo; 
shall	uza; 
shape	 bumba;  imilo; ukwakheka; 
shaped	miswe; 
shapes	 bumba;  imilo; ukwakheka; 
shaping	ukubumba; 
share	 isabelo;  yahlula;  isahlulo; ukwabelana; 
shared	 yahlula;  izabelo;  isahlulo; ukwabelana; 
shareholder	ukuba nesahlulo kushishino; 
shareholders	ukuba nesahlulo kushishino; 
shareholding	ukuba nezabelo; 
shares	 yahlula;  izabelo;  izahlulo; ukwabelana; 
sharing	 isabelo;  yahlula;  isahlulo; ukwabelana; 
shark	ukrebe; 
sharks	ookrebe; 
sharp	ebukhali; 
she	yena; 
shed	 ishedi; isitora;  ukobuza; 
shedding	 ishedi; isitora;  ukobuza; 
sheet	iphepha;  icangci;  ishiti; 
sheets	 ishiti;  amacangci; amaphepha; 
shelter	 ikhusi;  indawo yokuhlala; indlu; 
sheriff	unothimba; 
sheriffs	oonothimba; 
shift	isikofu; 
shifted	isikofu; 
shifting	isikofu; 
shifts	iishifu; 
ship	inqanawa; 
shipping	ukuthumela; 
ships	iinqanawa; 
shock	umothuko;  ukothuka; 
shocked	umothuko;  ukothuka; 
shocks	ukothuka; iimothuko; 
shop	ivenkile; 
shopping	ukuthenga; 
shops	iivenkile; 
shore	unxweme; 
shores	amaxweme; 
short	futshane; 
short-term	ixesha elifutshane; 
shortages	ukuqongophala; 
shorter	futshane; 
shortly	kungekudala; 
shot	imbumbulu; 
should	kufuneka; 
shoulders	amagxa; 
show	bonisa; 
showcase	umboniso; 
showcasing	ukubonisa; 
showed	bonisa; 
showing	ukubonisa; 
shown	bonisa; 
shows	bonisa; 
side	icala;  ithambeka;  icala lelaphu; 
sign	 ukusayina; uphawu;  umqondiso; 
signal	 umqondiso wonxibelelwano; umqondiso; 
signals	imiqondiso;  imiqondiso yonxibelelwano; 
signature	isandla;  utyikityo; 
signed	 ukusayina; uphawu;  umqondiso; 
significance	intsingiselo; 
significant	ukubaluleka; 
significantly	ngokubalulekileyo; 
signifies	ibonisa;  iqondisa; 
signing	 ukusayina; uphawu;  umqondiso; 
signs	 ukusayina; iimpawu;  umqondiso; 
silver	isilivere; 
similar	 ebufana; fanayo; 
similarly	ngokufanayo; 
simple	 -lula; lula; 
simply	lula; 
simultaneously	ngaxeshanye; 
since	kususela oko; 
sincere	nyanisekileyo; 
sincerely	ngokunyanisekileyo; 
sing	cula; 
singer	umculi; 
singing	ukucula; 
single	enye; 
sister	udade; 
sisters	oodade; 
sit	hlala; 
site	isiza; 
sites	iziza; 
sitting	indibano yendlu; 
sittings	indibano yendlu; 
situate	ukumisa ngendawo; 
situated	ukumisa ngendawo; 
situation	imeko;  ukuma; 
situations	imeko;  ukuma; 
six	 -thandathu; isithandathu; 
sixth	 isinye kwisithandathu; isinye esithandathwini; 
size	 ubungakanani;  usayizi; ubukhulu; 
skill	 isakhono; ubuchule;  ubuchwepheshe; 
skilled	 unesakhono; unobuchule; 
skills	izakhono;  ubuchule;  ubuchwepheshe; 
slave	ikhoboka; 
slavery	ubukhoboka; 
slaves	amakhoboka; 
slightly	kancinane; 
slip	uswazi;  ukutyibilika; 
small	 iqolo; -ncinci; 
small-scale	kancinci; 
smaller	 iqolo; -ncinci; 
so	njalo; 
so-called	bizwa njalo; 
soccer	 umdlalo webhola ekhatywayo; isoka; 
social	ezentlalo; 
socially	ngokuhlalisana; 
societal	eyezentlalo; 
societies	 umbutho;  iqumrhu; uluntu; 
society	 umbutho;  iqumrhu; uluntu; 
socio-economic	uqoqosho lwezentlalo; 
socioeconomic	uqoqosho lwezentlalo; 
soil	umhlaba; 
sold	 thengisa; ukuthengisa; 
soldiers	amajoni; 
sole	isoli; 
solely	kuphela; 
solid	 qinile; eqinileyo;  isiqina; 
solution	 umxube;  isinyibiliko;  ukucombulula; isisombululo; 
solutions	 umxube;  isinyibiliko;  ukucombulula; isisombululo; 
some	abanye; 
someone	omnye umntu; 
something	into ethile; 
sometimes	ngamanye amaxesha; 
somewhat	ngenye indlela; 
son	nyana; 
song	ingoma;  iculo; 
songs	 amaculo; ingoma; 
soon	msinya; 
sophisticated	 nqabileyo; nobunkunkqele; 
sort	hlela; 
sought	ufune; 
soul	umntu; 
souls	umntu; 
sound	isandi; 
sounds	-philile; isandi; 
source	umthombo;  fumana emthonjeni; 
sources	imithombo;  fumana emthonjeni; 
sourcing	umthombo;  fumana emthonjeni; 
south	 emazantsi;  omzantsi;  umzantsi; ezantsi; 
southern	emazantsi; 
sovereign	ukumkani;  -ombuso; 
space	 emajukujukwini; isithuba; 
spaces	izithuba; 
spatial	indawo;  isithuba; 
speak	thetha; 
speaker	usihlalo; 
speakers	usihlalo; 
speaking	thetha; 
speaks	thetha; 
spear	umkhonto; 
specialisation	ikhondo elithile; 
specialised	khethekileyo; 
specialist	ingcali;  incutshe; 
specially	ngokukodwa; 
species	izidalwa zohlobo olunye; 
specifically	ngokukhethekileyo; 
specification	iimpawu ezifunekayo; 
specifications	iimpawu ezifunekayo; 
specified	ukucacisa; 
specify	ukucacisa; 
specimen	 isiboniso; umzekelo; 
specimens	 isiboniso; umzekelo; 
spectacular	isenzo esinomtsalane emdlalweni; 
spectrum	umgca-mabala omnyama; 
speech	intetho; 
speeches	intetho; 
speed	isantya;  amendu; 
speedy	ngesantya;  ngamendu; 
spend	ukusebenzisa;  ukuchitha; 
spending	ukusebenzisa;  ukuchitha; 
spent	sebenzise; 
sphere	isazinge;  ingqukumba; 
spheres	 isazinge; ingqukumba; 
spirit	umoya; 
spiritual	ezomoya; 
split	 ukucanda; ukwahluka; 
spoke	isipeki; 
spoken	thetha; 
sponsor	 xhasa; umxhasi; 
sponsored	 xhasa; umxhasi; 
sport	umdlalo; 
sporting	imidlalo; 
sports	umdlalo; 
spotlight	isibane esinelitha elikhanya kakhulu; 
spouse	umlingane womtshato; 
spouses	umlingane womtshato; 
spread	 sasaza; ukusasaza; 
square	 ukuphindaphinda inani kwangalo; isikwere; 
stabilise	ukuzinzisa; 
stability	uzinzo; 
stable	isitali; 
stadium	isitediyam; 
stadiums	izitediyam; 
staff	 isitafu; abasebenzi; 
stage	 isiganga; inqanaba;  amabakala;  iqonga; 
stages	amanqanaba;  amaqonga;  isiganga;  amabakala; 
staging	amanqanaba esifo; 
stakeholder	umntu onomdla ochaphazelekayo; 
stakeholders	-chaphazelekayo; umntu onomdla ochaphazelekayo; 
stalwart	ithemba; 
stalwarts	ithemba; 
stamp	isitampu; 
stance	 ubume bengqondo; isimo; 
stand	isisekelo;  ipaviliyoni; 
standard	 izinga; umgangatho;  ibanga; 
standardised	bekwe emgangathweni; 
standardization	ukubeka emgangathweni; 
standards	imigangatho;  ibanga;  amazinga; 
standing	isisekelo;  ipaviliyoni; 
stands	isisekelo;  ipaviliyoni; 
stanza	indinyana; 
star	inkwenkwezi; 
stars	inkwenkwezi; 
start	qala; 
started	qala; 
starting	qala; 
starts	qala; 
state	 ilizwe lombuso;  imo;  umbuso; urhulumente; 
state-owned	eyombuso; 
stated	 ilizwe lombuso;  imo;  umbuso; urhulumente; 
statement	 inkcazo; ingxelo; 
statements	ingxelo-mali; 
states	 ilizwe lombuso;  imo;  umbuso; urhulumente; 
stating	 ilizwe lombuso;  imo;  umbuso; urhulumente; 
station	isitishi; 
stationery	-zokubhala;  izixhobo zokubhala; 
stations	izitishi; 
statistical	iinkcukacha-manani; 
statistician-general	umphathi jikelele weenkcukacha-manani; 
statistics	amanani; 
statue	umfanekiso oqingqiweyo; 
stature	 ubude; isidima; 
status	iwonga; 
statute	 ummiselo; umthetho; 
statutes	 ummiselo; umthetho; 
statutory	eyomthetho; 
stay	hlala; 
steadily	qinileyo;  thembekileyo; 
steady	nkqi; 
steal	ukuba; 
steel	 icwilika; intsimbi; 
steer	ukuqhuba; 
steering	ukuqhuba; 
step	 inqwanqwa;  inqanaba; inyathelo; 
steps	 inqwanqwa;  amanqanaba; amanyathelo; 
sterling	umntu olunge kanye; imali yaseBrithani; 
still	ukuzolisa; 
stimulate	ukukhuthaza; 
stimulating	ukukhuthaza; 
stipulate	ukubalula; 
stipulated	ukubalula; 
stock	 isabelo; ekhoyo;  imfuyo; 
stolen	ukuba; 
stone	 ipete;  khupha ipete; ithambo; 
stood	isisekelo;  ipaviliyoni; 
stop	misa; 
storage	 ugcino; uvimba; 
store	ukugcina;  gcina;  isitora; 
stored	ukugcina;  gcina;  isitora; 
stories	amabali; 
storm	uqhwithela;  isaqhwithi; 
story	 ibali lebhayibhile; ibali; 
storytellers	umbalisi-bali; 
strategic	ubuchule bokuhlela imfazwe; 
strategies	iqhinga; 
strategy	iqhinga; 
stream	umsinga; 
streams	imisinga; 
street	indlela;  isitrato; 
streets	izitaloto; izitalato; 
strength	amandla; 
strengthen	ukomeleza; 
strengthened	omeleziwe; 
strengthening	ukomeleza; 
stress	ukukhathazeka;  unxunguphalo;  ukucinezela;  isigxininiso; 
strict	ngqongqo; 
strides	imigxanyo; amanyathelo; 
strike	uqhankqalazo; 
string	umtya; 
strip	 ukuhlubula;  umcwe; umcu welaphu; 
strips	ukuhlubula;  imicu yelaphu; umicu yelaphu; 
strive	ukuzama; 
striving	ukuzama; 
strong	unamandla; 
stronger	unamandla ngakumbi; 
strongly	ngamndla; 
struck	uqhankqalazo; qhankqalazile; 
structural	eyesakhiwo; 
structure	 ubume; isakhiwo;  ulwakhiwo;  ukwakhiwa; 
structured	 ubume; isakhiwo;  ulwakhiwo;  ukwakhiwa; 
structures	 ubume; izakhiwo;  ulwakhiwo;  ukwakhiwa; 
struggle	ukuzama;  umzamo;  ukuzabalaza; 
struggles	ukuzama;  umzamo;  ukuzabalaza; 
struggling	ukuzama;  umzamo;  ukuzabalaza; 
student	umfundi; 
students	abafundi; 
studies	ukufunda; 
studio	igumbi; 
studios	igumbi; 
study	ukufunda; 
style	 uluthi lwesizalo; isimbo;  uluthi lwesizalo sentyatyambo; 
sub	enganeno; 
sub-item	into enganeno; 
sub-programme	inkqubo enganeno; 
sub-regulation	ummiselo onganeno; 
subject	 ukuthobisa; intloko;  isifundo; 
subjected	 ukuthobisa; intloko; -phethweyo;  isifundo; 
subjects	 ukuthobisa; -phethweyo; izifundo;  intloko; 
submission	Ungeniso lwezimvo; 
submissions	Ungeniso lwezimvo; 
submit	thumela; 
submitted	thumele; 
submitting	ukuthumela; 
subparagraph	umhlathi onganeno; 
subpoenaed	isapina; 
subscribe	ukubhalisa;  ukurhuma; 
subscribed	 rhumile; bhalisile; 
subsection	icandelwana; 
subsections	amacandelwana; 
subsequent	landelayo; 
subsequently	ngokulandelayo; 
subsidiary	umncedisi; 
subsidies	 iinkxaso; izibonelelo; 
subsidy	inkxaso;  isibonelelo; 
subsistence	ukuphila; 
substance	into; 
substances	izinto; 
substantial	omeleleyo; 
substantially	ngokomeleleyo; 
substantive	usobizo; 
substitute	ilalela;  fakela enye endaweni yenye;  usobizo endaweni; 
substituted	 fakela enye endaweni yenye; ukutshintshanisa; ufakelwe ilalela;  usobizo endaweni; 
substitutes	amalalela;  fakela enye endaweni yenye; ukutshintshanisa;  usobizo endaweni; 
substituting	 fakela enye endaweni yenye; usobizo endaweni; ukutshintshanisa;  ukufaka ilalela; 
substitution	ukufaka umdlali endaweni yomnye; 
succeeded	ngena esikhundleni ebesinomntu; 
success	impumelelo; 
successes	impumelelo; 
successful	-nempumelelo; 
successfully	ngempumelelo; 
succession	ukulandelelana; 
successor	umngeni-zinyaweni; 
such	enjalo; 
suffer	gula; 
suffered	gulayo; 
suffering	ubuhlungu; 
sufficient	 neleyo; aneleyo; 
sufficiently	ngokwaneleyo; 
sugar	iswekile; 
suggest	ukucebisa; 
suggested	ukucebisa; 
suggestion	ingcebiso;  icebiso; 
suggestions	iingcebiso;  amacebiso; 
suggests	ukucebisa; 
suitable	-fanelekileyo; 
suitably	ngokufanelekileyo; 
sum	isibalo; 
summary	isishwankathelo; 
summer	ihlobo; 
summit	 incopho; ingqungquthela; 
summits	incopho;  ingqungquthela; 
summoned	 menywe ngesamani; biziwe; 
summons	isamani; 
sun	ilanga; 
sung	culile; 
superior	-ngentla; 
supervisees	ongamele; 
supervision	ulongamelo; 
supervisory	ukongamela; 
supplement	isihlomelo;  isongezelelo; 
supplied	 ukufumanisa;  ukunika; inkxaso;  ukufumaneka; 
suppliers	abanikezi; 
supplies	ezikhoyo; 
supply	 ukufumanisa;  ukunika; inkxaso;  ukufumaneka; 
support	 isisekelo;  khathalela; ukuxhasa;  xhasa;  sekela; 
supported	 isisekelo;  khathalela; ukuxhasa;  xhasa;  sekela; 
supporting	 isisekelo;  khathalela; ukuxhasa;  xhasa;  sekela; 
supportive	exhasayo; 
supports	 isisekelo;  khathalela; ukuxhasa;  iinkxaso;  sekela; 
supposed	cingile; 
supreme	 eyona yona; phezulu;  owona wona; 
sure	qinisekile;  thembekileyo; 
surely	ngokuqinisekileyo;  ngokuthembekileyo; 
surface	 ukugudisa; umphezulu; 
surplus	 okuseleyo; intsalela; 
surrender	ukuzinikela; 
surrounding	ummandla;  rhanqileyo; ngqongileyo; 
surveillance	ukucupha; 
survey	ukuhlola; 
surveyor	 umvavanyi;  unocanda; umhloli; 
surveyors	 oonocanda;  abavavanyi; abahloli; 
surveys	phonononga; ukuhlola; 
survival	 ukungatshabalali; ukusinda; 
survive	 -phila; ukuphila; 
surviving	 -phila; ukuphila; 
suspect	krokrela; thandabuza;  rhanela; 
suspected	krokrele;  rhanele;  thandabuzile; 
suspects	krokrela; thandabuza;  rhanela; 
suspend	 -misa; ukumisa;  ukuxhoma; 
suspended	 -misa; ukumisa;  ukuxhoma; 
suspension	ukumiswa;  ukutshintshwa;  izixhasi; 
suspensions	ubaziso; ukumiswa;  ukutshintshwa;  umxube wezinto ezinganyibilikanga;  izixhasi; 
sustain	ukugcina; 
sustainability	uzinzo; 
sustainable	-nokuzinza; 
sustained	ukugcina; 
sustaining	ukugcina; 
swear	ukuthuka;  ukufunga; 
swearing	ukuthuka;  ukufunga; 
switch	iqhosha lombane;  ukucofa; 
sworn	fungisiwe; 
symbol	uphawu; 
symbolic	 ngomzekeliso; ngokomqondiso; 
symbolically	 ngomzekeliso; ngomqondiso; 
symbolises	ibonisa;  iqondisa; 
symbolism	ubuqondisi; ukuzekelisa; 
symbols	iimpawu; 
symposium	 ingqungquthela; intlanganiso; 
symptom	 uphawu lwesifo; uphawu;  umqondiso; 
symptoms	uphawu;  imiqondiso;  imiqondiso yesifo; 
system	 isixokelelwano; indlela;  inkqubo; 
systematic	ngendlela; 
systematically	ngeyona ndlela; 
systemic	ngokwenkqubo; 
systems	 isixokelelwano;  iinkqubo; indlela; 
table	 itafile;  uluhlu ngokwemihlathi; isicwangciso;  itheyibhile; 
tabled	 itafile;  uluhlu ngokwemihlathi; isicwangciso;  itheyibhile; 
tables	izicwangciso; iitheyibhile;  iitafile;  izintlu ngokwemihlathi; 
tabling	Ukwandlala; 
tabs	 iimbasa; amaphetshana; 
tackle	ukuhlutha ibhola; 
tags	iilebhile; iintloko zomtya wesihlangu; 
take	thatha; 
taken	thathiwe; 
takeover	ukuthathela kuwe; 
takes	thatha; 
taking	ukuthatha; 
tale	ibali; 
talent	italente;  isiphiwo; 
talented	nesiphiwo; 
talents	italente;  iziphiwo; 
tales	amabali; 
talk	thetha; 
talking	ukuthetha; 
talks	iintetha; 
tall	ende; 
tangible	okubambekayo; 
tap	 ukunkqonkqoza; impompo; 
target	ekujoliswe kuko; 
targeted	ekujoliswe kuko; 
targeting	ekujoliswe kuko; 
targets	ekujoliswe kuko; 
tariff	imali ehlawulelwa inkonzo; 
tariffs	iimali ezihlawulelwa inkonzo; 
task	umsebenzi; 
tasked	umsebenzi; 
tasks	umsebenzi; 
taught	ukufundisa; 
tax	irhafu; 
taxable	erhafiswayo; 
taxation	irhafu;  urhafiso; 
taxed	irhafisiwe; 
taxes	iirhafu; 
taxi	iteksi; 
taxpayer	umrhafi; 
taxpayers	abarhafi; 
teach	ukufundisa; 
teacher	itishala-; 
teachers	iitishala-; 
teaching	ukufundisa; 
team	iqela; 
teams	amaqela; 
teaser	umchwishi;  umqhuli; 
technical	-buchule; 
technician	ingcali ngobugcisa; 
technicians	iingcali ngobugcisa; 
technique	 isakhono; ubuchule; 
techniques	izakhono;  ezobuchule; 
technologies	ubuchwepheshe; 
technology	ubuchwepheshe; 
telecommunication	uthungelwano; 
telecommunications	unxibelelwano ngefowuni; 
telephone	 imfono-mfono; umnxeba; 
television	 umfanekiso kanomathotholo; umabonakude; 
tell	xelela; 
telling	ukuxelela; 
tells	uxela; 
temporarily	okwethutyana; 
temporary	okwexesha; 
ten	ishumi; 
tend	 khwezela; alusa;  londoloza; 
tender	ukunika; 
tendered	ukunika; 
tenders	ukunika; 
tension	umoya;  ukuqina;  ukuxhalaba; 
tenure	 ixesha lengqesho; ixesha lokuba sesikhundleni; 
term	 isigaba sexesha elimiselweyo; igama;  iseshini; 
terminate	ukuphelisa; 
terminated	phelisiwe; 
termination	upheliso; 
terminology	isigama; 
terms	imiqathango; 
terrestrial	asemhlabeni; 
territorial	ezemimandla; 
territories	imimandla; 
territory	ummandla; 
terrorism	ugrogriso; 
terrorist	umgrogrisi; 
tertiary	imfundo ephakamileyo; 
test	 ukuva;  ukuvavanya;  vavanya; uvavanyo; 
tested	iviwe;  ivavanyiwe; 
testimony	ubungqina; 
testing	 ukuva;  ukuvavanya;  vavanya; uvavanyo; 
tests	iimvavanyo;  iimviwo; 
text	itekisi; 
than	 kunawe;  kunam; kunaye; 
thank	enkosi;  umbulelo; 
thanks	imibulelo; 
that	 sona;  loo;  eso;  elo;  yona; ukuba; 
that's	 yinja; ngumntu;  yinkomo; 
the	 isonka;  inkomo; imoto; 
theater	igumbi loqhaqho;  ithiyetha; 
theatres	 ithiyetha; amagumbi oqhaqho; 
theft	 ubusela; ukuba; 
their	 sabo; abo;  yabo;  labo;  zabo; 
them	nabo;  bona; 
theme	umxholo; 
themes	umxholo; ingoma ephinda-phindayo emdlalweni; 
themselves	ngokwabo; 
then	ngako oko; 
therapy	ukunyanga; 
there	kukho; 
thereafter	emva koko; 
thereby	ngako oko; 
therefore	ngoko ke; 
therein	apho; 
thereof	ngenxa yoko; 
thereon	apho; 
thereto	apho; 
thereupon	phezu koko; 
therewith	ngaloo nto; 
these	ezi; 
they	bona; 
thing	into; 
things	izinto; 
think	ukucinga; 
thinking	ukucinga; 
third	isinye esithathwini; 
thirdly	okwesithathu; 
thirds	isinye esithathwini; 
thirty	amashumi amathathu; 
this	 esi;  oku; eli; 
those	abo;  eso;  eziya;  ezo; 
though	nangona; 
thought	ukucinga; 
thoughts	iingcinga; 
thousand	iwaka; 
thousands	 iwaka; amawaka; 
threat	isoyikiso; 
threaten	ukugrogrisa; 
threatened	ukugrogrisa; 
threats	izoyikiso; 
three	 -thathu; isithathu; 
three-day	iintsuku ezintathu; 
three-year	iminyaka emithathu; 
threshold	ubuncinane bomlinganiselo wamanani; 
thriving	 ukuphumelela; ukuqhuba; 
through	yikha; 
throughout	yonke indawo; 
thus	ngako oko; 
ticketing	Ukunika itikiti; 
tickets	iitikiti; 
tie	bambana-manqaku; 
tiers	imiqolo; 
ties	bambana-manqaku; isiqhakamshelo; 
till	lima; 
time	ixesha; 
timeframes	ukwahlulwa kwamaxesha; 
timely	ngexesha; 
times	phindaphinda; 
tirelessly	ngokungadinwa; 
title	igama; 
titled	yesihloko esithi; 
titles	igama; 
to	phambi; 
tobacco	icuba; 
today	namhlanje; 
together	kunye; 
toilet	indlu yangasese; 
toilets	amagumbi angasese;  izindlu zangasese; 
told	xelelwe; 
tolerance	ukunyamezela; 
tomorrow	ngomso; 
ton	itoni; 
tonight	kobu busuku; 
tonnage	ubunzima; 
tons	iitoni; 
too	 naye; kakhulu; 
took	thathile; 
tool	 isixhobo somsebenzi; isixhobo; 
toolkit	ingxowa yezixhobo zokusebenza; 
tools	izixhobo;  isixhobo somsebenzi; 
top	 incopho; umphezulu; 
topic	ingongoma; 
topics	ingongoma; 
total	iyonke; 
totalled	itotali; iyonke; 
touch	ukuphatha; 
tough	nzima;  yomelele; 
tour	 uhambo lokhenketho; ukhenketho; 
touring	ukukhenketha; 
tourism	ukhenketho; 
tourist	umcandi-zwe; 
tourists	umcandi-zwe; abakhenkethi; 
tournament	itumente; 
tournaments	iitumente; 
tours	 uhambo lokhenketho; ukhenketho; 
toward	malunga; 
towards	ukuya; 
town	idolophu; 
towns	idolophu; 
township	ilokishi; 
townships	ilokishi; 
trace	 fumana umkhondo; uphawu;  ukukhuphela;  funa;  ukutreyisa; 
track	 indledlana; umzila; 
trade	 urhwebo; ishishini;  ukurhweba; 
trading	ukurhweba; 
tradition	isithethe;  isiko; 
traditional	 -esithethe; yezithethe; 
traditionally	sithethe;  ngokwemveli; 
traditions	izithethe;  amasiko; 
traffic	izihamba-ndlela; 
trafficking	izihamba-ndlela; uthontelwano lwezithuthi; 
tragedy	isivisa-lusizi; 
tragic	lusizi; 
train	 ukuqhelisa; fundisa;  uloliwe; 
trained	 ukuqhelisa; fundisa;  uloliwe; 
training	 uqheliso; uqeqesho; 
trajectory	indlela yembumbulu okanye into ephoswayo; 
transaction	intengiselwano; 
transactions	iintengiselwano; 
transfer	unikezelo;  ukhuphelo;  ukutshintshela;  ukususwa endaweni usisiwa kwenye;  utshintshelo; 
transferred	unikezelo;  ukhuphelo;  ukutshintshela;  ukususwa endaweni usisiwa kwenye;  utshintshelo; 
transferring	unikezelo;  ukhuphelo;  ukutshintshela;  ukususwa endaweni usisiwa kwenye;  utshintshelo; 
transfers	amakhuphelo;  izitshintshelo;  ukususwa endaweni usisiwa kwenye; izinikezelo; 
transform	guqula; 
transformation	inguqu; 
transformed	guqulwe; 
transforming	ukuguqula; 
transition	 inguqu; utshintsho; 
transitional	inkqubela;  ukugqitha; 
translate	 guqulela; ukuguqula; 
translated	guquliwe; 
translation	inguqulo; 
translator	umguquli; 
translators	umguquli; 
transmission	 ukudlulisela; usasazo;  ukugqithisa umbane; 
transmit	ukuthumela;  dlulisa;  yosulela;  ukugqithisa; 
transmitted	ukuthumela;  dlulisa;  yosulela;  ukugqithisa; 
transparency	ukuba selubala; 
transparent	iyabonisa; 
transport	 ukuthutha; isithuthi;  uthutho; 
transportation	uthutho; 
travel	uhambo;  -hamba; 
travelled	hambile; 
travelling	hamba; 
treasure	indyebo; 
treasures	indyebo; 
treasuries	iindyebo; 
treasury	indyebo; 
treat	 ukunyanga; nyanga; 
treated	 ukunyanga; nyanga; 
treaties	 utyikityo lwesivumelwano soxolo; imvumelwano; 
treatment	unyango;  iyeza; 
treaty	 utyikityo lwesivumelwano soxolo; imvumelwano; 
tree	umthi; 
trees	imithi; 
trend	isiqhelo; 
trends	iziqhelo; 
trial	ukuthetha ityala;  ukuthethwa kwetyala; 
trials	 ukuthethwa kwetyala; izilingwa; 
tribunal	inkundla yomthetho; 
tribunals	inkundla yomthetho; 
tribute	 imbeko; irhafu;  umnikelo; 
tried	zamile; 
triple	ntathu; 
triumph	uloyiso; 
trophy	 indebe; imbasa; 
troupe	iqela labadlali; 
truly	ngokwenene; 
trust	 itrasti; themba; 
trustee	umgcineli; 
trustees	umgcineli; 
trusts	 iitrasti; themba; 
truth	inyaniso; 
try	zamile; 
trying	ukuzama; 
turfs	 isoyi; indlela yomdyarho; 
turn	guqula; 
turnaround	jika; 
turned	jikile; 
turning	imigobo nemidibaniso; 
turnover	ingeniso; 
twelve	ishumi elinambini; 
twentieth	eyamashumi amabini; 
twenty	amashumi amabini; 
twice	kabini; 
twitter	itwitter; 
two	isibini;  -bini; 
two-day	iintsuku ezimbini; 
two-thirds	isibini kwisithathu; 
type	 ukuchwetheza; uhlobo; 
types	iintlobo;  ukuchwetheza; 
typically	ngqo; 
ultimate	OKOKUGQIBELA; 
ultimately	EKUGQIBELENI; 
unable	ANDIKWAZI; 
unacceptable	AYAMKELEKI; 
unanimous	ngazwinye; 
unauthorised	AYIGUNYAZISWANGA; 
uncertainty	UKUNGAQINISEKI; 
under	ngaphantsi; 
underdevelopment	UKUPHUHLA OKUNGANENO; 
undergo	ukwenza; 
underlying	esisiseko; 
undermine	ukweya; 
underpin	phawula; 
understand	qonda; 
understanding	ukuqonda; 
understood	qonda; 
undertake	amkela;  ngcwaba; 
undertaken	 thathile; ngcwatyiwe; 
undertaking	ukwenza; 
undertook	wenze; 
underwater	phantsi kwamanzi; 
underway	ngaphantsi komhlaa; 
undue	ngokungafanelekanga; 
unemployment	ukungasebenzi; 
unfair	NGENABULUNGISA; 
unfortunately	ngelishwa; 
unhappy	awonwabanga;  awuvuyanga; 
unified	manya; 
uniform	 iyunifomu; iyunifom;  -fanayo; 
unify	manya; 
union	 umdibaniso; umanyano;  imanyano;  Umanyano; 
unions	 umdibaniso; umanyano;  imanyano;  Umanyano; 
unique	-yodwa; 
unit	umvo;  iyunithi; 
unitary	isinye; 
unite	dibanisa;  ukumanyana; 
units	imivo; 
unity	umanyano; 
universal	 ukubakho jikelele; jikelele;  wabo bonke; 
universe	indawo yonke; 
universities	 iyunivesithi; idyunivesithi; 
university	 iyunivesithi; idyunivesithi; 
unknown	ayaziwa; 
unlawful	ayikhomthethweni; 
unleash	khulula; 
unless	ngaphandle kokuba; 
unlike	ngokungafaniyo; 
unlikely	ngafanelanga; 
unnecessary	kungafuneki; 
unprecedented	ngafani nezazikhona ngaphambili;  ngenakufaniswa nanto; 
unqualified	ngafanelanga; 
unreasonable	ngamkelekanga; 
unregistered	ngabhaliswanga; 
unsafe	ngakhuselekanga; 
until	kude kube; 
untold	ayithethwanga; 
unusual	ayiqhelekanga; 
unveil	ukutyhila; 
unveiled	tyhilile; 
unveiling	ukutyhila; 
up	phezulu; 
upcoming	okhulayo; 
update	ukuhlaziya; 
updated	hlaziyiwe; 
updates	izihlaziyo; 
upgrade	-phucula; 
upgraded	-phucula; 
upgrades	-phucula; 
upgrading	-phucula; 
uphold	ukugcina; 
uploading	ukukopa; 
upon	kwakhe kwathi; 
urge	ukutshiseka; 
urged	ukutshiseka; 
urgency	ungxamiseko; 
urgently	ngokugxamiseka; 
urges	ukutshiseka; 
us	thina; 
usage	usetyenziso; 
use	 umsebenzi wenaliti; umsebenzi;  sebenzisa; 
used	setyenzisiwe; 
useful	luncedo; 
user	umsebenzisi; 
users	abasebenzisi; 
uses	 umsebenzi wenaliti; ukusetyenziswa kwesikera; umsebenzi;  sebenzisa; 
using	 umsebenzi wenaliti; ukusetyenziswa kwesikera; umsebenzi;  sebenzisa; 
utilisation	usetyenziso; 
utilise	sebenzisa; 
utilised	setyenzisiwe; 
v	V; 
vacancies	 izithuba somsebenzi; izithuba; 
vacancy	 isithuba somsebenzi; isithuba; 
vacant	ze; 
valid	semthethweni; 
validity	 isiqinisekiso esisemthethweni; ixabiso; 
valley	intlambo; 
valuable	nexabiso; 
valuation	ukuxabisa; 
value	ixabiso; 
valued	ixabiso; 
values	iinqobo ezisemgangathweni; 
van	iveni; 
variation	 iyantluko; iyantlukwano; 
varied	tshintshatshintsha; 
varies	ukwahluka; 
variety	ntlobontlobo; 
various	tshintshatshintsha; 
vary	ukwahluka; 
varying	ukwahluka; 
vast	ninzi; 
vat	irhafu yentengo; 
vehicle	 umthuthi; isithuthi; 
vehicles	izithuthi;  umthuthi; 
vendor	umthengisi; 
venture	ilinge; 
ventures	amalinge; 
venue	ibala lokudlalela; 
venues	ibala lokudlalela; 
verification	uqinisekiso; 
verify	qinisekisa; 
version	uguqulo; 
very	kakhulu; 
vessel	inqanawa;  umthambo;  uhlobo lwenqanawa;  ijelo legazi;  isityana; 
vested	thweswe; 
veterans	 ixhego lemfazwe; umdala; 
via	ngendlela edlula; 
viability	ukuba nokuphila; 
viable	nokuphila; 
vibrant	dlamkile;  hlokomayo; 
vice	ivayisi; 
vice-chairperson	sekela sihlalo; 
victim	ixhoba; 
victims	amaxhoba; 
victor	 umoyisi; oyisileyo; 
victory	uloyiso; 
video	umboniso;  isishicileli-miboniso; 
videos	umboniso;  isishicileli-miboniso; 
view	imbonakalo; 
viewed	imbonakalo; 
viewing	imbonakalo; 
views	imbonakalo; 
village	umzana; 
villages	umzana; 
violation	ukwaphula umthetho; 
violations	ukwaphula umthetho; 
violence	ubundlobongela; 
violent	bhovubhovu;  vuthuza; 
virtual	eqikelelwayo; 
virtually	ngenyani; 
virtue	ukulunga; 
visa	imvume yokungena kwilizwe; 
visible	ebonakalayo; 
vision	umbono; 
visionary	ingcinga esengqondweni; 
visit	utyelelo; 
visited	tyelele; 
visiting	ukutyelela; 
visitor	undwendwe; 
visitors	undwendwe; 
visits	amatyelelo; 
visual	-bonakalayo; 
visually	thabathekisayo; 
vital	dlamkileyo; enobomi; 
vocational	-omsebenzi; 
voice	ilizwi; 
voices	ilizwi; 
void	phuthile;  lambatha; ze; 
volatility	ukutsha msinya; 
volume	umthamo;  isandi; 
voluntarily	ngokuzithandela; 
voluntary	ngokuzithandela;  ngabom; 
volunteer	ivolontiya; 
volunteers	ivolontiya; 
vote	 ukuvota; ivoti; 
voted	votile; 
voter	umvoti; 
voters	umvoti; 
votes	vota;  ukuvota; ivoti; 
voting	ukuvota; 
vulnerability	enokonakaliswa; 
vulnerable	 -nokwenzakala; ukuba nokwenzakala; 
wage	umvuzo; 
wages	imivuzo; 
waiting	lindile; 
walk	hamba; 
walks	hamba; 
wall	udonga;  udonga lwabadlali; 
walls	udonga;  udonga lwabadlali; 
want	imfuno;  ukufuna; 
wanted	imfuno;  ukufuna; 
wants	ufuna; 
war	imfazwe; 
ward	 igumbi lezigulana; iwadi; 
wards	iiwadi;  magumbi ezigulana; 
warm	 -shushu; kushushu; 
warmth	ubushushu; 
warning	isiyalo; 
warrant	ilungelo lokungena endlwini nokuyiphanda; 
warrants	amalungelo okungena endlwini nokuphanda; 
wars	iimfazwe; 
was	ibinakho; 
waste	ukuchitha;  umphutha; 
watch	 iwotshi; ixesha; 
water	 ukunkcenkceshela; amanzi;  seza;  nkcenkceshela; 
waters	 ukunkcenkceshela; amanzi;  seza;  nkcenkceshela; 
wax	umthwebeba;  umphula; 
way	indlela; 
ways	iindlela; 
we	thina; 
we've	sinayo; 
weak	buthathaka; 
weakness	ubuthathaka;  ukutyhafa; 
weaknesses	ubuthathaka;  ukutyhafa; 
wealth	indyebo; 
weapon	isixhobo; 
weapons	izixhobo; 
weather	 izulu; imozulu; 
web	izigcawu; 
websites	iiwebhusayithi; 
week	iveki; 
week-long	iveki yonke; 
weekend	impela-veki; 
weeks	iiveki; 
weight	 ukwenza nzima; ubunzima;  ilitye lesikali; 
welcome	wamkelekile; 
welcomed	wamkelwe; 
welcomes	ukwamkela; 
welcoming	ukwamkela; 
welfare	intlalontle; 
well	iqula; 
well-being	 ukonwaba; ukulunga; 
well-known	dumile;  indwaluthu; 
wellbeing	 ukonwaba; ukulunga; 
went	hambile; 
were	beke; 
west	 ngasentshonalanga; entshona;  intshonalanga; 
western	entshonalanga; 
wetlands	umhlaba olijojo; 
what	intoni; 
what's	intoni; 
whatever	nantonina; 
whatsoever	nantonina; 
when	nini; 
whenever	nanini; 
where	phi; 
whereas	ekubeni; 
whereby	kanti; 
whereupon	apho; 
wherever	naphina; 
whether	nokuba; 
which	eyakuthi; 
whichever	nayiphina; 
while	xeshikweni; 
whilst	xeshikweni; 
whip	 UMbhexeshi; isabhokhwe; 
whips	 UMbhexeshi; isabhokhwe; 
white	mhlophe; 
whites	abamhlophe; 
who	ubani; 
whole	epheleleyo; 
wholly	 kwaphela; ngokupheleleyo; 
whom	lowo; 
whose	lowo; 
why	 ngoba; kutheni; 
wide	 -banzi; banzi; 
widely	ngokubanzi; 
wider	 -banzi; banzi; 
widespread	 yandile; inabile; 
wife	unkosikazi; 
wild	-asendle; 
wildlife	izilwanyana zasendle; 
will	 amandla engqondo; uya;  umyolelo;  intando; 
willing	zimisele; 
willingness	ukulungela; 
win	ukoyisa; 
wind	umoya; 
winding-up	ukusonga; 
window	ifestile; 
wine	iwayini; 
winners	abaphumeleleyo; 
winning	ukuphumelela; 
winter	ubusika; 
wisdom	ubulumko; 
wish	umnqweno; 
wishes	iminqweno; 
wishing	ukunqwena; 
with	kunye; 
withdraw	ukurhoxisa;  khupha imali; 
withdrawal	ukurhoxa; 
withdrawn	ukurhoxisa;  khupha imali; 
within	phakathi; 
without	ngaphandle; 
witness	 Ingqina; ingqina; 
witnessed	 Ingqina; ingqina; 
witnesses	 Ingqina; ingqina; 
woman	umfazi; 
women	abafazi; 
women's	eyabafazi; 
won	ukoyisa; 
wonderful	mangalisayo; 
wood	 ihlathi;  amaplanga; umthi; 
word	ilizwi; 
words	amagama; 
work	 imisebenzi yobugcisa;  ukusebenza; umsebenzi; 
worked	 imisebenzi yobugcisa;  ukusebenza; umsebenzi; 
worker	umsebenzi; 
workers	abasebenzi; 
workforce	abasebenzi xa bebonke befektri enye; 
working	ukusebenza; 
workplace	emsebenzini; 
works	 imisebenzi yobugcisa;  ukusebenza; imisebenzi; 
workshop	indawo yokusebenzela; 
workshops	indawo yokusebenzela; 
workspace	indawo yokusebenza; 
world	ihlabathi; 
world's	eyehlabathi; 
world-class	udidi lwehlabathi; 
worlds	amazwe; 
worldwide	edumileyo; 
worrying	ekhathazayo; 
worse	mandundu; 
worst	eyona imandundu; 
worth	ukuxabisa; 
worthy	thembekileyo; 
would	inga; 
wound	 ukungxwelerha; inxeba;  isilonda;  uduma; 
wounds	 ukungxwelerha; izilonda;  amanxeba;  uduma; 
write	bhala;  ukubhala; 
writer	umbhali; 
writers	ababhali; 
writers'	ezababhali; 
writing	isandla;  ukubhala; 
writings	isandla;  ukubhala; 
written	bhala;  ukubhala; 
wrong	ayilunganga; 
wrote	bhala;  ukubhala; 
xenophobia	ukubukulwa ngokobuhlanga; 
xenophobic	ubukulano ngobuhlanga; 
year	unyaka; 
year's	eyonyaka; 
year-on-year	unyaka nonyaka; 
years	iminyaka; 
yes	ewe; 
yesterday	izolo; 
yet	kanti; 
yield	vuna;  velisa; 
yields	izivuno;  zivelisa; 
you	wena; 
young	isencinane; 
younger	isencinane; 
your	eyakho; 
youth	ulutsha; 
zero	unothi; 
zone	ummandla; 
zones	imimandla; 
zoo	umzi wezilwanyana; 
