Act of Parliament	Mulayo wa Phalamennde
Africa Institute of South Africa	Africa Institute of South Africa
African American	African American
African Christian Democratic Party	Ḽihoro ḽa  African Christian Democratic
African Cup of Nations	Tshiphuga tsha Mashango a Afrika
African Development Bank	Bannga Ya Mveledziso ya Afrika Tshipembe
African Diaspora	Khasekano ya Afurika
African Economic Community	Tshitshavha tsha Ikonomi ya Afrika
African National Congress Youth League	Ḽigi ya Vhaswa ya African National Congress
African Union	African Union
African country	Shango ḽa Afrika
African language	Luambo lwa Afurika
African nationalist	Muafurika
African people	Vhaafurika
African renaissance	Mvusuludzo ya Afrika
African state	Shango ḽa Afrika
African wild cat	Tshimange tsha ḓaka; goya
Agricultural Research Council	Khoroṱhoḓisisi ya zwa Vhulimivhufuwi
Ambassador of	Muambasada wa
Arts and Culture Trust	Thirasiti ya Vhutsila na Mvelele
Bantu Authorities Act	Mulayo wa Muvhuso wa Vharema
Basic Conditions of Employment Act	Mikano ya Mutheo wa Milayo wa Vhashumi
Black Economic Empowerment	Maanḓafhadza Ekonomi ya Vharema 
Board of Directors	Bodo ya Vhalangi
Broad-based Black Economic Empowerment Act	Broad-based Black Economic Empowerment Act
Bureau of Heraldry	Bureau of Heraldry
Call of South Africa	Khuwelelo ya Afurika
Central Energy Fund	Tshikwama tsha Fulufulu tsha Vhukati
Chamber of Mines	Dzangano ḽa Vhatholi kha zwa Migodi; Dzangano ḽa Vhatholi kha nḓowetshumo ya zwa Migodi
Chief Executive Officer	Muofisiri Mulangi Muhulwane
Chief Justice	Muhaṱuli muhulwane
Christian Democratic Party	Christian Democratic Party
Civil Rights Movement	Dzangano ḽa Pfanelo dza Vhadzuli
Coat of Arms	Tshiphugaṱhalu
Commission for Conciliation, Mediation and Arbitration	Khomishini ya Vhupfumedzani, Vhukonanyi, na Vhulamukanyi
Commission for the Promotion and Protection of the Rights of Cultural, Religious	Khomishini ya Ṱhuṱhuwedzo na Tsireledzo ya Pfanelo dza Mvelele na Vhurereli
Commission for the Promotion and Protection of the Rights of Cultural, Religious and Linguistic Communities	Khomishini ya Ṱhuṱhuwedzo, Tsireledzo, Pfanelo dza Mvelele, Vhurereli na Nyambo dza Vhapo
Commission on Gender Equality	Khomishini ya Ndinganyiso nga Mbeu
Commission on Restitution of Land Rights	Khomishini ya Mbuedzedzo ya Pfanelo dza Mavu
Commonwealth of Independent States	Mulanganelo wa Mashango o ḓiimisaho nga oṱhe
Congress of Democrats	Congress of Democrats
Constitution of the Republic of South Africa	Ndayotewa ya Riphabuḽiki ya Afrika Tshipembe
Constitutional Assembly	Buthano ḽa Vhukhethoni
Constitutional Court	Khothe ya Ndayotewa
Council for Scientific and Industrial Research	Khoro ya Ṱhoḓisiso ya zwa Saintsi na zwa Nḓowetshumo
Council of Ministers	Khoro ya Dziminisiṱa
Council of Provinces	Khoro ya Mavundu
Council of Traditional Leaders	Khoro ya Vharangaphanḓa vha sialala
Cradle of Humankind	Cradle of Humankind
Criminal Procedure Act	Criminal Procedure Act
Customs and Excise	mithelo ya nnḓa na ya nga ngomu shangoni
Day of the Covenant	ḓuvha ḽa Mulanga
Democratic Alliance	Democratic Alliance
Democratic Party	Ḽihoro ḽa Democratic 
Department of Agriculture	Muhasho wa vhulimi
Department of Arts and Culture	Muhasho wa Vhutsila na Mvelele
Department of Communications	Muhasho wa Vhudavhidzani
Department of Correctional Services	Muhasho wa Tshumelo dza Ndulamiso
Department of Defence	Muhasho wa Vhupileli
Department of Education	Muhasho wa Pfunzo
Department of Environmental Affairs and Tourism	Muhasho wa zwa Mupo na Vhuendelamashango
Department of Finance	Muhasho wa Gwama
Department of Health	Muhasho wa Mutakalo
Department of Housing	Muhasho wa zwa Dzinnḓu
Department of Justice and Constitutional Development	Muhasho wa Vhulamukanyi na Mveledziso ya Mulayotewa
Department of Labour	Muhasho wa Mishumo
Department of Land Affairs	Muhasho wa zwa Mavu
Department of National Education	Muhasho wa Pfunzo wa Lushaka
Department of Public Enterprises	Muhasho wa Mabindu a Tshitshavha
Department of Public Service and Administration	Muhasho wa Tshumelo ya tshitshavha na Ndaulo
Department of Public Works	Muhasho wa Mishumo ya Tshitshavha
Department of Science and Technology	Muhasho wa Saintsi na Thekhinoḽodzhi
Department of Social Development	Muhasho wa Mveledziso ya Matshilisano
Department of Sport and Recreation	Muhasho wa zwa Mitambo na Vhuḓimvumvusi
Department of State	Muhasho wa Muvhuso
Department of Trade and Industry	Muhasho wa Mbambadzo na Nḓowetshumo
Department of Transport	Muhasho wa Vhuendi
Department of Water Affairs	Muhasho wa zwa Maḓi
Department of Water Affairs and Forestry	Muhasho wa zwa Maḓi na Maḓaka
Deputy Speaker	Mufarisamulangadzulo
Deputy Speaker of Parliament	Mufarisamulangadzulo wa Phalamennde
Development Bank of Southern Africa	Bannga ya Mveledziso ya Tshipembe ha Afrika
Director of Public Prosecution	Mulangi wa Vhutshutshisi ha Lushaka
Director of Public Prosecutions	Mulangi wa Vhutshutshisi ha Lushaka
Dutch Reformed Church	Kereke ya Dutch
Eastern Cape	Eastern Cape
Employment Equity Act	Employment Equity Act
Environmental Impact Assessment	Tsedzuluso ya Masiandaitwa a Mupo
European Union	European Union
Executive Council	Khorotshitumbe
Financial and Fiscal Commission	Khomishini ya zwa masheleni
Fire Protection Association	Dzangano ḽa Tsireledzo ya Mulilo
First World	Mashango a vhukovhela
First World War	Ndwa ya u Thoma ya Ḽifhasi
Foundation for Creative Arts	Tshiimiswa tsha zwa Vhutsila
Free State	Free State
Free State Stadium	Siṱediamu tsha Free State
Freedom Charter	Thendelonzwiwa ya Mbofholowo
Freedom Day	Ḓuvha ḽa mbofholowo
Freedom Front	Freedom Front
Gauteng Provincial Government	Muvhuso wa Vundu ḽa Gauteng
Government of National Unity	Muvhuso wa Vhuthihi ha Lushaka
Heads of Diplomatic Missions	Ṱhoho dza Vhurumelwa ha Vhudipuḽomati
Health Professions Council of South Africa	Khoro ya Phurofesheni dza zwa Mutakalo ya Afrika Tshipembe
High Court	Khothekhaṱhululi
High Court of South Africa	Khothekhaṱhuli ya Afrika Tshipembe; Khothe Khulwane ya Afrika Tshipembe
Horn of Africa	Horn of Africa
House of Assembly	Vhusimamilayo
House of Commons	Nnḓu fhasi ya phalamende
House of Delegates	Nnḓu ya vhurumelwa
House of Lords	Nnḓu ya nṱha ya phalamennde
House of Representatives	Nnḓu ya Vhaimeli
Human Rights Commission	Khomishini ya Pfanelo dza Vhathu
Human Rights Day	Ḓuvha ḽa Pfanelo dza Vhathu
Human sciences research	Ṱhoḓisiso ya saintsi dza nga ha vhathu
Independent Electoral Commission	Khomishini ya Khetho yo Ḓiimisaho
Industrial Development Corporation	Koporasi ya Mveledziso ya Nḓowetshumo
Information Society and Development	Dzangano ḽa Mafhungo na Mveledziso
Inkatha Freedom Party	Inkatha Freedom Party
International Labour Organisation	Dzangano ḽa zwa Vhashumi ḽa Dzitshaka
International Monetary Fund	Tshikwama tsha Tshelede tsha Dzitshaka
International Olympic Committee	Komiti ya Dzioḽimpiki ya Dzitshaka
International Relations	vhushaka ha dzitshaka
International Telecommunications Union	Mbumbano ya Vhudavhidzani ya Dzitshaka
Kruger National Park	Vhugalaphukha ha Lushaka ha Kruger;Vhugalaphukha ha Lushaka ha Boulo
Labour Relations Act	Mulayo wa vhushaka ha vhashumi
Land Claims Court	Khothe ya Mbilo dza Mavu
Language Task Group	Tshigwada tsha Mushumo tsha Luambo
Leader of the House	Murangaphanḓa wa Nnḓu
Member of Parliament	MP
Minister of Education	Minisiṱa wa zwa Pfunzo
Minority Front	Minority Front
Municipal Demarcation Board	Bodo  ya zwa Mikano ya Masipala
NCOP Committee	Komiti ya NCPO
Natal Indian Congress	Natal Indian Congress
National Agricultural Marketing Council	Khoro ya Mbambadzo ya zwa Vhulimifuvhuwi ya Lushaka
National Arts Council	Khoro ya Vhutsila ya Lushaka
National Assembly	Buthano ḽa Lushaka
National Commissioner	Mukhomishinari wa Lushaka
National Council of Provinces	Khoro ya Lushaka ya Mavundu
National Council of Provinces Committee	Komiti ya Khoro ya Lushaka lwa Mavundu
National Cultural History Museum	Muziamu wa Ḓivhazwakale ya Mvelele wa Lushaka
National Environmental Management Act	Mulayo wa Lushaka wa Ndaulo ya Mupo
National Film and Video Foundation	Mutheo wa Vidio na Fiḽimu wa Lushaka
National House of Traditional Leaders	Nnḓu ya Lushaka ya Vharangaphanḓa vha Sialala
National Intelligence Agency	Zhendedzi ḽa Lushaka ḽa zwa Vhusevhi
National Marketing Council	Khoro ya Mbambadzo ya Lushaka
National Monuments Council	Khoro ya Zwieledzi ya Lushaka
National Party	National Party
National Peace Accord	Thendelo ya Mulalo ya Lushaka
National Qualifications Framework	Furemiweke ya Ndalukano dza Lushaka
National Revenue Fund	Tshikwama tsha Mbuelo tsha Lushaka
National Swimming Federation	Feḓeresheni ya u bambela ya Lushaka
National Training Board	Bodo ya Lushaka ya Vhugudisi
National Women's Day	Ḓuvha ḽa Vhafumakadzi ḽa Lushaka
National Youth Commission	Khomishini ya Vhaswa ya Lushaka
New National Party	New National Party
New Year's Day	Ḓuvha ḽa Ṅwaha Muswa
Nkosi Sikelel' iAfrika	Nkosi Sikelel' iAfrika
Nobel Peace Prize	Nobel Peace Prize
Northern Cape	Northern Cape
Orange Free State	Orange Free State
Organisation for African Unity	Organisation for African Unity
Organisation of African	Dzangano ḽa Afrika
Organisation of African Unity	Dzangano ḽa Mbumbano ya Afrika
P and L	P na L
Pan Africanist Congress of Azania	Pan Africanist Congress of Azania
Pan South African Language Board	Bodonyangaredzi ya Nyambo dza Afrika Tshipembe
People Against Gangsterism and Drugs	Vhathu vhane vha lwa na zwigwada na zwidzidzivhadzi
Perishable Products Export Control Board	Bodondanguli yaVhurumelazwivhambadzwa nnḓa Zwitete
Population Registration Act	Mulayo wa u ḓiṅwalisa ha tshitshavha
President of the Senate	Muphuresidennde wa Vhutendelwamilayo
Pretoria Art Museum	Muziamu wa zwa Vhutsila wa Pretoria
Pretoria East Cemetery	Mavhiḓani a Pretoria Vhubvaḓuvha
Prohibition of Mixed Marriages Act	Prohibition of Mixed Marriages Act
Provincial Commissioner	Mukhomishinari wa Vundu
Provincial House of Traditional Leaders	Nnḓu ya Vundu ya Vharangaphanḓa vha Sialala
Public Administration	Ndaulo ya Tshitshavha
Public Order Policing	Tshipholisa tsha vhudziki tshitshavhani
Public Protector	Mutsireledzi wa Tshitshavha
Public Service Commission	Khomishini ya Tshumelo ya Muvhuso
Reconstruction and Development Programme	Mbekanyamushumo ya u Fhaṱulula na Mveledziso
Reserve Bank	Bannga ya Vhukati
SA Library for the Blind	Ḽaiburari ya Afrika Tshipembe ya vha sa vhoni
Second World War	Nndwa ya Vhuvhili ya Ḽifhasi
Secretary to Parliament	Muṅwaleli wa Phaḽamennde
Sector Education and Training Authority	Maanḓalanga a Sekithara ya Pfunzo na Vhugudisi 
Skills Development Act	Skills Development Act
South African Bureau of Standards	Birou ya Zwilinganyo ya Afrika Tshipembe
South African Chamber of Commerce	Tshemba ya Mbambadzo ya Afurika Tshipembe
South African Communist Party	South African Communist Party
South African Constitution	Ndayotewa ya Afrika Tshipembe
South African Council of Churches	Khoro ya zwa Dzikereke ya Afurika Tshipembe
South African Defence Force	Mmbi ya Vhupileli ya Afurika Tshipembe
South African Human Rights Commission	Khomishini ya Pfanelo dza Vhathu ya Afrika Tshipembe
South African Local Government Association	Dzangano ḽa Mivhuso yapo ḽa Afrika Tshipembe
South African National Civic Organisation	Dzangano ḽa Vhadzulapo ḽa Lushaka ḽa Afrika Tshipembe
South African National Defence Force	Mmbi ya Vhupileli ya Lushaka ya Afurika Tshipembe
South African National Parks	Vhugalaphukha ha Lushaka ha Afrika Tshipembe
South African Native National Congress	South African Native National Congress
South African Police	Tshipholisa tsha Afurika Tshipembe
South African Qualifications Authority	Maanḓalanga a zwa Ndalukanyo Afurika Tshipembe
South African Reserve Bank	Bannga ya Vhukati ya Afrika Tshipembe
South African Revenue Service	Tshumelo ya Muthelo wa Mbuelo wa Afrika Tshipembe
South African Secret Service	Tshumelo ya zwa Vhusevhi Afurika Tshipembe
South African Sugar Association	Dzangano ḽa Swigiri ḽa Afrika Tshipembe
South African citizen	mudzulapo wa Afrika Tshipembe
South African design	Nyolo ya Afrika Tshipembe
South African tea	Tie ya Afrika Tshipembe
Southern Africa	Afurika Tshipembe
Southern African Development Community	Ṱhanganelano ya Mashango a Tshipembe ha Afrika
Southern African Large Telescope	Theḽeskoupu Khulwane ya Tshipembe ha Afrika 
Speaker of Parliament	Mulangadzulo wa Phalamennde
Speaker of the National Assembly	Mulangadzulo wa Buthano ḽa Lushaka
State Department	Muhasho wa Lushaka
State President	Muphuresidennde wa Lushaka
Statistics South Africa	Statistics South Africa
Statistics South Africa	Vha Dzimbalombalo dza Afrika Tshipembe
Supreme Court	Khothekhaṱhululi
Supreme Court of Appeal	Khothe Khulwane ya Khaṱhululo
The Call of South Africa	Khuwelelo ya Afurika Tshipembe
The National Qualifications Framework	Furemiweke ya Ndalukano dza Lushaka
The South African National Council for the Blind	Khoro ya Lushaka ya Afrika Tshipembe ya vha sa Vhoni
Tropic of Capricorn	Ṱiropika ya Ngululu
Truth and Reconciliation Commission	Khomishini ya Vhungoho na Vhupfumedzani
UN Security Council	Khoro ya Tsireledzo ya UN
Union of South Africa	Mbumbano ya Afrika Tshipembe
United Christian Democratic Party	United Christian Democratic Party
United Democratic Front	United Democratic Front
United Democratic Movement	United Democratic Movement
United Nations	Yuno
Universal Declaration of Human Rights	Pfano ya Ḽifhasi ya Pfanelo dza Vhathu
Water Research Commission	Khomishini ya Ṱhoḓisiso ya Maḓi
West Bank	West Bank
Western Cape	Western Cape
Willem Prinsloo Agricultural Museum	Muziamu wa zwa Vhulimivhufuwi wa Willem Prinsloo
World Health Organisation	Dzangano ḽa Mutakalo ḽa Ḽifhasi
World Heritage Site	Fhethu ha Vhufa ha Ḽifhasi
World Trade Organisation	Dzangano ḽa Mbambadzo ḽa Ḽifhasi
World War I	Nndwa ya Ḽifhasi ya I
World Wildlife Fund	World Wildlife Fund
abuse of power	shumisa maanḓa luvhi
academic freedom	mbofholowo ya akademiki
account for	vhuḓifhinduleli nga nṱhani ha
account to	vhuḓifhinduleli nga
accountable for	vha na vhuḓifhinduleli
accounting officer	muofisiri o hweswaho
acid mine drainage	muelelo wa esidi ya mugodini
act of parliament	mulayo wa phalamennde
act of state	mishumo ya muvhuso
ad hoc	adihoko
administration of justice	matshimbidzele a zwa vhulamukanyi; ndaulo ya vhulamukanyi
administrative action	maga a ndaulo
administrative function	mishumo ya ndaulo
administrative powers	Maanḓa a ndaulo
advancement of technology	khwiniso ya thekhinoḽodzhi; mvelaphanḓa ya thekhinoḽodzhi
advisory body	tshiimiswangeletshedzi
affirmative action	ndinganyiso
against the law	hanedzana na mulayo; fhambana na mulayo; lwaho na mulayo
agent of change	muḓisatshanduko
air traffic	vhuendi ha muyani
air traffic control	ndango ya vhuendi ha muyani
all rights reserved	pfanelo dzoṱhe dzo tsireledzwa;
all the time	tshifhinga tshoṱhe
annual financial statement	tshitatamennde tsha masheleni tsha ṅwaha nga ṅwaha
annual general meeting	muṱanganonyangaredzi wa ṅwaha nga ṅwaha
annual report	muvhigo wa ṅwaha nga ṅwaha
appoint the cabinet	u thola khabinethe
appropriate technology	thekhonoḽodzhi yo teaho
area of interest	sia ḽa dzangalelo
area of jurisdiction	vhupo vhulaulwa
area of responsibility	sia ḽa vhuḓifhinduleli
armed struggle	nndwa dza zwigwada
arts and crafts	mishumo ya zwanḓa
arts and culture	vhutsila na mvelele
as amended	sa zwo khwiniswaho
as far as possible	nga hune zwa konadzea
as many as	vhunzhi nga hune
as soon as possible	nga u ṱavhanya
assumption of duty	thoma mushumo
at a meeting	muṱanganoni
at the age of	kha miṅwaha ya; miṅwaha ya
attainment of independence	wanambofholowo
attend a meeting	dzhenela muṱangano
basic needs	ṱhoḓea dza mutheo
basic rights	pfanelo dza mutheo
bear witness to	vha ṱhanzi ya
bed and breakfast	vhulalo na vhuragane
bilateral relations	vhushaka ha thengiselano
bill of rights	mulayotibe wa pfanelo
black power movement	dzangano ḽa maanḓa ḽa vharema
board of directors	bodo ya vhalangi
board of trustees	bodo ya thirasithii
body of water	maḓi manzhi o kuvhanganaho fhethu huthihi
border post	mukanoni
bottom line	tshithu tshihulwane
box office returns	mbuelo dza thengiso ya thikhithi; mbuelo dza ofisi ya u rengisa thikhithi
branches of government	mihasho ya muvhuso
budget process	maitele a mugaganyagwama
budget vote	voutu ya mugaganyagwama
build a part	fhaṱa tshipiḓa; vhumba tshipiḓa
bunch of grapes	tshidzhumba tsha nḓirivhe
bus rapid transit	sisiṱeme ya vhuendi ha nnyi na nnyi nga bisi
business community	vhubindudzi ha tshitshavha
business of parliament	mushumo wa phaḽamennde
business sector	sekithara ya vhubindudzi
by means of	nga nḓila ya
by the authorities	nga vha ndaulo; nga vha maanḓalanga
by virtue of	ngauri; nga mulandu wa
by way of	nga; nga nḓila ya
by word of mouth	nga u tou amba; nga mavharivhari
call centre operator	mushumeli wa vhuṱanganedza ṱhingo
call centre operator	mushumi wa call center;mushumi wa senthara ya vhuṱanganedza ṱhingo
call for nominations	khuwelelo ya u nanga
call for nominations	khuwelelo ya u ta; khuwelelo ya u nanga
capacity building	fhaṱa vhukoni
capital city	musanda
central government	muvhuso wa vhukati
certify a bill	khwaṱhisedza mulayotibe
chamber of commerce	dzangano ḽa zwa makwevho; dzangano ḽa zwa mbambadzo
change of address	tshanduko ya ḓiresi
change of course	 sudzuluwa;  shandukisa sia ḽe wa livha
changes over time	tshanduko nga murahu ha tshifhinga
changing society	shandukisa tshitshavha
checks and balances	sisiṱeme ya u khwinisa
chief executive	mulanguli muhulwane
chief whip	tshimebitshihulwane
child abuse	tambudza ṅwana
child rearing practices	maitele a u lela ṅwana; maitele a u ṱhogomela ṅwana; maitele a u alusa ṅwana; maitele a u dededza ṅwana; maitele a u londola ṅwana
children of Africa	vhana vha Afurika
city centre	tshivhindini tsha ḓorobo; vhukati ha ḓorobo
civil rights	pfanelo dza vhadzulapo
civil service	mushumo wa muvhuso
civil society	vhadzulapo
civil war	nndwa nga tshavho
coat of arms	tshigat2halu
code of conduct	milayo ya vhuḓifari
collection of data	u kuvhanganya data
collective responsibility	vhuḓifhinduleli ha vhoṱhe
colonial power	maanḓa a vhukoḽoni
colonial rule	muvhuso wa vhukoḽoni
come into force	thoma u shuma
come to the point	 swika kha zwa ndeme;  swika kha tshipiḓa tsha ndeme
committee meeting	muṱangano wa komiti
common interest	dzangalelo ḽithihi
community broadcasting service	tshumelo ya khasho ya vhadzulapo
community building	fhaṱa tshithavha
community development	mveledziso ya tshitshavha
community health centre	Senthara ya Mutakalo ya Tshitshavha
community involvement	dzhenelela ha tshitshavha
community participation	shela mulenzhe ha tshitshavha
community police forum	foramu ya tshipholisa ya  tshitshavha
community service	tshumelo ya tshitshavha
conclude an agreement	fhedza pfano; fhedza thendelano; phetha thendelano; phetha pfano
conditions of contract	milayo ya thendelano
conditions of service	milayo ya mashumele
conflict of interest	khuḓano ya dzangalelo
conflict prevention	thivhela khuḓano
conflict resolution	thasululo ya khuḓano
constitutional democracy	ndayotewa ya demokhirasi
constitutional mandate	ndayotewa ya
constitutional state	ndayotewa ya muvhuso
contempt of parliament	u nyadza phalamennde
convene a meeting	ramba muṱangano
cooperation agreement	thendelano ya tshumisano
course of action	maitele ane a fanela u tevhedzwa; zwine zwa fanela u itwa; zwine zwa fanela u tevhedzwa
cultural change	tshanduko ya mvelelo
cultural community	mvelele ya tshitshavha
cultural diversity	phambano ya mvelele
cultural goods	vhuḓi ha mvelele
cultural heritage	vhufa ha mvelele
cultural revolution	tshanduko ya mvelelo
culture of human rights	pfanelo dza vhathu dza mvelele
current affairs	zwino khou bvelela zwino
customary law	mulayo wa khasiṱamari
customs and excise	mithelo ya nnḓa na ya nga ngomu shangoni
cutting edge	rangaho phanḓa
data collection	kuvhanganya data
date of birth	ḓuvha ḽa mabebo; datumu ya mabebo
decent living	vhutshilo ha khwine
deciduous fruit industry	nḓowetshumo ya mitshelo ya tshipala
defence force	mmbi ya vhupileli
degree of freedom	tshiimo tsha mbofholowo
delegated legislation	theo ya mulayo ya vhurumelwa
demand and supply	ṱhoḓea na nḓisedzo
democratic culture	mvelele ya demokhirasi
democratic election	khetho dza demokhirasi
democratic political order	vhudziki ha polotiki ya demokhirasi
democratic principle	milayo ya demokhirasi
democratic society	tshitshavha tsha demokhirasi
democratic state	muvhuso wa demokhirasi
democratic transformation	tshanduko ya demokhirasi
democratic values	ndeme dza demokhirasi
deputy minister	mufarisaminisiṱa
deputy president	mufarisaphuresidennde
dereliction of duty	 sa londa vhuḓifhinduleli;  litshedzela vhuḓifhinduleli
developing country	mashango ane a kha ḓibvelela
development initiatives	mveledziso ya u thoma zwithu
development process	maitele a mveledziso
development programme	mbekanyamushumo dza mveledziso
development strategy	siṱirathedzhi tsha mveledziso
diplomatic corps	khoro ya vhadipuḽomati
diplomatic relations	vhushaka ha vhudipuḽomati
direct support	thikhedzothwii
director general	mulangimuhulwane
disaster management	ndangulo ya zwiwo
disciplinary action	maga a ndaṱiso
discussion document	ḽiṅwalo ḽine ḽa khou rerwa nga haḽo
dispossession of land	bviswa kha mavu
distribution capacity	vhukoni ha nḓisedzo
distribution of resources	nyavhelo ya zwishumiswa
distribution of wealth	nyavhelo ya lupfumo
district municipality	masipala wa tshiṱiriki
diverse society	tshitshavha tsho fhambanaho
diversity of people	vhathu vho fhambanaho
divide and rule	maitele a u fhandekanya
domain name authority	ndaulo ya u kovha;phaḓaladza domeini
down for discussion	zwine zwa khou ya u reriwa
draft bill	mvetomveto ya mulayotibe
draft legislation	mvetomveto ya mulayotibe
early warning	ṱavhanya u kaidza
early warning system	sisiṱeme ya u eletshedza hu tshe na tshifhinga
early warning system	sisiṱeme ya u kaidza hu tshe na tshifhinga
early warning system	sisiṱeme ya u sevha hu tshe na tshifhinga
ease of access	swikelea
economic empowerment	maanḓafhadza ikonomi
economic growth	nyaluwo ya ikonomi
economic impact	ṱhuṱhuwedzo ya ikonomi
economic relations	vhushaka ha zwa ikonomi
economic sector	sekithara ya zwa ikonomi
economic strength	maanḓa a zwa ikonomi
effective public service	tshumelo ya muvhuso yo khwaṱhaho
election period	tshifhinga tsha khetho
election process	kutshimbidzele kwa khetho
election results	mvelelo dza khetho
enabling environment	maanḓafhadza vhupo
entitled to vote	fanelwa nga u voutha; fanelwa nga u khetha; tendelwa u khetha; tendelwa u voutha
environmental impact	ṱhuṱhuwedzo ya vhupo
environmental impact assessment	tsedzuluso ya masiandaitwa kha vhupo
equal opportunities	zwikhala zwi linganaho
equality before the law	lingana phanḓa ha mulayo
every three years	miṅwaha miraru miṅwe na miṅwe
executive action	maga a ndaṱiso nga khorondangi
executive authority	Khorotshitumbe
executive organs of state	khorotshitumbe ya mihasho ya muvhuso
explanatory memorandum	memorandamu wa ṱhalutshedzo
fair election	khetho dzo vhofholowaho
fall in love	u funa
fauna and flora	zwipuka na zwimela
field of study	sia ḽa ngudo
fill a vacancy	thivha tshikhala; ḓadza tshikhala
financial year	ṅwaha wa muvhalelano
first past the post	muwini nga voutu nnzhisa
fiscal discipline	ndaṱiso ya zwa masheleni
floor of the House	lufhera lwa nnḓu
follow up	ya phanḓa
food security	tsireledzo ya zwiḽiwa
forced labour	kombetshedza u shuma
fore and aft	phanḓa ha na nga murahu ha
fore and after	phanḓa ha na nga murahu ha
foreign direct investment	bindudza na maṅwe mashango
foreign exchange	tshelede ya maṅwe mashango
foreign policy	mbekanyamaitele ya
free and fair election	khetho dzo vhofholowaho
free of charge	mahala; nga fhedzi
free society	tshitshavha tsho vhofholowaho
freedom fighter	mulwelambofholowo
freedom of association	pfanelo ya vhuḓibaḓekanyi
freedom of conscience	mbofholowo ya u tevhedza luvalo lwa muthu
freedom of expression	mbofholowo ya u amba; tendelwa u amba
freedom of movement	mbofholowo ya mupfuluwo
freedom of religion	mbofholowo ya zwa vhurereli
freedom of speech	mbofholowo ya u amba
freedom of the press	mbofholowo ya nyanḓadzamafhungo
from the front	thoma phanḓa; bva phanḓa
full supply level	tshiimo tsha nḓisedzo tsho fhelelaho
functional area	vhupo ha u shumela
fundamental human rights	pfanelo dza vhathu dza mutheo
fundamental rights	pfanelo dza mutheo
future research	ṱhoḓisiso dzi ḓaho
gender equality	ndinganyiso nga mbeu
gender inequality	sa lingana nga mbeu
gender violence	khakhathi nga mbeu
general election	khethoguṱe
get away with	ponya; ponyoka
give evidence	ṋea vhuṱanzi
global development	mveledziso ya dzhango
global economy	ikonomi ya dzhango
global village	Ḽifhasi ḽa vhuṱumani
go on for	livha; pika; yela
goods and services	thundu na tshumelo
governing party	ḽihoro ḽivhusi
government action	maga a muvhuso
government authority	maanḓalanga a muvhuso
government by the people	muvhuso wa vhathu
government department	mihasho ya muvhuso
government funding	ndambedzo ya muvhuso
government level	ḽeveḽe ya muvhuso
government of the day	muvhuso une wa khou vhusa
government policy	mbekanyamaitele ya muvhuso
government sector	sekithara ya muvhuso
government services	tshumelo dza muvhuso
governmental organisation	tshiimiswa tsha muvhuso
grassroots level	vhathu zwavho
gross domestic product	zwibveledzwa zwoṱhe zwa shango
guard of honour	mufolo
guilty of contempt	mulandu a u nyadza
half a million	hafu ya miḽiyoni
have a vote	vha na vouthu; kona u khetha
head of government	ṱhoho ya muhasho
head of office	muhulwane wa ofisi
head of state	ṱhoho ya shango
health care	ndondolo ya mutakalo
hierarchy of authority	ḽeveḽe ya maanḓa langa
historically disadvantaged	vhe kale vhavha vho siwa nnḓa
hold a meeting	vha na muṱangano; fara muṱangano
hold office	vha  ofisini
honorary citizenship	tshidzulapo tsha khuliso
honours and awards	pfufho na khuliso
host country	shango ḽo ḓelwaho
host nation	lushaka lwo ḓelwaho
house of assembly	vhusimamilayo
houses of parliament	nnḓu dza phalamennde
human development	mveledziso ya muthu
human dignity	tshirunzi tsha muthu
human nature	mvelo ya muthu
human race	murafho wa muthu
human resource	mushumi
human resource development	mveledziso ya vhashumi
human rights	pfanelo dza vhathu
human rights abuse	u shumiswa ha pfanelo dza vhathu nga nḓila i si yone
human rights activist	mulwela pfanelo dza vhathu
human rights violation	 pfukwa ha pfanelo dza vhathu
human security	tsireledzo ya muthu
imbalances of the past	sa lingana ha tshifhinga tsho fhelaho
immediate past president	muphuresidennde ane a kha ḓi bva u vhusa
in accordance with	zwi tshi elana na
in accordance with the rules	zwi tshi elana  na milayo
in addition to	nga nṱha ha
in an acting capacity	nga u vha mufareli; nga tshiimo tsha u tou farela
in any way	nga iṅwe nḓila
in case of	malugana na
in celebration of	hu tshi khou pembelelwa
in compliance with	hu tshi tevhedzwa
in connection with	malugana na
in consultation with	nga vhukwamani na
in excess of	zwinzhisa; zwo ḓalesaho; zwi fhiraho
in favour of	takalela; nga u takalela
in front of	phanḓa ha
in good faith	nga u fulfhedzea
in office	ofisini
in so far	nga hune
in spite of	naho zwo ralo
in support of	hu tshi tikedzwa
in terms of	zwi tshi ya nga
in the balance	siiwa muyani; siiwa tshikhalani
in the course of	musi hu tshi khou bvelela
in the evening	nga madekwana
in the event of	musi hu tshi
in the field of	kha sia ḽa
in the gap	ḓiambulula
in the interim	tshifhingakati
in the interim	zwa zwino; nga tshifhinga tsha zwino; tshifhinga tsha u lindela
in the lead	rangaho phanḓa
in the long term	nga murahu ha tshifhinga tshilapfu
in the majority	vhunzhi ha; nga vhunzhi
in the morning	nga matsheloni
in the name of	nga dzina ḽa
in the picture	kha tshifanyiso
in the region of	kha dzingu ḽa
in the white	kha zwitshena; wa zwitshena
inaugural address	tshipitshi tsha vhurangaphanḓa
inaugural meeting	muṱangano wa vhurangaphanḓa
income tax	muthelo wa mbuelo
indigenous culture	mvelele ya vhongwaniwapo
indigenous language	luambo lwa vhogwaniwapo
indigenous people	vhongwaniwapo
industrial society	ḽifhasi ḽa thekhinoḽodzhi
infant mortality rate	phimo ya mpfu dza vhushie
information retrieval	wana mafhungo u bva kha data
information retrieval system	sisiṱeme ya u wana mafhungo murahu
inner city	tshivhindini tsha ḓorobo;vhukati ha ḓorobo
inspector of mines	muingameli wa migodi
inspector of mines	sipikiṱere wa migodi
intellectual property rights	pfanelo dza
intergovernmental relations	vhushaka ha mivhusoḽedzani
interim constitution	ndayotewa ya tshifhinganyana
international affairs	mafhungo a zwa dzitshaka
international community	tshitshavha tsha dzitshaka
international humanitarian law	mulayo wa dzitshaka wa vhuthu
international olympic committee	komiti ya dzioḽimpiki ya dzitshaka
international relations	vhushaka ha dzitshaka
interrupt the proceedings	thithisa matshimbidzele
investment of capital	bindudza khephithaḽa
job creation	sika mishumo
joint committee	komitiṱhanganelo
joint meeting	muṱangano wo ṱanganelaho
joint responsibility	vhuḓifhinduleli ho ṱanganelaho
joint rules committee	komiti ya milayo yo ṱanganelaho
joint sitting	dzulo ḽo ṱanganelaho
judicial authority	maanḓalanga a mulayo
keep in mind	humbula; elelwa
keep up to date	khwinisa; dzudza zwi ngonani
key performance area	masia a kushumele  a ndeme
labour force	vhashumi
labour intensive	mushumo
labour market	mishumoni
lack of energy	shaya mafulufulu
land ownership	vhuṋe ha mavu
land reform	mvusuluso ya mavu
land restitution	mbuedzedzo ya mavu
land rights	pfanelo dza mavu
language policy	mbekanyamaitele ya luambo
language practice	nḓowedzo ya luambo
language rights	pfanelo dza luambo
law enforcement	tevhedza mulayo
lay a charge	vhiga mulandu
leader of the opposition	murangaphanḓa wa ḽihoro ḽi hanedzi
learning process	maitele a u guda
least of all	na khathihi
legal deposit library	ḽaiburari ya u vhulunga maṅwalo a ndeme
legislative authority	maanḓalanga a vhusimamulayo
legislative function	kushumele kwa mulayo
legislative power	maanḓa a mulayo
legislative powers	maanḓa a mulayo
legislative process	kutshimbidzele kwa mulayo
level of government	ḽeveḽe ya muvhuso
level of service	tshiimo tsha tshumelo
levels of development	zwiimo zwa mvelaphanḓa
liberation movement	dzangano ḽa mbofholowo
liberation struggle	nndwa ya mbofholowo
limited access	swikelelwa nga vha sivhanzhi
lingua franca	luambo lwa vhubindudzi
list of members	mutevhe wa miraḓo
local government	muvhuso wapo
local government level	ḽeveḽe ya muvhuso wapo
local government sector	sekithara ya muvhuso
local municipality	masipala wapo
local sphere of government	masia a muvhuso wapo
mainstream economy	ikonomi ya vhathu vhoṱhe
majority of votes	vhunzhi ha dzivouthu
majority party	ḽihoro ḽa vhanzhi
make a mark	swikelela mvelaphanḓa
make a statement	 ṋetshedza muhumbulo
make an effort	-fungelela
management review	tsedzuluso hafhu nga ndangulo
manner of speaking	kuambele; maambele; nḓila ya u amba
marine living resources	zwiko zwa lwanzheni
market economy	sisiṱeme ya ikonomi
mass mobilisation	kuvhanganya gogo
master of ceremonies	mutshimbidzamushumo
matter of public importance	zwithu zwa tshitshavha zwa ndeme
matter of urgency	zwa shishi; zwa tshihaḓu
means of communication	nḓila ya vhudavhidzani
means of transport	nḓila ya vhuendi; nḓila ya u endedza
member of parliament	muraḓo wa phalamennde
member of the council	muraḓo wa khoro
member states of the UN	vhuraḓo ha mashango a UN
memorandum of understanding	 memorandamu wa thendelano
metropolitan area	vhupo ha ḓorobo khulwane
middle class	vhuiimo ha vhukati
minority domination	tshigwada tshiṱuku
minority party	dzangano ḽiṱuku
minutes of proceedings	maambiwa a dzulo
mode of operation	mashumele; nḓila ya kushumele
moment in time	tshifhinga tsha ndeme
money laundering	ngalangadza vhuṱala ha tshelede
months of the year	miṅwedzi ya ṅwaha
mortality rate	phimo ya mpfu
mother tongue	luambo lwa ḓamuni
motion of no confidence	ḽikumedzwa ḽa tshayavhufulufheli
multicultural society	tshitshavha tsha mvelele nnzhi
music rights organisation	dzangano ḽa pfanelo dza muzika
mutual understanding	pfesesana
mutually exclusive	sa konadzea zwoṱhe
national affairs	mafhungo a lushaka
national anthem	luimbo lwa lushaka
national asset	ndaka ya lushaka
national budget	mugaganyagwama wa lushaka
national coat of arms	tshiphugaṱhalu tsha lushaka
national conference	khuvhangano ya lushaka
national department	muhasho wa lushaka
national development	mveledziso ya lushaka
national economy	ikonomi ya lushaka
national education	pfunzo ya lushaka
national executive	ndangulo ya nṱha ya lushaka
national executive authority	maanḓalanga a ndangulo ya nṱha ya lushaka
national executive committee	khoritshitumbe ya lushaka
national flag	fulaga ya lushaka
national government	 muvhuso wa lushaka
national identity	tsumbavhuṋe ya lushaka
national interest	dzangalelo ḽa lushaka
national leader	murangaphanḓa wa lushaka
national level	vhuimo ha lushaka
national level of government	vhuimo ha lushaka ha muvhuso
national policy	mbekanyamaitele ya lushaka
national pride	khuliso ya lushaka
national reconciliation	vhupfumedzanyi ha lushaka
national security	tsireledzo ya lushaka
national sphere of government	sia ḽa muvhuso wa lushaka
national strategy	tshiṱirathedzi tsha lushaka
national symbols	zwiga zwa lushaka
national unity	vhuthihi ha lushaka; pfano ya lushaka
natural justice	maitele na tsheokwazwo
natural resources	zwiko zwa mupo
need to know	ṱoḓa u ḓivha
new dispensation	nḓisedzo ntswa
not later than	hu sa athu fhira 
notice of motion	nḓivhadzo ya ḽikumedzwa
number of children	tshivhalo tsha vhana
number of deaths	tshivhalo tsha dzimpfu
oath of office	muano wa ofisi
of paramount importance	zwa ndeme
office bearer	vha re ofisini
official language	luambo lwa tshiofisi
official residence	vhudzulo ha tshiofisi
on the defence	vhaimeli
on the defence	vhulamuleli
on the market	tshi no khou rengiswa; tshi re na bvumo ḽivhuya
on the market	tshi no takaleleswa
on the market	tshi re maragani
on the market	tshino khou ṱoḓeswa
on the run	shavha; dzhenela mbambe
on the second	kha ṱhoho
on the wing	kha lufhafha; nga thungo
on top of	nṱha ha
open society	tshitshavha tsho vhofholowaho
opening address	mvulatswinga
order of merit	mufhirano
order of preference	thevhekano ya kutakalele
order of the day	ndaela ya ḓuvha; maitele a ḓuvha
ordinary session	dzulo zwaḽo
organs of state	khethekanyo dza muvhuso
orphans and vulnerable children	tsiwana na vhana vha songo tsireledzeaho
out of control	bva nnḓa ha ndango
out of date	zwa kale;  vha zwa tshikale
out of order	u bva nnḓa ha nḓila
out of print	sa tsha wanala
out of service	sa tsha shuma
out of stock	sa wanala kha tshiṱoko
outbreak of war	thoma ha nndwa
ownership of land	vhuṋe ha mavu
paradigm shift	tshanduko ya ndeme
parliament is in session	phalamennde yo dzula
parliamentary committee	komiti ya phalamennde
parliamentary correspondent	muisedzi wa phalamennde
parliamentary democracy	demokhirasi ya phalamennde
parliamentary process	kutshimbidzele kwa phalamennde
participate in the debate	dzhenela dibeithi; shela mulenzhe kha khanedzano; dzhenela khanedzano
participate in the debate	shela mulenzhe kha dibeiti
participatory democracy	demokirasi nga u shela mulenzhe
party discipline	thikhedzo nga miraḓo ya ḽihoro
party system	sisiṱeme ya ḽihoro
pass laws	milayo ya u thivhela vharema
pave the way	vula nḓila
peaceful coexistence	muṱaṱisano u sina khakhathi
peaceful demonstration	misumbedzo yo fholaho
peaceful transition	tshanduko I sina khakhathi
per capita	nga muthu
performing arts council	khoro ya vhutsila ha
pillar of strength	mutikedzi; mutiki
pilot project	thandela ya ndingedzo
place of safety	fhethu ha tsireledzo
platinum group metals	methala ya tshigwada tsha pulatinamu
platinum group metals	mitale ya tshigwada tsha puḽatinamu
play the lead	rangaphanḓa
playing field	mudavhi
point of contact	mukonanyi
point of view	kuvhonele
police service	tshumelo ya tshipholisa
policy development	mveledziso ya mbekanyamaitele
policy environment	vhupo ha mbekanyamaitele
policy formulation	bveledza mbekanyamaitele
policy framework	furemiweke ya mbekanyamaitele
policy implementation	shumisa mbekanyamaitele
policy making	vhusimambekanyamaitele
policy statement	tshitatamennde tsha mbekanyamaitele
political context	nyimele ya polotiki
political control	ndango ya polotiko
political development	mveledziso ya polotiki
political dispensation	sisiṱeme i langulaho shango
political environment	vhupo ha polotiki
political instability	khakhathi dza polotiki
political leadership	vhurangaphanḓa ha polotiki
political order	vhudziki ha polotiki 
political party	ḽihoro ḽa polotiki
political process	kutshimbidzele kwa polotiki
political rights	pfanelo dza polotiki
political system	sisiṱeme ya polotiki
political tradition	maitele a polotiki
poor living conditions	nyimele dza vhutshilo dzi si dzavhuḓi; kutshilele ku si kwavhuḓi
poorest of the poor	mushai wa vhashai
popular culture	mvelele yo ḓoweleaho
popular participation	shela mulenzhe ho ḓoweleaho
popular sovereignty	vhuḓivhusitshoṱhe ho ḓoweleaho
population register	ridzhisiṱara ya u ṅwalisa vhathu
population size	vhuhulu ha vhathu
portfolio committee	komiti ya phothifoḽio 
powers and functions	maanḓa na mishumo
powers that be	maanḓa
practical reality	ngoho i re khagala
praise singer	muimbi wa u renda
precincts of parliament	vhupo ha phaḽamennde
presiding officer	mutshimbidzi
press freedom	mbofholowo ya vhoramafhungo
private sector	sekithara ya phuraivethe
professional ethics	vhuḓifari ha phurofeshinaḽa
professional organisation	tshiimiswa tsha phurofeshinaḽa
prophets of doom	vhalavhelela zwi si zwavhuḓi
prophets of doom	vhalavhelela zwivhi
proportional representation	vhuimeleli ho linganaho
provincial administration	ndaulo ya vundu
provincial budget	mugaganyagwama wa vundu
provincial government	muvhuso wa vundu
provincial legislature	vhusimamilayo ha vundu
provincial level	kha vundu
provincial sphere of government	sia ḽa muvhuso wa vundu
provision of services	nḓisedzo ya tshumelo
public administration	ndaulo ya nnyi na nnyi
public domain	fhethu ha nnyi na nnyi
public expenditure	zwibviswa zwa nnyi na nnyi
public funds	tshikwama tsha nnyi na nnyi
public health	mutakalo wa nnyi nannyi
public hearing	vhupfiwa nga vhathu
public interest	madzangalelo a nnyi na nnyi
public meeting	miṱangano ya nnyi na nnyi
public money	masheleni a nnyi na nnyi
public office	ofisi ya nnyi na nnyi
public opinion	vhupfiwa ha nnyi na nnyi
public participation	dzhenela ha tshitshavha
public policy	mbekanyamaitele ya nnyi na nnyi
public relations officer	muofisiri wa vhushaka ha vhadzulapo
public sector	sekithara ya nnyi na nnyi
public service	tshumelo ya muvhuso
public services	tshumelo dza muvhuso
public transport system	sisiṱeme ya vhuendi ha nnyi na nnyi
public works	mishumo ya vhathu
public works programme	mbekanyamushumo ya mishumo ya muvhuso
pumped storage scheme	sisiṱeme ya u bveledza muḓagasi wa maḓi
put a motion	ṋetshedza ḽikumedzwa; swikisa ḽikumedzwa
put in writing	nga u tou ṅwala; zwo tou ṅwaliwaho
quality of life	tshiimo tsha vhutshilo
question paper	mbammbiri ḽa mbudziso
quota system	tshikalo tsho vhewaho nga mulayo
race relations	vhushaka ha lushaka
racial equality	ndinganyiso nga lushaka
racial segregation	khethano nga lushaka
rainbow nation	lushaka lwa musengavhadzimu
range of vision	kuvhonele kwo fhambanaho; mabono o fhambanaho
rapid transit system	sisiṱeme ya vhuendi ha nnyi na nnyi
redistribution of land	kovhela hafhu mavu
reference book	bugundaula
regional integration	ṱhanganelo ya dzingu
register of members	ridzhisiṱara ya miraḓo
removal from office	bviswa ofisini
remuneration package	phakhedzhi ya mbadelo
required to carry	zwi ṱoḓeaho u zwi hwala; zwi tendelwaho u zwi hwala; zwi ṱoḓeaho u zwi fara; zwi tendelwaho u zwi fara
reside in	dzula
residence permit	phemithi ya vhudzulo
resistance movement	hana u pfuluwa
resistance to change	hana tshanduko; lamba tshanduko
resolution of conflict	thandululo ya khuḓano
resource base	ḓisendeka nga
responsible for	vhuḓifhinduleli kha
restitution of land	mbuedzedzo ya mavu
restitution of land rights	pfanelo ya mbuedzedzo yamavu
return on investment	mbuelo dza vhubindudzi
right of access	pfanelo ya tswikelo
right to assemble	pfanelo ya
right to human dignity	pfanelo ya
right to life	pfanelo ya u tshila
right to privacy	pfanelo ya tshidzume
right to strike	pfanelo ya u ṱereka
right to vote	pfanelo ya u voutha; pfanelo ya u khetha
rights and privileges	pfanelo
rise and fall	u bvelela na u kundelwa; u bvelela na u wa; u vuwa na u wa
rite of passage	therelo ya u pfuka murole
road network	bada ya nnyi na nnyi
road show	ṱano
rule of law	mulayondango
rules and orders	milayo na ndaela
rules of debate	milayo ya dibeithi; milayo ya khanedzano
rules of natural justice	milayo ya vhulamukanyi vhu sa dzhii sia
rules of procedure	milayo ya matshimbidzele
ruling party	ḽihoro ḽivhusi
rural development	mveledziso ya vhupo ha mahayani
school library service	tshumelo ya ḽaiburari ya tshikolo
school nutrition programme	mbekanyamushumo ya mufusho ya tshikolo
science and technology	saintsi na thekhinoḽodzhi
search and rescue	 ṱoḓa na u phulusa;  ṱoḓa na u tshidza;  ṱoḓa na u lamukisa
seat of government	tshidulo tsha muvhuso
security clearance	thendelo ya tshiofisi
security forces	mmbi dza tsireledzo
sending and receiving	 rumela na u ṱanganedza
sense of responsibility	 vhuḓifhinduleli
sense of touch	phuphuledza
separate but equal	khethekana fhedzi zwi tshi lingana
separate development	mveledziso yo khethekanaho
separation of powers	fhandekana ha maanḓa
services industry	nḓowetshumo ya tshumelo
services rendered	tshumelo dze dza ṋetshedzwa
set in motion	 ḓilugisela u takuwa
shortage of skills	ṱhahelelo ya zwikili
sitting of parliament	dzulo ḽa phalamennde
small town	ḓorobo ṱhukhu
social benefits	mbuelo dza matshilisano
social capital	netiweke ya vhashumisani
social change	tshanduko ya matshilisano
social contract	konṱiraka ya matshilisano
social control	ndango ya matshilisano
social development	mveledziso ya matshilisano
social interaction	vhudavhidzani
social justice	vhulamukanyi ha u kovhela
social movement	tshigwada tsha kuhumbulele ku fanaho
social security	tsireledzo ya matshilisano
social services	tshumelo dza zwa u tshilisana
social system	sisiṱeme ya matshilisano
social upliftment	 vhuḓilisi ha nṱha
social welfare	ndondolavhathu
socio-economic development	mveledziso ya ikonomi ya matshilisano
source of income	tshiko tsha mbuelo
source of information	tshiko tsha mafhungo
source of water	tshisima tsha maḓi
sovereign democratic state	muvhuso wa demokhirasi ya vhuḓivhusi tshoṱhe
sovereign state	muvhuso wa vhuḓivhusi tshoṱhe
sphere of government	masia a muvhuso
standard of living	tshiimo tsha kutshilele
state assets	ndaka dza muvhuso
state emblem	tshiphugaṱhalu tsha muvhuso
state institutions	zwiimiswa zwa muvhuso
state money	masheleni a muvhuso
state of emergency	tshiimo tsha shishi
state of mind	tshiimo tsha muhumbulo
state of the nation address	Tshipitshi tsha lushaka
state revenue	mbuelo ya muvhuso
status of women	tshiimo tsha vhafumakadzi
status quo	nyimele ya zwino
statute book	bugu ya milayo
strategic management	ndaulo ya u swikelela zwipikwa
structural violence	khakhathi dzo livhanaho na muthu
struggle for liberation	vhofholowa
subject for discussion	thero ya therisano
subject to the provisions of	zwi tshi ya nga mbetshelwa dza
substantive motion	ḽikumedzwa ḽo khwaṱhisedzwaho
supply and demand	nḓisedzo na ṱhoḓea
supreme law	mulayo muhulwane
sustainable development	mveledziso i sa nyeṱhi
sustainable economic growth	nyaluwo ya ikonomi i sa nyeṱhi
sworn in	aniswa
system of government	sisiṱeme ya muvhuso
systems approach	kuitele kwa u vhea zwithu zwavhuḓi
table of contents	mbekanyo ya zwi re ngomu
take account of	dzhiela nzhele; dzhiela nṱha
take advantage of	shumisa zwikhala zwi re hone
take an oath	ana
take cognisance of	dzhiele nṱha; dzhiele nzhele
take cognizance of	dzhiele nṱha; dzhiele nzhele
take into consideration	humbula; elelwa; dzhiela nzhele; dzhiela nṱha
take off	takuwa
task team	tshigwada tsho tetshelwaho mushumo
tax revenue	mbuelo ya muthelo
technical services department	muhasho wa tshumelo dza zwa thekiniki
term budget	mugaganyagwama wa theme
term of office	tshifhinga tsha u shuma
terms and conditions	milayo
terms of reference	tsumbanḓila dza kushumele
terms of trade	milayo ya mbambadzo
the Cold War	Nndwa ya maṱo
the East	vhubvaḓuvha
the West	vhukovhela
the common good	mbuelo kha vhoṱhe; zwivhuya kha vhoṱhe
the disadvantaged	sa vha kha tshiimo tshavhuḓi
the historically disadvantaged	siwa nnḓa kale
the masses	gogo
the powers that be	vha re na maanḓa u fhira vhaṅwe
the right	pfanelo
the services	tshumelo
the struggle	nndwa
the voiceless	vha sa koni u ḓiambela
time of arrival	tshifhinga tsha u swika
time of departure	tshifhinga tsha u ṱuwa; tshifhinga tsha u takuwa
title deed	vhuṋe ha tshithu
to and fro	 ya na u vhuya
to the effect that	 swika hune
to the left of	kha tsha monde tsha
to the right of	kha tshauḽa tsha
top management	ndangulo ya nṱha
top secret	tshidzumbe tsha nṱha
total onslaught	khakhathi dza u ṱhasela
track record	rekhodo ya mushumo
trade relations	vhushaka ha mbambadzo
trade union	mbumbano ya vhashumi
trading partner	mushumisani kha vhubindudzi
traditional leadership	vhurangaphanḓa ha sialala
traffic control	ndangavhuendi
training facilities	tshomedzo dza vhugudisi
training institution	tshiimiswa tsha vhugudis
transition to democracy	pfukela kha demokhirasi
translation of the Bible	pindulelwa ha Bivhili; phindulelo ya Bivhili; ṱhalutshedzo ya Bivhili
tree of knowledge	muri wa nḓivho
tree of life	muri wa vhutshilo
umbrella body	tshiimiswa tshi konanyi
unanimous concurrence	tendelana
under the auspices of	nga thuso ya
under the authority of	nga fhasi ha ndaulo ya
unemployment rate	phimo  ya vhushayamushumo
unfair discrimination	khethululo
unique people	vhathu vho fhambanaho
united nations organisation	dzangano ḽa mbumbano ya dzitshaka
unreserved postal service	tshumelo dza poswo dzi re khagala
up to date	u tshimbila na tshifhinga
up to standard	tshiimo tshone; vhuimo hone
upper middle class	vhathu vha vhuimo ha nṱha
urban area	vhupo ha dziḓoroboni
urban centre	vhukati ha ḓorobo
urban development	mveledziso ya vhupo ha dziḓoroboni
urban renewal	mvusuludzo ya ḓorobo
value system	sisiṱeme ya vhuḓifari
violation of human rights	kandekanya pfanelo dza  vhathu
violence against children	u tambudzwa ha vhana
voice of the people	ipfi ḽa vhathu
vote in favour	vouthela
vote of thanks	ndivhuwo
waste management	ndangulo ya malaṱwa
ways and means	nḓila
welfare state	vhulondavhathu
winds of change	muya u vhudzulaho
winter rainfall region	dzingu ḽa mvula dza vhuriha
with effect from	 thoma;  thoma nga;  bva nga
with the sun	na ḓuvha
with the wind	na muya
within a radius of	nga ngomu ha rediasi ya
within the limits	nga ngomu ha mikano
word of welcome	maipfi a u ṱanganedza
working group	tshigwada tsha mushumo
world community	tshitshavha tsha ḽifhasi
you are here	vha hafha; ni hafha; ni henefha; vha henefha