APRIL	Lambamai; 
Africa's	Afrika; 
African	Muafrika; 
Africans	Muafrika; 
Apr	Lambamai; 
April	Lambamai; 
Auditor	Oditha; 
Bantu	Murema; 
Beginner's	muthomi; 
Boer	muvhuru; mufurukaṋere; 
Brazil	Brazili; 
CEOs	 Vhaofisiri Mutshimbidzi; 
Canada	Khanada; 
Chairman	 mudzulatshidzulo; mudzulaphanḓa; 
Chinese	Mutshaina; 
Christianity	Vhutendi; 
Clerks	 Muṅwali wa ofisini; Vhomabalane; 
Commissioner	Mukhomishinari; 
DECEMBER	NYENDAVHUSIKU; 
Dec	NYENDAVHUSIKU; 
December	Nyendavhusiku; 
Deregister	bvisa kha ridzhisiṱara; 
Drakensberg	Ḽiulu; 
English	Tshiisimane; 
Ethiopia	Ethopia; 
Europe	Yuropa; 
European	Mutshena; 
Excellency	Vhaṱhonifhei; Vhaṱhomphei; Vhahulisei; Vhatatisei; 
FEBRUARY	LUHUHI; 
FRIDAY	ḼAVHUṰANU; 
Feb	LUHUHI; 
February	Luhuhi; 
Federal	 Lushaka;  Tshitshavha; Muvhuso; 
Filter	sefo;  miṋa; suḓa;  muṱuḓo;  kunakisa;  ṱuḓa;  sefa; 
Fort	tshihoḓo; thondo; 
Friday	Ḽavhuṱanu; 
Fridays	Ḽavhuṱanu; 
Gazette	Gazete; 
Germany	Dzheremane; 
Glossary	Guḽosari; Teo; 
God	 Mudzimu; mudzimu; 
Guardian	muunḓi; 
HIV-positive	 vha na HIV; 
Handbook	bugupfarwa; 
Hawks	vhurwanzhivha;  vhavhambadzi; rengisa; 
I'm	 tho;  nda; ndo; ndi;  thi;  nṋe; 
Infecting	fhirisela;  pfukisela;  longa zwi vhulayaho;  kavha; 
Interjections	maaravhi; 
JANUARY	PHANDO; 
JULY	FULWANA; 
JUNE	FULWI; 
Jan	PHANDO; 
January	Phando; 
Japan	Dzhapani; 
Jul	FULWANA; 
Julius	Lulius; 
July	Fulwana; 
Jun	FULWI; 
June	Fulwi; 
Keyword	 ipfi ḽa ndeme; ipfi ḽi shumaho sa khii;  ipfi ḽa khoṋo; 
KwaZulu-Natal	Kwazulu-Natal; 
LinkedIn	Linkedin; 
Luthuli	Luthhuli; 
MONDAY	MUSUMBULUWO; 
MPs	MP; 
MR	VHO; 
Madam	Mufumakadzi; 
Mandela's	Mandela; 
Mar	Ṱhafamuhwe; 
Mayor	 Ṋeḓorobo; Meyara; 
Meanwhile	zwi tshe zwo ralo;  zwi tshi kha ḓivha zwo ralo; 
Monday	Musumbuluwo; 
Mourns	 ṱungufhala; lila; 
Mr	Vho; 
Mrs	 Mufumakadzi vho; Vho; 
NOVEMBER	LARA; 
Nov	LARA; 
November	Lara; 
OCTOBER	TSHIMEDZI; 
Oct	TSHIMEDZI; 
Offender's	 mupfuki wa mulayo;  mukhakhi; mutshinyi; 
Olympic	Oḽimpiki; 
Olympics	Dzioḽimpiki; 
PACs	PAC; 
Pan	pani; 
Parliament's	 Zwa phalamennde; Zwa phaḽamennde; 
Postpones	 lengisa;  fhirisa tshikhathi tsha;  fhirisa tshifhinga tsha; imisa; 
Presidency	 zwa ṱhoho;  zwa muphuresidennde;  zwa mulangashango; zwa mutshimbidzi; 
President's	 dzula phanḓa; tshimbidza; 
Pretoria	tsho nakaho; 
Prince	 Mukololo wa munna; Zhinda; 
Pringle	ṱhavha;  vaya; 
Protector	Mutsireledzi; 
Registrar	 mabalane; mulanguli; Rigisiṱarara; 
Rejoice	 takala; takalela; 
Riverside	khunzikhunzini;  bilipili;  vhugabelo; 
SEPTEMBER	KHUBVUMEDZI; 
Secretariat	Vhuṅwaleli; 
Secretaries	Vhaṅwaleli; 
Secretaries-General	Vhaṅwaleli Vhahulu; Vhaṅwaleli Dzheneraḽa; 
Self-Governance	 ḓilanga; ḓivhusa; 
Senate	Vhutendelwamilayo; 
Sep	KHUBVUMEDZI; 
September	Khubvumedzi; 
Sharpeville	Sharpville; 
Skip	pfuka;  thamuwa;  fhidza;  fhufha; 
Sunday	Swondaha; 
Surname	tshifani; 
Switchboard	switshibodo; 
TUESDAY	ḼAVHUVHILI; 
Venda	Venḓa; 
WEDNESDAY	ḼAVHURARU; 
York	tshitswuku tsha gumba; 
Zulu	Muzulu; 
ability	vhukoni; 
able	 maanḓa;  konaho; kona; 
about	 nga nṱha ha;  re henefha kha; nga;  nga ha; nga nṱhaniha: nga vhaho; 
above	nṱha ha; 
above-mentioned	bulwaho afho nṱha; 
abroad	seli ha malwanzhe; 
absence	 u sa vha hone; -phidza; 
absent	-fhidzaho; 
absolute	vhukuma; 
abused	 vhutambudzi; tshumisommbi; tambudzwa; 
academia	akademia; 
academic	-akademi;  zwa pfunzo; 
academics	 zwa pfunzo; akademi; 
academies	akademisi; 
academy	akademi; 
accelerate	 vhiluledza; -ṱavhanyisa; 
accelerated	 vhiluledza; ṱavhanyisa; 
accelerating	 vhiluledza; ṱavhanyisa; 
acceleration	nyengedzo ya luvhilo; 
accept	ṱanganedza; 
acceptable	ṱanganedzea; 
acceptance	ṱanganedza; 
accepted	ṱanganedza; 
accepting	ṱanganedza; 
access	 tswikelo; -swikela; 
accessed	swikela;  tswikelo; 
accessibility	swikelea;  dzhenea; 
accessible	swikelea; 
accession	 tholwa; thendelano;  ṱanganedza; 
accident	khombo; 
accidents	khombo; 
acclaim	 khoḓa; tenda;  renda; fululedza; 
acclaimed	 khoḓa; tenda;  renda; fululedza; 
accommodate	shumisa;  thusa;  ḓowela; 
accommodated	shumisa;  thusa;  ḓowedza; 
accommodation	 u vhona; vhudzulo; 
accompanied	 itea mazha;  bvumela; fhelekedza; 
accompany	 u itea mazha;  bvumela; fhelekedza; 
accomplish	u khunyeledza; 
accomplished	khunyeledza; 
accord	thendelano;  ṱhanganyo;  mvumelano; 
accordance	-pfana; 
accorded	thendelano;  ṱhanganyo;  mvumelano; 
according	u ya nga; 
accordingly	 zwenezwo ha;  ya nga;  tevhedza;  nga hune;  sa zwenezwo; ngauralo; 
account	akhaunthu; 
accountability	vhuḓifhinduleli; 
accountable	-vha na vhuḓifhinduleli; 
accountants	vhaḓivhambalelano; 
accounted	akhaunthu; 
accounting	muvhalelano; 
accounts	akhaunthu; 
accreditation	khwaṱhisedzo;  thendelo ya tshiofisi;  tendelwa lwa tshiofisi; 
accredited	khwaṱhisedzo;  thendelo ya tshiofisi;  tendelwa lwa tshiofisi; 
accruals	nyaluwo, zwo wanalaho;  muṱanganyo; mbuthanyo; 
accrue	engedzea; 
accrued	engedzea; 
accumulate	kuvhanganya; 
accumulated	kuvhanganya; 
accuracy	vhuronwane; 
accurate	kwakwakwa;  nga vhuronwane; 
accused	muhwelelwa; 
achieve	swikelela; 
achieved	swikelela; 
achievement	tswikelo; 
achievements	tswikelo; 
achieving	swikelela; 
acknowledge	-tenda; 
acknowledged	tenda; 
acknowledges	tenda; 
acquire	wana;  -ḓiwanela; 
acquired	wana;  ḓiwanela; 
acquisition	wana;  renga;  swika;  kona; 
across	buḓa; 
act	 nyito; mulayo;  luṱa; 
acted	tamba;  nyito; mulayo;  luṱa; 
acting	-farelaho; 
action	nyito; 
actions	nyito; 
active	ḓalaho mafulufulu; 
actively	tsha maanḓa;  nga maanḓa;  ya maanḓa; 
activism	makone; muḓisatshanduko; 
activists	muṱuṱuwedzi; 
activities	mishumo; 
activity	mushumo; 
actors	Vhatambi; 
acts	tamba;  nyito; mulayo;  luṱa; 
actual	vhukuma; 
actually	vhukuma; 
ad	khungedzelo; 
ad-hoc	 sa dzudzanyelwa; sa pulanelwa; 
adaptation	 vhushumisi; nḓowedzo; 
add	 -ṱanganya; ṱanganya; 
added	engedzwa;  ṱanganya; 
adding	ṱanganya; 
additional	nyengedzedzo; 
address	 ḓiresi; ṋea tshipitshi;  aḓiresi; 
addressed	 ḓiresi; ṋea tshipitshi;  aḓiresi; 
addresses	 ḓiresi; ṋea tshipitshi;  aḓiresi; 
addressing	 ḓiresi; ṋea tshipitshi;  aḓiresi; 
adds	ṱanganya; 
adequate	 -linganaho; linganaho; 
adequately	 eḓanaho; linganelaho;  luga; 
adhere	u tevhedza; 
adjourn	u vala mushumo; 
adjourned	vala mushumo; 
adjudication	konanyi;  nyambedzano; vhulamukanyi; 
adjust	shandukisa; 
adjusted	shandukisa; 
adjustment	u dzudzanyea; 
adjustments	dzudzanyea; 
administer	 -laula; u laula; 
administered	laula; 
administering	laula; 
administration	ndaulo;  vhulauli; 
administrations	ndaulo;  vhulauli; 
administrative	ndaulo;  vhuvhusi;  laula;  vhulangi; vhutsimbidzi; 
administrator	mulangi;  mulauli; 
administrators	mulangi;  mulauli; 
admissible	 ṱanganedzea; tendelwa; 
admission	 u tenda mulandu; ṱhanganedzo; 
admit	-ṱanganedza; 
admitted	ṱanganedzwa; 
adopt	u unḓa;  u hulisa; 
adopted	 unḓa; hulisa; 
adopting	 unḓa; hulisa; 
adoption	u unḓa; 
adoptive	ṅwanakisa; shumiswa;  ṱanganedzwa; 
adopts	 unḓa; hulisa; 
adult	 mualuwa; muhulwane; 
adults	 mualuwa; muhulwane; 
advance	 u khwinifhadza; khwinifhadzo; 
advanced	-bvelelaho; 
advancement	 bvela phanḓa;  mvelaphanḓa; engedza; zwiswa; isa phanḓa; 
advances	khwinifhadza; mbadelophanḓa;  khwinifhadzo; 
advancing	khwinifhadza; mbadelophanḓa;  khwinifhadzo; 
advantage	tshivhuya;  vhuḓi; 
advantages	tshivhuya;  vhuḓi; 
advent	mathomo;  marangaphanḓa; muswika; 
adverse	 mutshinyali; swina;  sa takadzi; vhushanyi; 
adversely	 mutshinyali; swina;  sa takadzi; vhushanyi; 
adversity	vhushai;  tsiku;  vhuṱungu; 
advertise	 -vhambadza;  u kungedzela; kungedzela; 
advertised	 kungedzela; vhambadza; 
advertisement	khungedzelo; 
advice	ndaela;  ngeletshedzo; 
advise	 laya; limusa;  tsivhudza;  humbudza; eletshedza; 
advised	 laya; limusa;  tsivhudza;  humbudza; eletshedza; 
adviser	mueletshedzi; 
advisers	vhaeletshedzi; 
advisor	eletshedza; 
advisories	mivhigo; 
advisors	vhaeletshedzi; 
advisory	 tsivhudzo; ngeletshedzo; 
advocacy	tikedza;  thikhedzo; 
advocate	 muimeleli;  muambeli; muimeli;  -imelela; 
advocates	 muimeleli;  muambeli; muimeli;  imelela; 
affairs	mafhungo; 
affect	kwama; 
affected	kwamea; 
affecting	kwama; 
affects	kwama; 
affirm	khwaṱhisa; 
affirmation	khwaṱhisedzo; 
affirming	khwaṱhisa; 
afford	kona; 
affordable	-konaho; 
afforded	kona; 
aforementioned	zwo bulwaho nṱha;  zwo bulwaho; 
aforesaid	zwo bulwaho nṱha;  zwo bulwaho; 
after	nga murahu; 
afternoon	 mathabama; masiari; 
again	hafhu; 
against	mavhangani na; fhambana na; 
age	 ṅwaha;  u hula;  miṅwaha; vhukale; 
aged	 miṅwaha;  kegula;  kalaha; vhukale; 
agencies	mazhendedzi; 
agency	zhendedzi; 
agent	 tshivhumbi;  tshishandukisi;  tshumi;  ḽiḓadzisi; zhendedzi; 
agents	 tshivhumbi;  tshishandukisi;  tshumi;  ḽiḓadzisi; zhendedzi; 
ages	 ṅwaha;  miṅwaha;  hula; vhukale; 
aggregate	ṱhanganyelo; 
aggrieved	-vhaiswaho; 
ago	kalekale; kaleni; 
agree	tenda; 
agreed	tenda; 
agreement	thendelano;  pfano; 
agreements	thendelano;  pfano; 
agrees	tenda; 
agricultural	zwa vhulimi; 
agriculture	vhulimi;  vhulimi vhufuwi; 
ahead	mbvelo phanḓa; nga phanḓa; 
aid	thuso;  -thusa; 
aids	 thuso; thusa; 
aim	ndivho; 
aimed	korola; ndivho; 
aims	korola; ndivho; 
air	muya; 
aircraft	bufho; 
airport	 vhukavhabupo; vhukavhamabufho;  vhuimabupo; 
airports	 vhukavhabupo; vhukavhamabufho;  vhuimabupo; 
albeit	 naho; fhedzi;  naho zwo ralo; 
alcohol	zwikambi; 
align	-livhanya; 
aligned	livhanya; 
alignment	 mulivhanyo; ndivhanyo; 
alike	 nga u fana; fana; 
alive	tshihanyaho;  tshitshilaho; 
all	zwoṱhe;  nga huzwo;  zwoṱhezwoṱhe; 
allegation	humbulelwa;  mavharivhari; 
allegations	humbulelwa;  mavharivhari; 
alleged	-humbulelwaho; 
allegedly	humbulelwa; 
alleviate	fhungudza; 
alleviation	fhungudzwa; 
alliance	pfano; 
allocate	avhela; 
allocated	avhela; ṋea; 
allocation	mukovhe; 
allocations	mukovhe; 
allow	tendela; 
allowance	gavhelo; 
allowances	gavhelo; 
allowed	tendela; 
allowing	tendela; 
allows	tendela; 
almost	 kaṱukuṱuku;  ṱoḓou; tsinitsini; 
alone	vhoṱhe;  dzoṱhe;  eṱhe;  woṱhe; muṅwefhedzi; 
along	thungo ha; 
alongside	tsini na; 
already	 zwo;  no;  zwo no ḓi ralo; arali;  zwo luga; 
also	 hafhu;  ralo; na; 
alter	shandukisa;  rembulusa; 
alternative	shandukisa;  ṱhaḓulanya;  fhambanya; 
although	naho;  nangwe; 
always	misi yoṱhe;  nga musi;  nga misi; tshifhingatshoṱhe; 
am	ndi; 
ambassador	 muambasada; muimeleli; 
ambassadors	 muambasada; muimeleli; 
ambient	 vhupo ha tsini; muzikanyangaredzi; vhupo; 
ambit	vhuhulu;  khaphasithi;  nḓadzo; 
amend	-khwinisa; 
amended	khwinisa; 
amending	khwinisa; 
amendment	khwiniso; 
amendments	khwiniso; 
amends	khwinisa; 
amnesty	u farelwa ha vhafariwa; 
among	vhukati; 
amongst	vhukati; 
amount	 -lingana; ṱhanganyelo; 
amounted	lingana;  ṱhanganyelo; 
amounting	lingana;  ṱhanganyelo; 
amounts	lingana;  ṱhanganyelo; 
analogue	anaḽogo; 
analyse	saukanya; 
analysed	saukanya; 
analyses	sengulusa;  fhenḓa; 
analysing	saukanya; 
analysis	 phenḓa; musaukanyo; 
ancestor	 vhadzimu;  makhulukuku; mudzimu; 
ancestors	 vhadzimu;  makhulukuku; mudzimu; 
and	na; 
animal	phukha;  tshiḽaṋama;  tshihanyi; 
animals	phukha;  tshiḽaṋama;  tshihanyi; 
annex	thuba;  -thuba; 
annexure	ṱhumetshedzo;  tshiengedzwa; 
anniversary	anivesari; 
announce	ḓivhadza; 
announced	ḓivhadza; 
announcement	nḓivhadzo; 
announcements	nḓivhadzo; 
announces	ḓivhadza; 
annual	ṅwaha nga ṅwaha; 
annually	nga ṅwaha; 
annum	nga ṅwaha; 
answer	phindulo; 
answers	thekenelo; phindulo; 
antenatal	vhuimana;  phanḓa ha mbebo; 
anthem	luimbo;  luimbo lwa lushaka; 
anti-corruption	lwa na vhuaḓa;  lwa na tshanḓanguvhoni; 
anti-pass	vhulwa na u hwala dzibasa;  vhulwa na milayo ya u fara basa; 
anticipated	lavhelewa; 
any	muṅwevho; tshiṅwevho; 
anyone	muṅwe na muṅwe; 
anything	tshiṅwe na tshiṅwe; 
apart	-khethwaho; 
apartheid	khethululo; 
apparent	-vhonalaho; 
appeal	khaṱhululo;  -humbela khaṱhululo;  humbela khaṱhululo; 
appealed	khaṱhululo;  humbela khaṱhululo; 
appeals	khaṱhululo;  humbela khaṱhululo; 
appear	 ḓivhonadza;  dzumbuluwa; bvelela;  vhonala; 
appearance	 mbonalele; u bvelela; 
appeared	 ḓivhonadza;  dzumbuluwa; bvelela;  vhonala; 
appearing	 ḓivhonadza;  dzumbuluwa; bvelela;  vhonala; 
appears	 ḓivhonadza;  dzumbuluwa; bvelela;  vhonala; 
appellant	muhumbeli wa khaṱhululo; 
applaud	 vhanda; losha; 
applause	 vhanda; losha; 
applicable	teaho;  shumiswa; 
applicant	muhumbeli; 
applicants	muhumbeli; 
application	 u shumisa; khumbelo;  tshumiso; 
applications	 shumisa; khumbelo;  tshumiso; 
applied	ḽiitela; 
applies	ita khumbelo; 
apply	u ita khumbelo; 
applying	ita khumbelo; 
appoint	-vhea; 
appointed	vhea; 
appointing	vhea; 
appointment	 mbeo; ndangano; 
appointments	tholwa;  mbeo;  ndangano; 
appoints	vhea; 
appreciate	-pfesesa; 
appreciated	livhuwa; pfesesa; 
appreciates	livhuwa; pfesesa; 
appreciation	vhupfesesi; 
approach	 -sendela;  nḓila; maele; 
approached	sendela;  nḓila;  maele; 
approaches	sendela;  nḓila;  maele; 
appropriate	teaho; 
appropriated	teaho; 
appropriately	teaho;  fanelaho; 
appropriation	kukovhele;  mukovho; 
appropriations	kukovhele;  mukovho; 
approval	thendelo; 
approve	-tendela; 
approved	tendela; 
approximately	-anganyela; 
arbitration	vhulamukanyi; 
arbitrator	mulamukanyi; 
architects	muatshithekithi; 
architectural	vhufhaṱi; 
architecture	vhufhaṱi; 
archival	vhuvhulungamaṅwalo; 
archive	akhaivi; 
archives	akhaivisi; 
area	vhupo; 
areas	nyalo; vhupo; 
arena	 luvhanḓe; tshitediamu;  vhugalatenga; 
argue	 ṱaṱa; ṱaṱisana; 
argued	 ṱaṱa; ṱaṱisana; 
argument	khanedzano; 
arguments	 khanedzano; khanedzano; ṱaṱisana; 
arise	 karuwa;  takuwa; vuwa;  fhinduwa; 
arises	vuwa; karuwa;  fhinduwa; takuwa; 
arising	vuwa; karuwa;  fhinduwa; takuwa; 
arm	tshanḓa; 
armed	shoma; 
arms	zwiṱhavhane; 
arose	 karuwa;  takuwa; vuwa;  fhinduwa; 
around	-mona na; 
arrange	 -lugisa; -dzudzanya; 
arranged	dzudzanya;  lugisa; 
arrangement	ndugiso; 
arrangements	ndugiso; 
array	mutevhe; 
arrest	fara;  -fara; 
arrested	fara; 
arrival	 u swika; muswiko; 
arrive	 muswiko; swika; thuthuluku; 
arrived	 muswiko; swika; 
art	vhutsila; 
artefacts	zwivhaḓwa; 
articles	ḽianetshelo; 
articulate	 mabulele; kubulele; 
articulated	 mabulele; kubulele; 
artist	mutsila;  mukonesi; 
artistic	-vhukonesi;  -vhutsila; 
artists	mutsila;  mukonesi; 
arts	ḓivhavhukonesi; vhukonesi; 
artwork	mushumo wa vhutsila; 
artworks	mishumo ya vhutsila; 
as	vhunga; 
ascertain	khwaṱhisedza; wana mafhungo ngoho; 
aside	 thungo;  lurumbu; 
ask	 -vhudzisa; vhudzisa; 
asked	vhudzisa; 
asking	vhudzisa; 
asks	vhudzisa; 
aspect	sia; 
aspects	masia; 
aspiration	dzangalelo;  vhuvhudzuli; 
aspirations	dzangalelo; tswonzwa;  vhuvhudzuli; 
assault	 u rwa; mulandu wa u rwa; 
assembly	buthano; 
assented	thendelo;  tendela;  tenda; 
assert	 khwaṱhisa; amba; 
assess	gaganya;  -gaganya; 
assessed	gaganya; 
assesses	gaganya; 
assessing	gaganya; 
assessment	ngaganyo; 
assessments	ngaganyo; 
assessors	mugaganyakhaṱhulo; 
asset	ndaka; 
assets	ndaka; 
assign	avhela; rumela;  ṋetshedza;  ṋea; 
assigned	avhela; rumela;  ṋetshedza;  ṋea; 
assignment	mushumoavhelwa; 
assist	thusa; 
assistance	thuso; 
assistant	 farisa;  ṱhaḓula;  pfariso; thusa; 
assisted	thusa; 
assisting	thusa; 
assists	thusa; 
associate	 nyanḓano;  -anḓana; anḓana; 
associated	 nyanḓano; anḓana; 
association	dzangano; 
associations	dzangano; 
assume	 elekanya; dzhia;  linganya; 
assumed	 elekanya; dzhia;  linganya; 
assumptions	muhumbulo;  tenda;  khumbulelo; 
assurance	fulufhelo;  khwaṱhiso; 
assure	fulufhelo;  khwaṱhiso; 
assured	 khwaṱhisedzo; fulufhelo; 
astronomy	ḓivhaṋaledzi; 
at	 kha; nga;  tsini ha; 
athletics	zwipotso; 
atmosphere	dzingamufhe; 
atmospheric	dzingamufhe; 
attach	 thuba; nambatedza; 
attached	 thuba; nambatedza; 
attachment	 tshinambatedzwa; nambatedza; 
attack	 u thomiwa;  ṱasela;  ṱahadza; -thoma; 
attacks	ṱhasela;  thomo;  u thomiwa;  ṱasela;  ṱahadza; thoma; 
attain	-kona; 
attained	kona; 
attainment	wana;  swika;  kona; 
attempt	ndingedzo;  -lingedza; 
attempted	lingedza;  ndingedzo; 
attempts	lingedza;  ndingedzo; 
attend	-dzhena; 
attendance	madzhenele; 
attended	dzhena; 
attending	dzhena; 
attention	tshenzhemo; 
attitude	vhuḓifari; 
attitudes	maime; vhuḓifari; 
attorney	 axennḓe; ramilayo; 
attorney-general	mulangavhatshutshisi; 
attorneys	 maaxennḓe; vhoramilayo; 
attract	-kokodza; 
attracted	kokodza; 
attribute	 tshiṱaluli; vhunzani; 
attributed	 tshiṱaluli; vhunzani; 
auction	 vandisi; fandisi; 
audience	 vhathetshelesi; vhaṱaleli; 
audiences	 vhathetshelesi; vhaṱaleli; 
audio	odio; 
audios	dziodio; 
audiovisual	odovisuaḽa; 
audit	ṱola;  -u ṱola; 
audited	ṱola; ṱholo; 
auditing	ṱola; ṱholo; 
auditor	muṱolamuvhalelano; 
auditor-general	Muodithadzheneraḽa;  muṱolambalelano;  muṱolamuvhalelano; 
auditors	vhaṱolambalelano; vhaṱolamuvhalelano; 
audits	ṱola; ṱholo; 
august	ṱhangule; 
auspices	 tshiga; thuso;  tikedza;  thikhedzo; 
authentic	 tshonetshone;  fulufhelwaho; vhukuma;  vhuronwane;  ngoho; 
author	muṅwali; 
authorisation	thendelo; 
authorise	thendelo;  tendela;  tenda; 
authorised	laedzwaho; 
authorities	 maanḓa; muvhuso;  maanḓalanga; muḓivhesi; 
authority	 maanḓa; muvhuso;  maanḓalanga; 
authorization	thendelo; 
authorize	thendelo;  tendela;  tenda; 
authorized	thendelo;  laedzwaho; 
authors	muṅwali; 
automated	 vhuitatshoga; vhuḓiitisi; 
automatic	tshiḓiitisi’ vhuitatshoga; 
availability	wanala;  vha hone; 
available	-wanala; 
avenue	tshiṱaraṱa; 
avenues	tshiṱaraṱa; 
average	tshikati;  mbalotshikati;  -tshikati; 
avoid	 -ilisa; thivhela;  tinya; 
avoidance	tinyai;  pilela; shavha;  tinya;  ilisa; 
awaiting	lindela; 
award	pfufho;  -pfufha; 
awarded	 pfufha; pfufho; 
awarding	 pfufha; pfufho; 
awards	 pfufha; pfufho; 
aware	 ḓivha; -ṱhogomela; 
away	kule; 
babies	lushie; 
baby	lushie; 
back	 u humela kha;  nnḓa ha tshanḓa;  mudzi wa lulimi; muṱana; 
backdrop	 siangane; vhupo; 
background	siangane;  nga murahu; 
backgrounds	siangane;  nga murahu; 
backlog	salela; 
backlogs	salela; 
bad	vhifhaho; 
bail	beila; 
bake	baka; 
baking	baka; 
balance	 -linganyisa;  u lingana;  baḽantsi;  tshilinganyisi; ndinganyiso; 
balanced	zwosalaho;  ndinganyo;  linganyisa; tshikalo; 
balances	 lingana; mulingano;  baḽantsi;  linganyisa;  tshilinganyisi; ndinganyiso; 
ball	bola;  pfura; 
band	 bannda; bennde; 
bank	bannga; 
banking	-khuvhedzela;  u bannga; 
banks	bannga; 
baobab	muvhuyu; 
bar	bara;  dungo; 
bargain	muganyo; 
bargaining	muganyo; 
barrier	luswinga; 
barriers	luswinga; 
base	 mutheo;  thikho;  -theo; fhasi;  beisi; 
based	 mutheo;  basisi ya;  thikho; fhasi;  theo;  beisi; basisi; 
baseline	mutheo; 
basic	-theo; 
basics	theo; 
basis	 theo; mutheo; 
basket	 basigidi; manngi; 
battle	nndwa; 
bay	 tshikombame; gombame; 
be	vha; 
beach	bitshi; 
beaches	bitshi; 
bear	bere;  tshivhingwi; 
bearer	mubveledzi;  mufari; 
bearers	mubveledzi;  mufari; 
bearing	berini; 
bears	bere;  tshivhingwi; 
beautiful	 nakisa;  nakaho; naka; 
beauty	lunako; 
became	vha; 
because	ngauri; 
become	-vha; 
becomes	vha; 
becoming	vha; 
bed	mmbete;  vhulalo; 
beds	mmbete;  vhulalo; 
bee	ṋotshi; 
been	vha; 
beer	halwa;  bia; 
before	phanḓa ha; 
began	 simula;  ranga; thoma; 
begin	 simula;  ranga; thoma; 
beginner's	musimuli; 
beginning	mathomoni; 
begins	 simula;  ranga; thoma; 
begun	 simula;  ranga; thoma; 
behalf	nṱhani ha;  sia ḽa; 
behaviour	mikhwa;  vhuḓifari; 
behind	murahu; 
being	 tshivhumbiwa; muthu; 
beings	vhathu;  zwivhumbiwa; 
belief	lutendo; 
beliefs	lutendo; 
believe	 fulufhela; tenda;  fhulufhela;  fulufhedza;  fhulufhedza; 
believed	 fulufhela; tenda;  fhulufhela;  fulufhedza;  fhulufhedza; 
believes	 fulufhela; tenda;  fhulufhela;  fulufhedza;  fhulufhedza; 
believing	 fulufhela; tenda;  fhulufhela;  fulufhedza;  fhulufhedza; 
belong	vhawa; rumiwa; 
belonging	zwithu;  thundu; 
belongs	vhawa; rumiwa; 
beloved	mufunwa;  funwaho; 
below	fhasi; 
beneficial	wana;  thusi;  thakho;  vhuelwa;  pfariso;  mbuelo;  luga; 
beneficiaries	muvhuelwa; 
benefit	mbuelo;  thakho; 
benefited	mbuelo;  thakho; 
benefits	mbuelo;  thakho; 
best	bidzi; tshisikudi; 
better	 vhukhwiṋe; khwiṋe; 
between	vhukati;  vhukati ha; 
beyond	murahu;  seli;  phanḓa ha;  hafhaḽa; 
bidders	mubidi; 
bids	bida;  bidi; 
biennale	 nga tshikhathi;  kha miṅwaha mivhili;  nga tshifhinga; zwa misi yoṱhe; 
big	khulu; 
bigger	khulu; 
biggest	khulu; 
bilateral	ṱhumo;  masia mavhili; ṱangana; 
bill	 mulayotibe;  vhila;  mbalelano; mulandu; 
billion	biḽioni; 
bills	 mulayotibe;  vhila;  mbalelano; mulandu; 
bind	-ṱanganya;  -boma; 
binding	lubomo; 
bingo	 mutambo wa ḽotho; bingo; 
biodiversity	bayodaivesithi; 
biological	bioḽodzhikhaḽa; 
biome	zwimela zwa kilima nkene; 
bird	tshiṋoni; 
birds	zwiṋoni; 
birth	 mbebo;  u beba; mabebo; 
birthday	ḓuvha ḽa mabebo; 
blacks	tswu; 
blind	 -bofu;  u pofula; -swingisa;  -swinga; 
block	 buloko; tshigwada; 
blood	 muelelo wa malofha; malofha; 
blue	muvhala wa lutombo;  bulusele; 
board	 khorwana; bodo;  khadibodo;  khoro ya ṱhoḓisiso; 
boards	khoro;  komiti;  khoro ya vhulangi;  bodo;  khorwana; makhadibodo; 
boasts	 khoḓa; renda; 
bodies	nzio; muvhili;  baga; 
bodily	muvhili;  tshitumbu; 
body	muvhili;  baga; 
bold	tshisina nyofho; khwaṱhaho; 
bona	Bona; 
bond	mbofho;  vhofhelela; 
bonds	mbofho;  vhofhelela; 
book	bugu; 
books	bugu; 
boom	 zwithivheli; vilili; 
boost	 gonyisa;  isa phanḓa;  engedza;  lugisa;  hudza; khwinisa; 
border	mukano;  sakha; 
borders	mukano;  sakha; 
born	bebwa; 
borne	bere;  tshivhingwi; 
borrow	hadzima;  -pamba; 
borrowing	hadzima;  pamba; 
boss	 vhutotoma; vhasa; totomedza; 
botanical	ḓivhamela;  bothanikhaḽa; 
both	-vhili; 
bottom	tshiraho; 
bought	 -renga; renga; 
bound	ṱanganya;  boma; 
boundaries	mukano;  matungo; 
boundary	mukano;  matungo; 
box	 -tsivha;  bogisi; tshibogisi; 
boy	tshitukana; mutukana;  dukana; 
boys	 madukana; vhatukana;  zwitukana; 
braille	bureiḽi; 
branch	 -khethekana; davhi;  u khethekanya nga madavhi;  mudzi wa nga thungo; 
branches	davhi;  u khethekanya nga madavhi;  mudzi wa nga thungo;  khethekana; 
brave	u vha na vhuhali; 
bravery	vhuhali; 
breach	pfuka;  vunḓa;  tumula; 
breadth	vhuphara; 
break	-vunḓa;  u pfuka mulayo;  -fhanduwa ha ipfi; 
breakdown	 ṱhaṱhamula;  kwashekanya; fhandekanya; 
breakfast	vhuragane;  vhurangane; 
breakthrough	bvelela; phuletshedza; 
bridge	buroho;  boroho; 
bridging	buroho;  boroho; 
brief	-pfufhi; 
briefed	nyeṱulela; pfufhi; 
briefly	nga u pfufhifhadza; 
briefs	nyeṱulela; pfufhi; 
bring	ḓera; ḓisa; 
bringing	ḓera; ḓisa; 
brings	ḓera; ḓisa; 
broad	-baphathi; 
broad-based	ṱanḓavhuwaho; angalalaho; 
broadband	zwirathisi zwo angalalaho; 
broadcast	khasho;  -hasha; 
broadcaster	muanḓadzi; 
broadcasters	vhahashi; 
broadcasting	vhuanḓadzi; 
broaden	aṱamisa; 
broadening	aṱamisa; 
broader	baphathi; 
broadly	aṱamisa; 
brochure	tshivhambadzi; 
brochures	tshivhambadzi; 
brother	khaladzi;  mukomana; 
brothers	 vhakomana; khaladzi; 
brought	ḓisa; 
brutal	zwa tshiṱuhu; 
brutality	tshiṱuhu; 
budget	 -gaganya; mugaganyagwama; 
budgetary	masheleni; mugaganyagwama; 
budgeted	 gaganya; mugaganyagwama; 
budgeting	 gaganya; mugaganyagwama; 
budgets	 gaganya; mugaganyagwama; 
build	fhaṱa; 
build-up	 gonya, bveledza; engedza;  ṱuṱuwedza; 
building	tshifhaṱo; 
buildings	tshifhaṱo; 
built	fhaṱa; 
bulk	vhunzhi; zwihuulwane;  tshivhumbeo;  tshileme; 
bureau	ofisi;  birou; 
buried	vhulungwa; 
burning	 fhisa; phise;  duga; swa; 
bursaries	bazari; 
bursary	bazari; 
bury	-vhulunga; 
bus	bisi; 
business	bindu;  makwevho; 
businesses	bindu;  makwevho; 
busy	kakatika;  mishumoshumo; kakarika; 
but	 matsina;  hafhu;  fhedzi; hone; 
buy	 -renga; renga; 
by	nga; 
cabinet	khoro;  khabinethe; 
calculate	-rekanya; 
calculated	-rekanya; 
calculating	-rekanya; 
calculation	u shuma mbalo; 
calendar	khaḽenda; 
call	 rina dzina; vhidza;  vhidzelela; 
called	vhidzwa; 
calling	mbidzo; 
calls	 rina dzina; vhidza;  vhidzelela; 
came	 kuvhangana;  ḓa;  sendela;  swika; bva;  dzhena; 
camp	 -gammba; gammba; 
campaign	fulo;  u bva fulo; 
campaigns	 bva fulo; fulo; fulofulu; 
camps	gammba; 
campus	khamphasi; 
campuses	khamphasi; 
can't	nga si; 
cancel	-swaya; 
cancellation	 ladza;  khantsela;  funga;  swaya;  thutha;  phumula; fhedza; 
cancelled	swaya; 
cancer	 pfuko; khentsa; 
candidate	 mulingiwa; nkhetheni; 
candidates	 mulingiwa; nkhetheni; 
cannot	nga si; 
cant	nga si; 
cap	gebisi; 
capabilities	vhukoni;  maanḓa o fanelaho; 
capability	vhukoni; 
capable	konaho; 
capacities	nḓadzo; 
capacity	nḓadzo; 
capacity-building	fhaṱavhukoni; 
cape	luvhombo; 
capita	tshelede; 
capital	 pfuma; tshelede;  musanda; 
caps	gebisi; tamba kha thimu ya lushaka; 
capture	thuba;  u dzhia nga khani; 
captured	thuba;  dzhia nga khani; ganḓisa; 
captures	thuba;  dzhia nga khani; ganḓisa; 
car	goloi; 
carbon	khaboni; 
cards	garaṱa; 
care	 -londola; ndondolo; 
career	buḓo; 
careers	buḓo; 
carefully	ṱhogomela; vhulondo; 
cargo	muhwalo;  furaha; 
caring	 londola; ndondolo; 
carnival	bepha; 
carpet	khaphethe; 
carried	ingara;  beba; hwala;  takula; 
carries	ingara;  beba; hwala;  takula; 
carry	ingara;  beba; hwala;  takula; 
carrying	-wedza; 
case	mulandu; 
cases	mulandu; 
cash	kheshe; 
cast	maitele;  vhumba;  ḓuvhudza;  pfula; 
catalogue	khathalogo; 
catalyst	tshiṱuṱuwedzi; 
catch	khakhedza; 
categories	khethekanyo; 
category	khethekanyo; 
cater	 ḓisedzwa; dzudzanya;  kovhela;  lugisela;  lugisa; 
catering	khethariṅi; 
cattle	kholomo; 
caucus	 tsivhudzo; ḽigi; thendelano;  mulanga;  mbumbano, tshigwada; 
cause	tshivhangi; 
caused	tshivhangi; 
causes	tshivhangi; 
causing	tshivhangi; 
cave	bako; 
caves	bako; 
cease	 ṱutshela; litsha; 
ceases	 ṱutshela; litsha; 
celebrate	pembela;  u pembela; 
celebrated	pembela; 
celebrates	pembela; 
celebrating	pembela; 
celebration	tshimima; 
celebrations	tshimima; 
cell	tsiki; 
cells	tsiki; sele; 
cellular	luṱingokhwalwa; selefounu; luṱingothendeleki; 
census	mbalavhathu;  muvhalo; 
censuses	mbalavhathu;  muvhalo; 
cent	peni; 
centenary	 anivesari; ḓuvha ḽa mabebo; pembelela; 
center	vhukati;  senthara;  vhukati kwa; 
central	-vhukati; 
centre	vhukati;  senthara;  vhukati kwa; 
centres	vhukati;  senthara;  vhukati kwa; 
centuries	 ḓana; sentshari; ḓaṅwaha; 
century	sentshari; 
ceremonial	vhuṱambo; 
ceremonies	vhuṱambo; 
ceremony	vhuṱambo; 
certainly	vhuṱanzi;  ngoho; 
certainty	vhuṱanzi;  ngoho; 
certificate	ṱhanziela; 
certificates	ṱhanziela; 
certification	khwaṱhisedzo; 
cession	kumedzela;  ṋetshedza;  ṱovhowa; 
chain	tshaini; 
chair	tshidulo; 
chaired	tshidulo; 
chairman	mudzulatshidulo; 
chairperson	mudzulatshidulo; 
chairpersons	mudzulatshidulo; 
challenge	khaedu;  u lwela; 
challenged	khaedu;  lwela; 
challenges	khaedu;  lwela; 
challenging	khaedu;  lwela; 
chamber	nnḓu; 
chambers	 nnḓu; phera; 
champions	ngweṋa; 
championship	vhungweṋa; 
championships	vhugweṋa; 
chance	 khonadzeo; tshikhala; 
change	 tshintshi; tshanduko;  -shandukisa;  shanduka; 
changed	 tshintshi; tshanduko;  shandukisa;  shanduka; 
changes	 tshintshi; tshanduko;  shandukisa;  shanduka; 
changing	 tshintshi; tshanduko;  shandukisa;  shanduka; 
channel	 -sumbanḓila;  mulonga; tshanele; 
channels	 mulonga; tshanele;  sumbanḓila; 
chapter	ndima; 
chapters	ndima; 
character	 mubvumbedzwa;  vhunzani; mutambi; 
characterised	vumbedza; 
characteristic	 ṱalulaho; mbonalo; 
characteristics	mbonaleo;  ṱalulaho; mbonalo; 
characterize	-vumbedza; 
characterized	vumbedza; 
characters	bvumbo; vhatambi;  vhunzani;  vhabvumbedzwa; 
charge	 mutengo;  -hwesa mulandu; mulandu; 
charged	-tshadzhiwaho; 
charges	milandu;  mitengo;  hwesa milandu; 
chartered	thendelonzwiwa; 
checked	nyokolodzo; 
cheque	tsheke; 
chief	khosi; 
child	ṅwana; 
childhood	vhuhana; 
children	vhana; 
children's	vhana; 
china	China; 
choice	khetho; 
choices	khetho; 
choir	khwairi; 
choral	-khwairi; 
chose	nanga; 
chosen	nanga; 
chronic	goḓombela; 
church	kereke; 
churches	kereke; 
cinema	baisikoponi;  baisikopo; 
cinemas	baisikoponi;  baisikopo; 
circumstances	maimele; 
cited	dagafala; 
cities	ḓorobo khulwane;  ḓorobo; 
citizen	mudzulapo; 
citizenry	 mudzuli; mudzulapo; 
citizens	vhadzulapo; 
citizenship	vhudzulapo; 
city	ḓorobo khulwane;  ḓorobo; 
civic	 siviki; vhadzulapo; 
civil	wapo; 
civilian	mudzulapo a si muraḓo wa tshipholisa;  muthufhedzi; 
claim	mbilo;  -vhila; 
claimed	mbilo;  vhila; vhilwa; 
claims	mbilo;  vhila; 
clarification	bviselakhagala; 
clarify	 dzika; bviselakhagala; ṱalutshedza; 
clarion	porompiṱa; 
class	 lushaka lwa dzina; tshigwada;  kilasi; 
classes	 lushaka lwa dzina; zwigwada;  kiḽasi; 
classic	kiḽasiki; 
classical	-kiḽasiki; 
classics	kiḽasiki; 
classification	khethekanyo;  mukhethekanyo; 
classified	-khethekanywaho; 
clause	davhi; 
clauses	davhi; 
clean	-si na tshika;  u kuna; 
cleaning	kuna;  si na tshika; 
clear	 -vhonadzaho; -phumula;  ḽo tsha;  u tsha;  -vhonalaho; 
clearance	thendelo;  tendela;  laedzwa; 
clearing	 tshenisa;  haḓa; ḓekulula;  hwivha; nakisa; 
clearly	pfalaho; vhonadzho; 
clerk	mabalane; 
click	puṱedza;  tsaṅwa; 
client	khasitama;  murengi; 
clients	khasiṱama; murengi; 
climate	kilima; 
clinic	kiḽiniki;  ngalafhoni; 
clinical	kiḽinikhaḽa; 
clinics	kiḽinikiḽ; kiḽiniki;  ngalafhoni; 
close	tsini;  biko; 
closed	-valeaho; 
closely	tsini; 
closer	tsini;  biko; 
closing	tsini;  biko; 
closure	mvalo; 
closures	mvalo; 
clothing	zwiambaro; 
club	kiḽabu; 
clubs	kiḽabu; kiḽaba; 
cluster	tshigwada; 
co-operation	vhuanḓani; 
co-operative	-vhuanḓani; 
co-ordinate	-pfananya; 
co-ordination	pfananyo; 
co-production	nḓisedzo ya zwibveledzwa; 
coach	 ṱorokisi;  gariki; mugudisi;  basi; 
coal	malasha; 
coast	phendelashango; 
coastal	phendelashango; 
coat	 -pennda; mukumba; 
code	khoudu;  mbulatshiga; 
codes	khoudu;  mbulatshiga; 
coherent	tevhekana; ṱhanḓulukano; 
cohesion	tevhekana;  khwaṱha;  dzudzana; 
cohesive	tevhekana;  khwaṱha;  dzudzana; 
cold	 duda;  u rothola;  hu a rothola; phepho;  murotho;  -rothola; 
collaborate	tshumisano; 
collaboration	tshumisano; 
collaborative	tshumisano; 
collapse	 -wa; wa; 
colleagues	vhashumisani; 
collect	 -khuvhela;  -kuvhanganya; kuvhanganya; 
collected	 khuvhela; kuvhanganya; 
collecting	 khuvhela; kuvhanganya; 
collection	 khuvhanganyo;  khotha;  zwifhiwa;  mitendelo; dzhia; 
collections	 khuvhanganyo;  khotha;  zwifhiwa;  mitendelo; dzhia; 
collective	 ṱangana;  ṱanganela; tshigwada; 
collectively	 ṱangana;  ṱanganela; tshigwada; 
college	khoḽidzhi; 
colleges	khoḽidzhi; 
colloquium	thuthoriaḽa;  therisano dza tshigwada; kiḽasi; 
colonial	-koloni; 
colonies	koḽoni;  vhukoḽoni; 
colony	koloni; 
colour	muvhala; 
coloured	-muvhala; 
colours	muvhala; 
column	 mushinzhi;  muingekano; lutsinga;  phuphu; 
combat	kunda; 
combating	kunda; 
combination	ṱhangano; 
combined	-tshikate; 
come	 kuvhangana;  ḓa;  sendela;  swika; bva;  dzhena; 
comes	 kuvhangana;  ḓa;  sendela;  swika; bva;  dzhena; 
coming	 kuvhangana;  ḓa;  sendela;  swika; bva;  dzhena; 
comma	khoma; 
command	ndaela;  ndaelo; 
commas	khoma; 
commemorate	u humbula; 
commemorating	humbula; 
commemoration	tshihumbudzo; 
commemorative	tshihumbudzo; 
commence	 simula;  ranga; thoma; 
commenced	 simula;  ranga; thoma; 
commencement	 mathomo; ranga; thoma; 
commencing	 simula;  ranga; thoma; 
commend	 khoḓa;  bvumisa; renda; 
commendable	 khoḓa;  bvumisa; renda; 
commensurate	 elana;  lingana;  fana; tea; 
comment	muhumbulo; 
comments	muhumbulo; 
commercial	 vhuvhambadzi; khungedzelo; 
commission	khomishini; 
commissioned	khomishini; 
commissioner	 muanisi; khomishinari; 
commissioners	vhaanisi;  vhakhomishinari; 
commissions	khomishini; 
commit	 vuledza; ita;  kumedzela;  phetha; 
commitment	vhuḓikumedzeli; 
commitments	vhuḓikumedzeli; 
commits	 vuledza; ita;  kumedzela;  phetha; 
committed	 vuledza; ita;  kumedzela;  phetha; 
committee	 khorwana; komiti; 
committee's	 khorwana; komiti; 
committees	 khorwana; komiti; 
committing	 vuledza; ita;  kumedzela;  phetha; 
commodities	tshivhambadzwa; 
commodity	tshivhambadzwa; 
common	kate;  ḓowelea; 
commonly	kate;  ḓowelea; 
commonwealth	mulanganelo; 
communal	vhoṱhe; 
communicate	u davhidzana; 
communicated	davhidzana; 
communication	 vhudavhidzano; vhudavhidzani; 
communication-related	zwa vhudavhidzano; 
communications	vhudavhidzano; 
communities	 vhadzulapo; lushaka;  vhapo;  vhupo; 
community	 vhadzulapo; lushaka;  vhapo;  vhupo; 
community-based	zwa tshitshavha; 
companies	khamphani; 
company	khamphani; 
comparability	 linganyiswa;  fanyiswa;  fanyisedza; vhambedzwa; 
comparable	 linganyiswa;  fanyiswa;  fanyisedza; vhambedzwa; 
comparative	 linganyiswa;  fanyiswa;  fanyisedza; vhambedzwa; 
compare	-vhambedza; 
compared	vhambedza; 
comparison	mbambedzo; 
compassion	vhupfelavhuṱungu; 
compatriots	 muthu wa shango ḽa haṋu; mudzulapo; 
compelled	 ita nga maanḓa; kombetshedzea; 
compelling	 ita nga maanḓa; susumedza; kombetshedzea; 
compensate	 lifha;  lifhela; vhuisedzela;  linganyisa; ndinganyiso; 
compensation	 ndiliso; ndinganyiso; 
compete	 -pikisana; ṱaṱisana; 
competence	vhukoni; 
competencies	vhukoni; 
competency	vhukoni; 
competent	 vhukoni; kona; 
competition	muṱaṱisano; 
competitive	kwazwo;  tshavhuḓi; pfalaho;  ṱukufhadza; sa ḓuri; 
competitiveness	swikelelea;  kunga;  ṱukufhadza;  sa ḓuri; 
compilation	 khuvhanganyo; mbekanyo; 
compile	-kuvhanganya; 
compiled	kuvhanganya; 
complainant	 muvhilaeli; muhweleli; 
complaint	mbilaelo; 
complaints	mbilaelo; 
complement	thendelo; 
complementary	thendelo; 
complete	 -fhedza;  -fhelaho; fhedza; 
completed	 fhelaho; fhedza; 
completely	tshoṱhe;  zwoṱhe; 
completing	 fhelaho; fhedza; 
completion	 khunyeledza; fhedza; 
complexity	tserekano; 
compliance	tevhedza; 
complied	tevhedza; 
complies	tevhedza; 
comply	tevhedza; 
complying	tevhedza; 
component	tshipiḓa; 
components	zwipiḓa; tshiitaho; 
composed	sika; 
composition	 mbumbo;  vhusiki;  mbumbeo;  mbekanywa; maanea;  tshisikwa; 
comprehensive	kuṱalukanyele; kupfesesele; 
comprehensively	kuṱalukanyele; kupfesesele; 
comprise	kateka; vha na; 
comprises	kateka; vha na; 
comprising	kateka; vha na; 
compromise	 u pfesesana; pfesesa; 
compromised	pfesesa;  pfesesana; 
compulsory	-khombekhombe;  zwa khombekhombe; 
computer	khomphyutha;  khomphiyutha; 
computers	khomphyutha;  khomphiyutha; 
comrade	khonani nndwani; 
comrades	khonani nndwani; 
conceive	u pfukwa; 
conceived	pfukwa; 
concentrated	tsho dziaho; 
concentration	pfutelelo; 
concept	 muṱalukanyo; ipfi; 
concepts	 muṱalukanyo; ipfi; 
concern	malugana na;  nga ha; 
concerned	malugana na;  nga ha; 
concerning	malugana na;  nga ha; 
concerns	malugana na;  nga ha; 
concert	khontsati; 
conciliation	 pfumedzano; vhupfumedzani; 
conclude	u guma; 
concluded	guma; 
concludes	guma; 
conclusion	magumo; 
concrete	khonkhrithi; 
concurrence	thendelano; 
concurrent	thendelano; 
condemned	haṱula; ndaṱo; 
condemns	haṱula; ndaṱo; 
condition	 maimele;  vhulwadze; tshiimo; 
conditions	tshiimo; 
condolences	ndiliso; 
condom	khondomu; 
condoms	khondomu; 
conducive	 ṱuṱuwedzea;  takalela;  thusalea;  vhuelwa; funa; 
conduct	 -ḓifara;  vhuḓifari;  -rathisa; -laula; 
conducted	 ḓifara;  vhuḓifari; laula;  rathisa; 
conducting	 ḓifara;  vhuḓifari; laula;  rathisa; 
conducts	 ḓifara;  vhuḓifari; laula;  rathisa; 
confederations	 Feḓarasi; 
confer	vhudzisana;  ṋea; 
conference	khuvhangano; 
conferences	khuvhangano; 
conferred	vhudzisana;  ṋea; 
confidence	vhufulufheli; 
confident	fulufhela; 
confidential	 zwa tshiphiri; zwa tshidzumbe; 
confidentiality	tshiphiri; 
confirm	khwaṱhisedza; 
confirmation	khwaṱhisedzo; 
confirmed	 amba hafhu; khwaṱhisedza;  ṱanganedzwa; 
confirms	khwaṱhisedza; 
confiscation	mpalo; 
conflict	khuḓano; 
conflicts	khuḓano; 
confront	 livhana; ṱangana; 
congratulate	 khoḓa;  renda; takalela;  fhululedza; 
congratulates	 khoḓa;  renda; takalela;  fhululedza; 
congratulating	 khoḓa;  renda; takalela;  fhululedza; 
congratulations	 khoḓa;  renda; takalela;  fhululedza; 
congress	guvhangano; 
conjunction	ḽiṱanganyi; 
connect	 -ṱanganya; ṱanganya; 
connected	ṱhumanyo; ṱanganya;  ṱuma;  paṱekanya; 
connection	ṱhumano; 
conscience	luvalo; 
conscious	 dzivhuluwa; tshiḓipfaho;  ḓivha; ṱalukanya; 
consecutive	-tevhekanaho; 
consensus	thendelano;  thendelano nga huswi; 
consent	thendelo;  tendela; 
consequence	mvelelo; 
consequences	mvelelo; 
consequential	mvelelo; tshiḓiswaho nga mafhungo; 
consequently	ngauralo; 
conservation	ndondolo; 
conserve	 -bikela;  -tsireledza; -vhavhalela;  zwivhulungwa;  u londota; 
consider	 -sedza; sedza; 
considerable	tshuhulwanenyana;  sedzesa;  humbula; sedza; 
considerably	tshuhulwanenyana;  sedzesa;  humbula; sedza; 
consideration	 ngelelo; tshuhulwanenyana;  sedzesa;  humbula; sedza; 
considerations	ngelelo; tshuhulwanenyana; humbula;  sedzesa; sedza; 
considered	tshuhulwanenyana;  sedzesa;  humbula; sedza; 
considering	sedza; 
considers	sedza; 
consist	vha;  itwa nga; 
consistent	thevhekano; 
consistently	khwaṱhaho; nzio; 
consisting	katela;  vha na;  dzhenisa; 
consists	vha;  itwa nga; 
consolidate	pfumbisa; 
consolidated	pfumbiswaho; 
consolidation	pfumbiso; 
constant	-sa shanduki; 
constantly	sa fhidzi; 
constituency	vhukhethelo; 
constitute	-tsheṱa; 
constituted	tsheṱa; 
constitutes	tsheṱa; 
constitution	 ndayotewa; mulayotewa; 
constitutional	ndayotewa; 
constitutions	 ndayotewa; mulayotewa; 
constraint	tshiiledzi; 
constraints	tshiiledzi; 
construct	fhaṱa; 
constructed	fhaṱa; 
construction	mbumbo;  u fhaṱa; 
constructive	fhaṱa; 
construed	ṱalutshedza;  saukanya; 
consult	 -pfa muhumbulo; pfa muhumbulo; 
consultant	mueletshedzi; 
consultants	mueletshedzi; 
consultation	vhuvhudzisi; 
consultations	vhuvhudzisi; 
consultative	 pfa mihumbulo;  vhuvhudzisi; vhukwamani; 
consulted	pfa muhumbulo; 
consulting	pfa muhumbulo; 
consumables	tshifhedzea; 
consumer	murengi;  mufhedzi; 
consumers	murengi;  mufhedzi; 
consumption	tshumiso; 
contact	khwamano; 
contacts	khwamano; 
contain	-faredza; 
contained	faredza; 
container	 tshifaredzi; mudzio; 
containers	 tshifaredzi; mudzio; 
containing	faredza; 
contains	faredza; 
contemplated	sedza nga vhuronwane; 
contemporary	tsha musalauno; 
contempt	 sola; tshinyadzo; tsola; 
content	zwi re ngomu; 
contents	zwi re ngomu;  nḓadzo; 
context	nyimele; 
continent	dzhango; 
continental	dzhango; 
continents	dzhango; 
contingency	tshiwo tshine tsha nga bvelela; 
contingent	khonadzeo ya u bvelela; 
continuation	 ya phanḓa; isa phanḓa; 
continue	u ya phanḓa; 
continued	ya phanḓa; 
continues	ya phanḓa; 
continuing	ya phanḓa; 
continuous	ḽikhathi ḽa khou; 
continuously	sa tumuwiho; sa tumuwi; 
contract	thendelano;  -hwetekanya;  u hwetekana;  konṱiraka; 
contracted	 hwetekanya; thendelano;  hwetekana;  konṱiraka; 
contracting	 hwetekanya; thendelano;  hwetekana;  konṱiraka; 
contractors	rakhonṱhiraka; 
contracts	 hwetekanya; thendelano;  hwetekana;  konṱiraka; 
contractual	thendelano; 
contrary	fhambana;  sa pfana;  phambano;  pfuka; 
contrast	phambano;  -livhanya;  ndivhanyo; 
contravenes	fhambana;  sa pfana;  phambano;  pfuka; 
contravention	fhambana;  sa pfana;  phambano;  pfuka; 
contribute	mpho;  tshifhiwa;  shela mulenzhe;  kovha; 
contributed	mpho;  tshifhiwa;  shela mulenzhe;  kovha; 
contributes	mpho;  tshifhiwa;  shela mulenzhe;  kovha; 
contributing	mpho;  tshifhiwa;  shela mulenzhe;  kovha; 
contribution	mpho;  tshifhiwa;  shela mulenzhe;  kovha; 
contributions	mpho;  tshifhiwa;  shela mulenzhe;  kovha; 
contributor	muṋetshedzi;  mushelamulenzhe; mukovhi; 
contributors	vhakovhi;  vhaṋetshedzi; vhashelamulenzhe; 
control	ndaulo;  u laula;  ndango; 
controlled	ndaulo;  ndango;  laula; 
controlling	ndaulo;  ndango;  laula; 
controls	ndaulo;  ndango;  laula; 
convene	 ramba;  khuvhangano; kuvhanganya; 
convened	 ramba;  khuvhangano; kuvhanganya; 
convention	nzulele;  mulanga; 
conventional	maitele;  zwi re khagala;  zwo ḓoweleaho; 
conventions	nzulele;  mulanga; 
convergence	 nambatelana; ṱhangano; 
conversation	nyambedzano; 
conversations	nyambedzano; 
conversion	 -tshanduko; tshandukiso; 
convert	 u shandukisa; -shandukisa;  -rembuluwa; 
converted	shandukisa;  rembuluwa; 
convey	 fhirisa; tshimbidza; 
convicted	haṱulwa; 
conviction	u vhonwa mulandu; 
convinced	tendisea;  tendisa; 
cookie	makukisi; 
cooperation	tshumisano; 
cooperative	vhuanḓani; 
cooperatives	vhuanḓani; 
coordinate	 pfananya; konanya; 
coordinated	pfananya; 
coordinating	pfananya; 
coordination	pfananyo; 
cope	langea;  shumana na; 
copies	 kopa; khophi; kopi; 
copy	 -kopa;  kopa; khophi; 
core	mbilu; 
corner	khuḓa; 
cornerstone	thikho; 
corporation	 feme;  khamphani; bindu; 
corporations	 feme; khamphani;  mabindu; 
corps	 khamphani;  yuniti; tshigwada; 
correct	 -lulamisa;  -lugaho; lugaho; 
correction	ndulamiso; 
correctional	dzudzanya;  khakhululo;  lugisa;  ndulamiso; 
corrections	ndulamiso; 
corrective	-ndulamiso; 
correctly	-hone; 
correspondence	ṱanganya;  anḓana;  pfana;  ṅwalelana; 
corresponding	-pfana; 
corrupt	-tshinyadza; 
corruption	tshanḓanguvhoni; 
cost	 thengo; mutengo;  -vhea mutengo; 
cost-effective	mbambadzo;  ita tshelede;  vhuelwa; 
costs	 vhea mutengo;  thengo; mutengo; 
could	 valela zwitsimbini; khene; 
council	khoro; 
councillor	mukhantseḽara; 
councillors	vhakhantseḽara; 
councils	khoro; 
counsel	thuso;  ṱhuṱhuwedzo; ngeletshedzo; tsivhudzo; 
counselling	nyeletshedzo;  khuthadzo; 
count	-vhala; 
countdown	u vhala zwikhala nga u sielisana; 
counter	muvhali; 
counterclaim	mbilo ya u badela iṅwe mbilo; 
counterpart	lingana;  zwino elana; 
counterparts	lingana;  zwino elana; 
countries	shango; 
country	shango; 
country's	shango; 
countrywide	shangoḽoṱhe; 
couple	 zwivhili;  para;  tshivhili; lunzhi; ṱuma; 
coupled	 zwivhili;  para; ṱuma; tshivhili; 
coupon	khuphoni; 
courage	ṱhuṱhuwedzo; 
course	khoso;  ngavho; 
courses	khoso;  ngavho; 
court	khothe; 
court's	 khoro; khothe; 
courtesy	vhuhwavho; 
courts	khothe; 
cover	 fukedza: putela; dzumba;  fuka;  tibedza; 
coverage	vhonisi; vhiga; 
covered	 fukedza: putela; dzumba;  fuka;  tibedza; 
covering	 tshifukedzi;  luvhemba; putela; 
covers	 fukedza: putela; dzumba;  fuka;  tibedza; 
covet	-emula; 
coveted	emula; 
cradle	vhulalashie; 
craft	vhutsila;  vhutsila ha zwanḓa; 
crafter	muvhaḓi; 
crafters	vhavhaḓi; 
crafts	vhutsila;  vhutsila ha zwanḓa; 
crater	 mutwe; mala; lubuli, dzanyo; 
create	-sima; 
created	sima; 
creates	sima; 
creating	sima; 
creation	 mbumbo; tsiko; 
creative	-konaho u sika; 
creativity	vhusiki; 
creator	musiki; 
creators	vhasiki; 
credibility	fulufhedzea; 
credible	konadzea;  tendisea;  fulufhedzea; 
credit	khiredithi; 
creditor	mukolodwa; 
creditors	vhakolodwa; 
credits	khiredithi; 
creed	lutendo;  dokotirini; dogima;  pfunzothendwa; 
cricket	 tsenene; khirikhethe; 
crime	vhugevhenga; 
crimes	vhugevhenga; 
criminal	 mupfukamulayo; mutshinyi; 
criminals	 mupfukamulayo; vhatshinyi; 
crisis	khuḓano; 
criteria	nḓila; 
criterion	nḓila; 
critical	 tsha vhuṱhogwa; zwihulu;  tsha ndeme; 
critically	 tsha vhuṱhogwa; zwihulu;  tsha ndeme; 
crop	tshiliṅwa;  dyelo; 
crops	dyelo;  tshiliṅwa; khano; 
cross	tshifhambano; 
cross-border	pfuka mukano;  wela mukano; 
crucial	 tsha vhuṱhogwa; tsha ndeme; 
culminate	 mafhedziselo;  magumo; fhelisa;  vala; 
culmination	 mafhedziselo;  magumo; fhelisa;  vala; 
cultural	zwa mvelele; 
culture	mvelele; 
cultures	mvelele; 
cup	khaphu; 
curate	dzudzanya;  muthusamufunzi; mufarisamufunzi;  tshanḓa tsha mufunzi;  mulangamiziamu;  topola zwiṱanwa muziamu; 
curator	muṱhogomeli wa vhutsila; 
curators	muṱhogomeli wa vhutsila; 
currency	tshelede; 
current	lutsinga; 
currently	zwino;  tshino tshifhinga;  zwazwino; 
curriculum	 theapfunzo; kharikhuḽamu; 
curve	 govhe;  kheve; khona; 
custodian	mulisa;  mulavhelesi;  muunḓi; 
custodians	vhalisa; vhalavhelisi;  vhaunḓi; 
custody	u valelwa;  vhuunḓi; 
custom	mikhwa; 
customary	sialala; 
customer	murengi; 
customers	vharengi; 
customs	mikhwa; 
cut	mbanga;  u tshea; 
cutting	mupilimulo; 
daily	 ḓuvha na ḓuvha;  maḓuvha oṱhe;  musi nga musi; ḓuvha ḽiṅwe na ḽiṅwe; 
dam	 tshipata; -thivha mulambo;  -dzivha;  damu; 
damage	 tshinyalo;  -tshinyadza; tshinyalelo;  -tshinya; 
damages	 tshinyalo; tshinyalelo;  tshinya;  tshinyadza; 
dance	 mutshino; tshina; 
dancer	mutshini; 
dancers	mutshini; 
dances	mutshino;  mitshino; 
danger	khombo;  phanzi; 
dangerous	-khombo; 
dark	swiswi;  ho swifhala;  tshitswu; 
databases	databeisi; 
date	 deithi; datumu; 
dated	tsha kale; tshofhelelwaho nga tshifhinga; 
dates	tshevho; 
dawn	maṱambanḓou; 
day	ḓuvha; 
days	maḓuvha; 
dead	mufu; 
deadline	datumu ya u fhedziseala; tshifhinga tsha u vala; 
deaf	dzinganḓevhe; 
deal	 thanda vhunzhi; ita;  shuma;  fhandekanya;  khethekanyo; 
dealer	 mushavhi; murengisi; 
dealers	vharengisi;  vhashavhi; 
dealing	vhubindudzi; rengisa; vhambadza;  mbambadzo; 
deals	 vhambadza; thendelano; ṱhirantsikishini;  nzudzanyo;  thengiselano;  konṱiraka; 
dealt	 vhambadza; thendelano; ṱhirantsikishini;  nzudzanyo;  thengiselano;  konṱiraka; 
dear	funwaho; tshiḓuraho; mufunwa; 
death	lufu; 
deaths	mpfu; 
debate	khanedzano;  u hanedzana; 
debated	 hanedzana; khanedzano; 
debates	 hanedzana; khanedzano; 
debt	mulandu; 
debtor	mukolodi; 
debtor's	 re na mulandu; muvhilwa;  re na tshikolodo; 
debts	milandu; 
decade	miṅwaha ya fumi; 
decades	miṅwaha ya fumi; 
deceased	mufu; 
decent	 khuliso; ndugelo; 
decide	-tshea mafhungo; 
decided	 langana; humbula;  tshea mafhungo; 
decides	tshea mafhungo; 
deciding	tshea mafhungo; 
decision	tsheo;  tsheo ya mafhungo; 
decision-making	u dzhia tsheo; 
decisions	tsheo;  tsheo ya mafhungo; 
declaration	mulevho; 
declare	ḓivhadza; 
declared	 dzumbulula;  bvisa; kwaṱhisa; amba; 
declares	ḓivhadza; 
decline	 landula;  lamba; hana; 
declined	 landula;  lamba; hana; 
declines	 landula;  lamba; hana; 
declining	 landula;  lamba; hana; 
decrease	fhungudza; 
decreased	fhungudza; 
decryption	ita uri zwi pfesesee; ṱhalutshedzo;  ṱhaluso; 
dedicate	kumedza;  -kumedza; 
dedicated	kumedza; 
dedication	vhukumedzi; 
deduct	-ṱusa; 
deducted	ṱusa; 
deduction	muṱuso; 
deductions	miṱuso; 
deed	ṱanziela ya vhuṋe; 
deeds	ṱanziela ya vhuṋe; 
deem	vhona;  linganya; 
deemed	vhona;  linganya; 
deems	vhona;  linganya; 
deep	tsa; dindi ḽo tsaho;  vhuswatata;  tsaho; 
deepen	tsisa fhasi fhasi; vhuswata; 
deeper	tsa;  vhuswatata; dindwi ḽo tsaho;  tsaho; 
deeply	tsisa fhasi fhasi; vhuswata; 
default	khakha; kundelwa; 
defect	 posa; mulandu; 
defence	tsireledzo; 
defend	 tsireledza;  lamulela;  lwela; thivhela;  ambela;  imelela; kwatisa; 
defendant	muhwelelwa; muvhilaelwa; 
defiance	lunyadzo; 
deficiencies	ṱhahelelo;  u kundelwa; 
deficit	ṱhahelelo; 
deficits	ṱhahelelo; 
define	-ṱanḓavhudza; 
defined	ṱanḓavhudza; 
defines	ṱanḓavhudza; 
defining	ṱanḓavhudza; 
definition	ṱhalutshedzo;  ṱhanḓavhudzo; 
definitions	ṱhalutshedzo;  ṱhanḓavhudzo; 
degree	digirii; 
degrees	digirii; 
delay	 lengisa;  tshilengo; lenga; 
delayed	 lengisa;  tshilengo; lenga; 
delays	 lengisa;  tshilengo; lenga; 
delegate	murumelwa;  -rumelwa; 
delegated	rumelwa;  murumelwa; 
delegates	rumelwa;  murumelwa; 
delegation	vhurumelwa; 
delegations	vhurumelwa; 
delete	phumula; 
deleted	phumula; 
deletion	thutha; 
deliberate	rera;  nga khole;  elekanya; 
deliberately	rera;  nga khole;  elekanya; 
delighted	takala; 
deliver	u isa;  u bebisa; 
delivered	 bebisa; isa; 
delivering	 bebisa; isa; 
delivers	 bebisa; isa; 
delivery	u vhofholowa; 
demand	 ṱoḓa; muvhilo;  ṱhoḓea; 
demands	 ṱoḓa; muvhilo;  ṱhoḓea; 
demarcation	mukano; 
democratically	vhuvhusavhoṱhe; 
demographic	tsha dimogirafi; 
demonstrate	sumbedza;  gwalaba; 
demonstrated	sumbedza;  gwalaba; 
demonstrates	sumbedza;  gwalaba; 
demonstration	misumbedzo;  u sumbedza;  musumbedzo; 
denied	hana; 
dental	maṋo; 
deny	u hana; 
department	muhasho; 
department's	muhasho; 
departmental	-muhasho; 
departments	muhashwana; muhasho; 
departure	tshimbila;  ṱuwa; 
depend	 fulufhela; lavhelesa; 
dependants	 fulufhela; lavhelesa; 
dependence	u ḓiimisa; 
dependent	-fulufhela; 
depending	 fulufhela; lavhelesa; 
depends	 fulufhela; lavhelesa; 
deploy	rumela; 
deployed	rumela; 
deployment	 vhewa;  nzudzanyo;  vhea;  tshidzulo; tshiimo; 
deposit	 diphositha;  masalela; diphosithi; 
deposited	 diphositha;  masalela; diphosithi; 
depository	vhulunga;  londota;  vhulungelwaho; kuvhanyanya; 
deposits	 diphositha;  masalela; diphosithi; dibositi; 
depreciation	tsa ha ndeme; tsudzufhalo; 
depth	vhudzivha; 
deputies	zwanḓa zwa;  vhathusa; vhafarisa; 
deputy	mufarisa;  muthusa; tshanḓa tsha; 
derive	vhumba;  sika; 
derived	vhumba;  sika; 
descent	lushaka lwa vhaḓuhulu vha muthu; 
describe	 -buletshedza; -tala; 
described	 tala; buletshedza; 
description	mbuletshedzo; 
desert	 -laṱedza;  soga; phanga; 
design	 -ola; nyolo;  makolo; 
designate	 avhelwa;  buletshedzwa;  vhidzwa; dzina; 
designated	khetwa;  nangwa; vhidzwa;  buletshedzwa; 
designation	vhuimo; 
designed	 nyolo; ola;  makolo; 
designer	muoli; 
designers	muoli; 
designs	 nyolo; ola;  makolo; 
desirable	tameaho; 
desire	 lutamo; tama;  nyemulo;  tamela;  funa; 
desired	 lutamo; tama;  nyemulo;  tamela;  funa; 
despite	naho zwo ralo; 
destination	 vhuiwa; vhuyo; 
destiny	vhuyo; 
destroy	tshinyadza; 
destroyed	tshinyadza; 
destruction	tshinyadzo; 
detail	tshidodombedzwa;  zwiteṅwa;  -vhudodombedzi; 
detailed	 zwiteṅwa;  tshidodombedzwa; vhudodombedzi; 
details	 zwiteṅwa; zwidodombedzwa;  vhudodombedzi; 
detained	valelwa; 
detainees	vhafariwa; vhavalelwa; 
detection	 tumbula; wanulusa;  ḓivha; 
detention	u valela; 
determination	wana; ta;  dzumbulula; 
determined	ḓiimisela; 
determines	ta; 
determining	ta; 
develop	-bveledza;  u aluwa; 
developed	 aluwa; bveledza; 
developing	 aluwa; bveledza; 
development	mveledziso;  nyaluwo; 
developmental	bveledza;  bvelela; 
developments	mveledziso;  nyaluwo; 
develops	 aluwa; bveledza; 
device	tshishumiswa;  -khavhanga; 
devices	 khavhanga; zwishumiswa; 
devolution	vhurumelwa; sidzulusa; 
dialogue	nyambedzano;  mufhindulano; 
dialogues	nyambedzano;  mufhindulano; 
diamond	 daimane; musendo; 
diamonds	 daimane; musendo; 
diaspora	mupfuluwo; 
dictionary	ṱhalusamaipfi; 
did	ita; 
didn't	sa ita; 
die	 u fa; u lovha; 
died	 fa; lovha; daizi; 
dies	 fa; lovha; daizi; 
differ	-fhambana; 
difference	phambano; 
differences	 phambano; phambano; tsala; 
different	 fhambana;  siana; fhambanaho;  ṱutshelana; 
differently	fhambana;  siana;  ṱutshelana; 
difficult	 lemela;  konḓa;  konḓaho; lemelaho; laṱisa; 
difficulties	tshikundisi; 
difficulty	tshikundisi; 
digital	didzhithala; 
dignified	 ṱhonifho; vhuhulwane;  tshirunzi; 
dignitaries	vhaṱhomphei; vhahulwane; 
dignity	tshirunzi; 
dimension	muelo; 
dimensions	sia; 
dinner	dina;  tshilalelo; 
diploma	dipuloma; 
diplomatic	 vhuswaledzeli; vhuvhuyefhadzi; 
direct	-luga; 
directed	luga; 
directing	luga; 
direction	sia; 
directions	sia; 
directives	ḽiitele; 
directly	thwii; 
director	mulangi; 
director-general	mulangi muhulwane; 
directorate	ndangulo; 
directors	vhalangi; 
directs	luga; 
disabilities	vhuholefhali; 
disability	vhuhole; 
disabled	holefhala; 
disadvantage	tshikonḓisi; 
disadvantaged	tshikonḓisi; 
disaster	tshiwo;  -bulayo; 
disasters	 bulayo; tshiwo; 
discharge	malanga; 
discharged	 tshiluḓibviswa; malanga; tshadzhuluwo; 
disciplinary	ndaṱiso;  vhulayi;  ndayo; 
disciplines	ndaṱiso; 
disclaimer	ndambavhuḓifhinduleli; 
disclose	ambulula;  bvisela khagala; 
disclosed	ambulula;  bvisela khagala; 
disclosure	ambulula;  bvisela khagala; 
discourse	desethesheni; nyambedzano;  therisano;  vhudavhidzano;  tshipitshi; 
discover	-tumbula; 
discovered	tumbula; 
discovery	 tumbula; vhutumbuli; 
discretion	vhuṱali; 
discretionary	 muhumbulo;  vhuṱali; ndivho; 
discrimination	khethululo; 
discuss	rera; 
discussed	rera; 
discussing	rera; 
discussion	rera;  murero; 
discussions	rera;  therisano; 
disease	vhulwadze; 
diseases	vhulwadze; 
dismissal	pandelwa;  thathwa; 
disparities	 sa elana; phambano;  sa tevhekana;  sa lingana; 
dispensation	nyimele ya poḽotiki ya tshifhinga tshenetsho; 
display	 -ṱana; ṱana; 
displayed	ṱana; 
displaying	ṱana; 
disposal	 fhelisa; bvisa; laṱa; 
disposed	laṱa; 
dispossession	 ṱhahelelo;  sivhe na tshitshu; sa phetheya;  tsirusa; bvisa;  shaya; 
dispute	phambano;  -ṱaṱisana; 
disputes	phambano;  ṱaṱisana; 
disqualified	 sa tea;  lambela;  bviswa; thivhela;  iledzwa; 
dissatisfied	vhilaela;  vhilaedza; 
dissemination	laṱanya; balanganya; 
dissolution	 magumo; fhelisa;  vala; 
dissolve	 ṋoka; fhaladza; 
dissolved	 ṋoka; fhaladza; ṋwisa; 
distance	vhukule; 
distant	 kule;  vhukule; tshikhala; 
distinct	 fhambana;  siana; fhambanaho;  ṱutshelana; 
distinction	furalelanaho; dzi sa fani; 
distinctions	 fhambana; khethekanyo; 
distinctive	furalelanaho; dzi sa fani; 
distinguished	 ṱalukanya; khetha; 
distribute	kovhekanya;  -kovhekanya; 
distributed	kovhekanya; 
district	tshiṱiriki; 
districts	tshiṱiriki; 
distrust	u sa themba; 
diverse	bva; 
diversion	 vhaṅwe; bva; fhambanaho; dziṅwe; 
diversity	fhambana; 
diverted	pambuwa; tambisa; 
divide	 -kovha; kovha;  khethekanya; 
divided	kovha;  khethekanya; 
dividend	 mukanzwo; kovhiwa; 
dividends	 mukanzwo; ḽikovhiwa; kovhiwa; 
division	khethekanyo;  u kovha;  mukovho; 
divisions	khethekanyo;  kovha;  mukovho; 
divorce	ṱhalano; 
do	 itesa; ita;  shuma; 
doctor	dokotela;  maine;  ṅanga; 
doctorate	vhudokotela; 
doctors	 vhomaine; madokotela;  ṅanga; 
document	ḽiṅwalwa; 
documentation	 ḽiṅwalo;  u kuvhanganya maṅwalo; ḽiṅwalo ḽa vhuṱanzi; 
documented	ḽiṅwalwa; 
documenting	ḽiṅwalwa; 
documents	maṅwalwa; 
does	ita; 
doesn't	sa ita; 
doing	ita; 
dollar	doḽa; 
domain	pfunzo ya kule; 
domains	pfunzo ya kule; 
domestic	-muṱani; 
dominant	thakhula; 
domination	rena; vhusa; 
don	ambara;  mugudisi; 
don't	songo; 
donation	ndambedzo; 
donations	ndambedzo; 
done	fhedza; 
donor	muṋetshedzi; 
donors	vhaṋetshedzi; 
door	vothi; 
doors	mavothi; 
double	nga zwivhili; 
doubt	 gungula; timatima;  kanakana; thimothimo;  vhilahedza; 
down	 mithenga; fhasi;  vhuthenga; 
download	-sudzulusa; 
downtown	tshivhindini tsha ḓorobo;  vhukati ha ḓorobo; 
downturn	tsela fhasi; vhutsaekonomi; 
draft	mvetomveto; 
drafted	mvetomveto; 
drafting	mvetomveto; 
drama	ḽitambwa; 
dramatic	ḽitambwa;  ḓirama; 
draw	 u ola; -khesha; 
drawing	 nyolo; ola; 
drawn	 kiwa;  u kheshwa tsheke; oliwa;  kokodziwa;  u lingana; taliwa;  u wa mafhuri;  u bviswa tshelede; 
dream	muloro; 
dreams	miloro; 
drew	tamba u lingana; ola;  khesha; 
drink	tshinwiwa; 
drinking	nwa; 
drive	Mukoto; 
driven	Mukoto; 
driver	mureili; 
driver's	 mutshaeli; mutshimbidzi;  mureili;  ḓiraiva; 
drivers	vhareili; 
driving	Mukoto; 
drop	 -tsa; shotha; 
drug	 tshidzidzivhadzi; mushonga; 
drugs	ḓiraga; mishonga;  zwidzidzivhadzi; 
drum	 ḓiramu; ngoma; 
dry	 -omaho; oma;  -oma;  -omisa;  yo omaho; 
dual	 -nga huvhili; -vhili; 
due	-mulandu; 
duly	teaho;  fanelaho; 
duplicate	mukokotolo; 
duplication	mukokotolo; 
duration	tshifhinga; 
during	vhukati ha; 
duties	miingatengo;  pfanelo;  vhuḓifhinduleli;  mithelo; mishumo;  ndivhanelo; 
duty	 pfanelo;  vhuḓifhinduleli;  muthelo; mushumo;  ndivhanelo; 
dynamic	dainamiki; 
dynamics	dainamiki; 
e-mail	 poswo nga eḽekiṱhironiki; emeiḽi;  imeiḽa; 
each	tshithihi tshithihi; 
earlier	 mathomoni;  phanḓa;  vhilula;  fhindutshela;  vutshela; ṱavhanya; 
earliest	ṱavhanyedzesa; fhinduwesa;  vhilulesa; 
early	 fhindutshela;  vutshela; vhilula; 
earmarked	vhaledzelwa;  vhetshelwa thungo; kovhelwa;  funga; 
earn	- hola; 
earned	hola; 
earning	hola; 
earnings	mbadelo;  malamba a mushumi;  muholo; 
earth	ḽifhasi; 
easier	sa konḓa; 
easily	leluwaho;  nga vhulenda;  zwavhuḓi; 
east	 vhubvaḓuvha; Vhubvaḓuvha; 
eastern	vhubvaḓuvha; 
easy	-sa konḓa; 
economic	ekonomi; 
economically	vhulungaho ekonomi; sa tambisiho ekonomi; 
economies	ikonomi; 
economists	vhoraekonomi; 
economy	ikonomi; 
ecosystem	ekhosisteme; 
ecosystems	ekhosisteme; 
edge	lumeme; 
edit	dzudzanya; 
editing	dzudzanya; 
edition	nzudzanyo; 
editor	mudzudzanyi; 
editors	vhadzudzanyi; 
educate	funza; 
educated	funza; 
educating	funza; 
education	 u funza; pfunzo; 
educational	zwa pfunzo;  -pfunzo; 
educator	mudededzi; 
educators	vhadededzi; 
effect	-bveledza; 
effected	bveledza; mveledzwa; 
effective	 bveledzaho mvelelondavhelelwa; -bveledzaho; 
effectively	 bvelelaho; itaho;  shumaho; 
effectiveness	 shuma;  ita;  bvelela; 
effects	bveledza; mveledzwa; 
efficacy	ita;  shuma;  ndeme;  bvelela; 
efficiency	vhukoni; 
efficient	vhukoni;  -vhukoni; 
efficiently	 bvelelaho; itaho;  shumaho; 
effort	vhuḓidini; 
efforts	vhuḓidini; 
eight	malo; 
either	kana; 
elderly	vhuhulwane;  vhualuwa; 
elders	 vhaaluwa; vhahulwane; 
elect	khetha;  -khetha; 
elected	khetha; 
election	khetho; 
elections	khetho; 
electoral	khetho; 
electrical	muḓagasi; 
electricity	muḓagasi; 
electrification	dzhenisa muḓagasi; 
electronically	eḽekiṱhironiki; 
elects	khetha; 
elevate	 imisa;  isa nṱha; 
eleven	fumithihi; 
eligible	tewa;  fanelwa; 
eliminate	-bvisa; 
eliminated	bvisa; 
elimination	u bvisa; 
eloquently	elela; fhuredzela; 
else	 muṅwe; u sili; 
elsewhere	 huṅwe;  huṅwe fhethu; thungo iṅwe; 
emanating	 thoma; bva; 
emancipation	mbofhololo; 
embark	lwendo;  dzhena; 
embarked	lwendo;  dzhena; 
embarking	lwendoni;  dzhena; 
embassies	embasi; 
embassy	embasi; 
embed	-somedza; 
embedded	somedza; 
embodiment	 tshifanyiso;  tshivhumbeo;  ambadzwa; tsumbo; 
embrace	 kuvhatedza; katela; 
embraced	 kuvhatedza; katela; 
embraces	 kuvhatedza; katela; 
emerge	 bva;  bvelela; 
emerged	 bvelela; bva; 
emergence	 bvelela; bva; 
emergency	 zwa shishi;  tshiimo tshi toḓaho u ṱavhanya; ndiliso; 
emergent	 aluwa; bvelela; 
emerging	 bva; u bvelela; 
eminent	 khetheaho;  wa bvumo; hulwane;  tsha phungo mbuya; ndeme;  ḓivheaho; 
emission	 phaḓaladzo; vhubveledzi; muhasaladzo; 
emissions	 phaḓaladzo; vhubveledzi; muhasaladzo; 
emoluments	 malamba; miholo; 
emotion	nyanyuwo; 
emotional	 dzikuwa; nyanyuwa; 
emotions	nyanyuwo; 
emphasis	 nyombedzelo; khwaṱhisedzo; 
emphasise	 ombedzela; khwaṱhisedza; 
emphasised	 ombedzelwa; khwaṱhisedzwa; 
emphasises	 ombedzela; khwaṱhisedza; 
employ	thola; 
employed	thola; 
employee	mutholiwa; 
employees	vhatholiwa; 
employer	mutholi; 
employers	vhatholi; 
employing	thola; 
employment	mushumo; 
employs	thola; 
empower	maanḓafhadza; 
empowered	maanḓafhadzwa; 
empowering	maanḓafhadza; 
empty	-shulula;  -si na tshithu; 
emulate	vhambedza;  edzisela;  ṱaṱisana; 
enable	-konisa; 
enabled	konisa; 
enables	konisa; 
enabling	konisa; 
enacted	mulayo;  mulevho;  bulwaho;  phasiswa; 
enacting	mulayo;  mulevho;  bulwaho;  phasiswa; 
enactment	mulayo;  mulevho;  bulwaho;  phasiswa; 
enactments	mulayo;  mulevho;  bulwaho;  phasiswa; 
encourage	ṱuṱuwedza; 
encouraged	ṱuṱuwedza; 
encourages	ṱuṱuwedza; 
encouraging	ṱuṱuwedza; 
end	magumo; 
endanger	u dzhenisa khomboni; 
endangered	u dzhenisa khomboni; 
endeavor	edzisa; 
endeavour	-edzisa; 
endeavours	edzisa; 
ended	magumo; 
ending	 guma; fhela; 
endorse	 themendela;  khwaṱhisedza; tendela; 
endorsed	tendelwa;  khwaṱhisedzwa;  themendelwa; 
endorsement	thendelo;  khwaṱhisedzo;  themendelo; 
ends	magumo; 
enduring	 sa fhela mbilu;  konḓelela; 
energy	fulufulu; 
enforce	ombedzela; 
enforced	ombedzela; 
enforcement	kombetshedza u tevhedza; 
engage	 tholwa;  shela mulenzhe; kunga;  vha na mushumo; 
engaged	 dzewa; farekanea;  fhulufhedziswa u vhinga; 
engagement	nyanḓano; 
engagements	nyanḓano; 
engaging	kunga; 
engender	 dzwala; bveledza; 
engendering	 dzwala; bveledza; 
engine	ṱhoho;  nzhini; 
engineer	muinzhiniara; 
engineering	munzhiniere; muinzhiniara; 
engineers	vhanzhiniere; vhainzhiniara; 
enhance	khinisa; 
enhanced	khwiniswa; 
enhancement	khwiniso;  khwinisa; 
enhancing	khwinisa; 
enjoy	ḓiphina; 
enjoyed	ḓiphina; 
enormous	 zwihulwanesa; khulwanesa; 
enough	lingana; 
enquiries	tsenguludzo; 
enquiry	ṱhoḓisiso; 
enrich	-pfumisa; 
enrol	-ṱanganedza; 
enrolled	ṱanganedza; 
enrolment	ṱhanganedzo; 
enshrined	tsireledzwa; 
ensue	-bvelela; 
ensuing	bvelela; 
ensure	fulufhedzisa; 
ensured	fulufhedzisa; 
ensures	fulufhedzisa; 
ensuring	fulufhedzisa; 
entail	katela;  ṱoḓa;  angaredza; 
entails	katela;  ṱoḓa;  angaredza; 
enter	dzhenisa; 
entered	dzhenisa; 
entering	dzhenisa; 
enterprise	bindu; 
enterprises	mabindu; 
enters	dzhenisa; 
entertainment	vhumvumvusi; 
entire	suvha;  -oṱhe; 
entirely	tshoṱhe; 
entities	zwiimiswa; 
entitled	 tewa; tendelwa;  fanelwa; 
entity	tshiimiswa; 
entrance	khoro;  tshivhana;  ha u dzhena;  muṋango; 
entrepreneur	mubindudzi; 
entrepreneurial	vhubindudzi;  vhushavhi;  vhuvhambadzi;  makwevho; 
entrepreneurs	vhabindudzi; 
entrepreneurship	vhubindudzi; 
entries	madzhenele; 
entrusted	fhulufhelwa; 
entry	madzhenele; 
envelope	fulobo; 
environment	 mupo; vhupo; 
environmental	vhupo; 
environments	vhupo; 
envisaged	sedzwa;  bula zwiḓaho;  humbulelwa;  vhona zwiḓaho;  elekanya;  linganya; 
envisages	sedzwa;  bula zwiḓaho;  humbulelwa;  vhona zwiḓaho;  elekanya;  linganya; 
epidemic	dwadze; 
equal	eḓana;  u lingana;  eḓana na; 
equality	ndinganyelo; 
equally	zwi eḓanaho; 
equals	lingana na; 
equipment	zwishumiswa; 
equipped	shomedza; shomedzwa; 
equitable	tshiitwaho nga ndelekanyo; pfalaho;  sa dzhia sia; 
equity	lingana;  sa dzhia sia;  lugaho;  eḓana;  fanelaho; 
equivalent	ndingano; 
era	 tshikhathi; tshifhinga; 
eradicate	 tupula; bvisa; 
eradicating	 tupula; bvisa; 
eradication	mutupulo; 
error	khakho; 
errors	khakho; 
escape	u ponya; 
escapes	phonyoka; ponya; 
especially	zwihuluhulu;  nga maanḓa; 
essence	vhukwaho; 
essential	ṱoḓeaho;  -ṱoḓeaho; 
essentially	 tsha vhuṱhogwa; tsha ndeme;  tsha mutheo; tshihulwane; 
establish	u thoma; 
established	thoma; 
establishes	thoma; 
establishing	thoma; 
establishment	tshiimiswa;  thomiwa; 
establishments	zwiimiswa; 
estate	thundu;  ifa;  kusi; 
estates	thundu;  ifa;  ndaka; 
esteemed	 sedzesa zwihulu;  khuliso;  hulisa;  huliswa; ndeme; 
estimate	 u anganya; anganya;  -gaganya; 
estimated	 gaganya; anganya; 
estimates	 gaganya; anganya; 
ethical	mikhwa;  tshavhuḓi;  vhuhwavho; tea;  lugaho;  hulisa;  huliswa;  fanelaho; 
ethics	vhuḓifari; 
ethnic	-mirafho;  zwa lushaka; 
ethnicity	lushaka; 
ethos	 ndivho khulu; lushaka;  mukhwa wa muthu;  mikhwa; 
evaluate	u ela ndeme; 
evaluated	ela ndeme; 
evaluating	ela ndeme; 
evaluation	vhupimathengo; 
eve	mulovha;  ḓuvha ḽo fhiraho; 
even	 -linganya;  -lingana; -linga; 
evening	madekwana; 
event	 mutambo; tshiwo; 
events	mitambo;  zwiwo; 
eventually	phetho;  ya u fhedzisela;  ya u fhiledza; 
ever	 tshifhinga tshoṱhe;  lini na lini;  misi yoṱhe; tshikhathi tshiṅwe na tshiṅwe;  tshifhinga tshiṅwe na tshiṅwe; 
every	ṅwe na ṅwe; 
everybody	vhoṱhe;  muṅwe na muṅwe; 
everyone	vhoṱhe;  muṅwe na muṅwe; 
everything	zwoṱhe;  tshiṅwe na tshiṅwe; 
evidence	vhuṱanzi; 
evident	vha khagala; 
evolve	-bvelela; 
evolved	bvelela; 
evolving	bvelela; 
ex	 wa u rangela;  wa phanḓa; fhiraho;  wa kale; 
exactly	nga u lugamedza; zwavhuḓivhuḓi; 
examination	mulingo; 
examinations	ṱholo; mulingo; 
examine	linga;  u linga; 
examined	linga; 
example	 tsumbedzo; tsumbo; 
examples	 tsumbedzo; tsumbo; 
exams	milingo; 
exceed	fhira;  u fhira; 
exceeded	fhira; 
exceeding	 fhirisa; fhira; 
exceeds	fhira; 
excelled	konesa; 
excellence	vhukoni; 
excellent	vhuḓivhuḓi; 
except	 nga nḓani ha; arali i singa; 
exceptional	vhukoni; khethea;  konesa; 
excess	fhirisa mpimo; 
excessive	 fhirisa; fhira; 
exchange	rengiselana;  -rengiselana; 
exchanges	rengiselana; 
excise	 ṱusa;  thutha; bvisa;  phumula; 
excitement	manyanyuwo; 
exciting	ṱuṱuwedza;  nyanyulaho;  nyanyula; susumedza; 
exclude	 lamba;  pambuwa; bvisa; laṱa;  pambula; 
excluded	 lamba;  pambuwa; bvisa; laṱa;  pambula; 
excluding	 lamba;  pambuwa; bvisa; laṱa;  pambula; 
exclusion	 lamba;  muṱuso;  pambuwa;  bvisa;  lambela;  hangwa;  bviswa; thivhela; laṱa;  iledzwa;  pambula; 
exclusions	 muṱuso;  lambela;  hangwa;  bviswa; thivhela;  iledzwa; 
exclusive	masakha;  vhea mikano;  maimo a nṱha; khethea;  kiḽasi ya nṱha; 
exclusively	 zwoṱhe nga tshithihi;  khunyeledza; fhedza; 
execute	ita;  phetha; 
executed	itwa;  phethwa; 
executing	 ita;  phetha; 
execution	 ita;  phetha; 
executive	khorondanguli; 
exempt	-vhofhololwa; 
exempted	vhofhololwa; 
exemptions	mutshipiso; 
exercise	 nḓowedzo;  -ḓowedza; nyonyoloso;  u ḓionyolosa; 
exercised	 nḓowedzo; nyonyoloso;  nḓowenḓowe;  ḓowedza;  ḓionyolosa; 
exercises	 nḓowedzo;  onyolosa; nyonyoloso;  ḓowedza; 
exercising	 nḓowedzo; nyonyoloso;  nḓowenḓowe;  ḓowedza;  ḓionyolosa; 
exhibit	ṱano; 
exhibition	ṱano; 
exhibitions	ṱano; 
exile	 muthathiwa; -thatha; 
exist	-vha hone;  vha hone; 
existed	vha hone; 
existence	-vha hone; 
existing	 tshila; sala;  vha hone; 
exists	vha hone; 
exit	 enda; ṱuwa; 
expand	kukumuwa;  tatamudza; 
expanded	kukumuwa;  tatamudza; 
expanding	kukumuwa;  tatamudza; 
expansion	 ṱharamuwo;  thathamudzo; mukukumuwo; 
expect	-lavhelela; 
expectation	ndavhelelo; 
expectations	ndavhelelo; 
expected	lavhelela; 
expedient	tendisa nga ngoho; ine hu nga shunwa ngayo;  tshi re na thuso; 
expenses	mbadelo; zwibviswa; 
expensive	 -ḓura; ḓura; 
experience	tshinyalelo;  -tshenzhela; 
experienced	 tshenzhela; tshinyalelo; 
experiences	 tshenzhela; tshinyalelo; 
experiencing	 tshenzhela; tshinyalelo; 
expert	 muḓivhi; makone; 
expertise	vhukoni; 
experts	 muḓivhi; makone; 
expiration	-femela nnḓa; 
expired	 fa;  xela;  magumo; lovha;  dzama;  fhelelwa nga tshifhinga; 
expiry	 fa;  xela;  magumo; lovha;  dzama;  fhelelwa nga tshifhinga; 
explain	ṱalutshedza; 
explained	ṱalutshedza; 
explains	ṱalutshedza; 
explanation	ṱhalutshedzo; 
explanatory	 eledza;  fanyisela; thuso;  funza;  ṱalutshedza;  eletshedza;  ṱalusa; 
explicit	pfalaho;  vhonadzaho;  nakisa tshenisa; 
exploitation	 shumisa; tambisa; tambudzwa; 
explore	tandula;  -sedzulusa;  -tandula; 
explored	 tandula; sedzulusa; 
explores	 tandula; sedzulusa; 
exploring	 tandula; sedzulusa; 
export	tsudzuluso; 
exports	mbambadzwaseli; 
expose	 dzumbulula; ṱana; 
exposed	 ṱanwa; dzumbululwa; 
exposure	u shaya vhudzulo; 
express	bvukulula;  -bula;  tshidimela tsha luvhimba; 
expressed	 bvukulula; bula;  tshidimela tsha luvhimba; 
expression	 vhuḓinyanyuli; mbonalelo; 
expressions	 vhuḓinyanyuli; mbonalelo; 
expressly	 khagala;  tiwaho; vhukuma;  ngoho; 
extend	hudza;  -lapfisa; 
extended	 hudza; lapfisa; 
extending	 hudza; lapfisa; 
extends	 hudza; lapfisa; 
extension	muengedzo; 
extensive	 angalala; vhuphara; 
extent	vhuhulu; 
external	nnḓa;  -nga nnḓa; 
extra	nyingo; 
extract	-bvisa;  tshipiḓa;  u kula; 
extraordinary	mangadzaho;  zwisili; 
extreme	kalula; 
extremely	kalulaho; 
eye	 buli; iṱo; 
eyes	 u kona u vhona; maṱo; 
face	 tshifhaṱuwo;  nga phanḓa ha;  lurumbu lwa nga nṱha; lurumbu; 
faced	 tshifhaṱuwo;  nga phanḓa ha;  lurumbu lwa nga nṱha; lurumbu; 
faces	 tshifhaṱuwo;  nga phanḓa ha;  lurumbu lwa nga nṱha; lurumbu; 
facilitate	 -leludza; -tshimbidza; 
facilitated	 leludza; tshimbidza; 
facilitates	 leludza; tshimbidza; 
facilitating	 leludza; tshimbidza; 
facilitation	 leludza;  tshimbidza; thusa; 
facilities	tshileludzi; 
facility	tshileludzi; 
facing	 livhana; sedza; 
facsimile	fekisi; 
fact	mbuno; 
factor	tshiitisi;  tshivhumbi; 
factors	 zwivhumbi; zwiitisi; 
factory	feme; 
facts	mbuno; 
fail	 shayea;  kundwa; balelwa;  bala;  feila; 
failed	 balelwa; kundelwa;  feila; 
failing	 balelwa; kundelwa;  feila; 
fails	 bala; kunda;  feila; 
failure	u kundelwa; 
failures	kundelwa; 
fair	 u sa dzhia sia; zwavhuḓi; 
fairly	tshavhuḓi tshi sa soleyi; 
fairness	 u sa dzhia sia; zwavhuḓi zwi sa soleyi; ndinganelo; 
faith	lutendo; 
fall	 wa;  tsa ha ndeme; 
fallen	 lovha; wa; 
falling	-tsa; 
falls	wa;  tsa ha ndeme; 
familiar	ḓowela;  ḓowelea; 
families	muṱa; 
family	muṱa; 
famous	ḓivheaho; 
fan	fene; 
fans	fene; zwipelepelu; 
far	kule; 
farewell	onesa; u phia zwavhuḓi;  nyonesano; 
farm	 lima na u fuwa; bulasi; 
farmers	vhorabulasi; 
farming	vhubulasi; 
farms	vhalimivhafuwi; bulasi; 
fashion	fesheni; 
fast	-ḓidzima; 
faster	ḓidzima; 
father	khotsi; 
fathers	khotsi; 
fault	 -wana vhukhakhi; khakheaho; 
favorite	tshitakalelwa; takalelwaho; 
favorites	tshitakalelwa; takalelwaho; 
favour	tshilidzi; 
favourable	funwaho;  takalelwaho; 
favourite	takalelwaho; 
fax	fekisi; 
faxed	fekisi; 
fear	nyofho; 
fears	nyofho; 
feasibility	 koneaho; iteaho; 
feature	 mafhungo a tshipentshela; mbonalo; 
featured	 mafhungo a tshipentshela; mbonalo; 
features	 mafhungo a tshipentshela; mbonalo; 
featuring	 mafhungo a tshipentshela; mbonalo; 
federal	muvhuso;  lushaka;  tshitshavha; 
federation	feḓerasi; 
fee	 tshelede; mbadelo; 
feed	 -ṋea zwiḽiwa; unḓa; 
feedback	khumelamurahu; 
feeds	 ṋea zwiḽiwa; unḓa; 
feel	fara;  pfa;  phuphuledza;  dodonga; 
fees	 tshelede; mbadelo; 
fell	 wa;  tsa ha ndeme; 
fellow	khonani;  thanga;  murole; 
felt	fara;  pfa;  phuphuledza;  dodonga; 
female	 -tshikadzi;  -tshisadzini; tshisadzi; 
females	 tshikadzi; tshisadzini;  tshisadzi; 
festival	vhuṱambo; 
festivals	vhuṱambo; 
festive	madakalo; 
fever	mufhiso; 
few	 -si gathi; zwiṱuku; 
fewer	 zwi si gathi; zwiṱuku; 
field	 tsimu; gammba; 
fields	 masimu; gammba; 
fifth	tsha vhuṱanu; 
fifty	fuṱhanu; 
fight	nndwa; 
fighter	mulwi; 
fighters	vhalwi; 
fighting	nndwa; 
figure	 sifhere; figara; 
figures	 sifhere; ḽiambe;  le; figara; 
file	 -feila; faela;  feila; 
filed	faela;  feila; 
files	faela;  feila; 
filing	faela;  feila; 
fill	ḓadzisa; ṱhophela;  ḓadza; 
filled	ṱhophiwa;  ḓadzwa; ḓadziswa; 
film	fiḽimu; 
filmmakers	muitafiḽimu; 
filmmaking	 vhusikabaisikopo; vhubveledzafiḽimu;  vhusikafiḽimu; 
films	fiḽimu; 
final	makhaulatshele; 
finalisation	 vuledza;  guma; fhedzisa;  phetha; 
finalise	 vuledza; phetha; guma; fhedza; 
finalised	 vuledza;  guma; fhedza;  phetha; 
finalising	 vuledza;  guma; fhedzisa;  phetha; 
finally	magumoni;  mafhedziseloni; 
finance	badela;  gwama; 
financed	badela;  gwama; 
finances	badela;  gwama; 
financial	zwa tshelede; 
financially	zwa masheleni; zwa tshelede; 
financing	badela;  gwama; 
find	-wana; 
finding	mawanwa; 
findings	mawanwa; 
finds	wana; 
fine	 lifhisa;  -suvhelelaho; mulifho;  ḽo tsha; 
fines	 lifhisa; ndaṱiso;  mulifho;  suvhelelaho; 
finest	 lifhisa; mulifho;  ḽo tsha;  suvhelelaho; 
fingerprints	ganḓisa magunwe;  khanḓiso dza minwe; magunwe; 
fire	mulilo; 
firearm	tshigidi; 
firearms	zwigwada; 
firm	-khwaṱhaho; 
firmly	nga maanḓa;  nga u khwaṱha; 
firms	khwaṱhaho; 
first	mathomo; 
firstly	 tsha u ranga; tsha phanḓa;  tsha u thoma; 
fiscal	muthelo; 
fish	khovhe; 
fisheries	vhureakhovhe; 
fishery	vhureakhovhe; 
fishing	vhureakhovhe;  -rea khovhe; 
fit	vili;  u vha na mutakalo;  u khwaṱhelela; 
fitting	 eḓanaho; teaho;  lugisa;  dzhenisa;  linganaho;  fanelaho; 
five	ṱhanu; 
five-year	zwa miṅwaha miṱanu; 
fixed	 tewa;  khwaṱhiswa; khwaṱhaho;  imiswa;  tshi sa dzinginyei;  lugiswa;  tetshelwa;  tshi sa tsukunyei; 
flag	fuḽaga;  fulaha; 
flags	fuḽaga;  fulaha; 
flagship	 tshikepe tsha nndwani;  pfufho; nṱha; ṋaledzi;  rangaphanḓa; 
flame	khavhu; 
flexibility	vhutepe; 
flexible	-tepaho; 
flood	 muḓalo; ḓala; 
floods	 muḓalo; ḓala; 
floor	 fuloro; fhasi;  tshitizi; 
flora	zwimela; 
floral	-maluvha; 
flow	muelelo; 
flower	dzuvha; 
flows	muelelo; 
fly	thunzi;  -fhufha;  u fhufha; 
flying	fhufha;  zwi fhufhaho; 
focus	lumba; 
focused	lumba; 
focuses	lumba; 
focusing	lumba; 
follow	 tevhekana; tevhela; 
followed	tevhelwa;  sala murahu; 
following	 ḓaho; tevhelaho; 
follows	 ḓaho; tevhelaho; 
food	zwiḽiwa; 
foot	mulenzhe;  futhi;  lwayo; 
football	futhibola; 
footsteps	 mitsindo; vhuṱala; 
for	zwa;  nga nṱhani ha uri;  ngauri; 
force	 maanḓa;  -kombetshedza; nungo; 
forced	kombetshedzwa; susumedzwa; 
forces	 maanḓa;  nungo; kombetshedza; 
forebears	 ṱutshela;  vhomakhulukuku; litsha; 
forefront	phanḓa; 
foreign	 -sili; mutsinda; 
foreigner	mubvannḓa;  musili; 
foreigners	vhasili; vhabvannḓa; 
forensic	forentsiki; 
forest	ḓaka; 
forests	ḓaka; 
forever	tshifhinga tshiṅwe na tshiṅwemisi yoṱhe;  tshifhinga tshoṱhe;  lini na lini; tshikhathi tshiṅwe na tshiṅwe; 
forfeited	 xelelwa;  lozwa; balelwa; 
forge	-bea; 
forged	bea; shondo; 
forget	hangwa;  livhala; 
form	 -humba;  tshivhumbeo;  -vhumba; fomo;  bannga; 
formal	-pfanelo; 
formally	 phanḓa; fomaḽa;  lwa tshiofisi; 
format	fometha; tshivhumbeo; 
formation	 mbumbo;  kuvhekanyele kwa vhatambi;  tshivhumbeo tsha matshinele; tsiko; 
formations	 mbumbo;  kuvhekanyele kwa vhatambi;  tshivhumbeo tsha matshinele; tsiko; 
formed	 vhumba;  tshivhumbeo; fomo;  bannga;  humba; 
former	-phanḓa; 
formerly	kale;  u thomani;  u rangani; 
forms	 vhumba; fomo;  bannga;  humba;  zwivhumbeo; 
formula	dandululo; 
formulation	 u vhumbiwa;  u thomiwa;  u sikiwa; thandululo; 
forth	phanḓa; 
forthcoming	zwine zwa ḓo bvelela; 
forthwith	bvela khagala; 
forum	foramu; 
forums	foramu; 
forward	phanḓa;  u bvisela phanḓa; 
forwarded	rumelwa; 
fossil	masalela; 
foster	bveledza; 
fostering	 unḓa; bveledza; 
fought	nndwa; 
found	thoma; 
foundation	mutheo; 
foundations	mutheo; 
founded	thoma; 
founder	muthomi; 
founding	thoma; 
four	iṋa; 
fourth	vhuṋa; 
frame	fureme; 
framework	muteo; 
frameworks	muteo; muhanga; 
franchise	pfanelo ya u vouta; 
fraternity	mbumbano; 
fraud	vhumenemene; vhufhura; 
fraudulent	zwa vhufhura; zwa vhumenemene; 
free	 vhofholowa; mahala; 
freed	vhofhololwa; 
freedom	mbofholowo;  vhupapadzi; 
freedoms	mbofholowo;  vhupapadzi; 
freely	 nga mahala; vhofholowa; 
freight	muhwalo; 
frequency	frikhwentsi; 
frequently	-ḓala; 
fresh	zwiswa;  zwitete; 
friend	khonani; 
friendly	vhukonani; 
friends	khonani; 
friendship	vhukonani; 
from	 u takuwa;  u bva;  u bva kha; kha; 
front	phanḓa; 
fruit	mutshelo; 
fruitful	bvelelaho;  zwo pfumaho; 
fuel	tshivhaswa; 
fuels	zwivhaswa; 
fulfil	swikela;  fhedzisela;  khunyeledza;  fusha;  phetha; 
fulfill	swikela;  fhedzisela;  khunyeledza;  fusha;  phetha; 
fulfilling	ṱuṱuwedza;  fusha;  takadza; 
full	-ḓala; 
full-time	wa tshoṱhe;  zwa tshoṱhe; 
fully	tshoṱhe;  lwo fhelelaho;  u ḓala nga maanḓa; 
function	 -shuma; mushumo; 
functional	shumaho; 
functionality	mushumo; 
functioning	 shuma; mushumo; 
functions	 shuma; mushumo; 
fund	tshikwama; 
fundamental	 zwa ndeme; zwihulwane; 
fundamentally	zwihuluhulu;  nga maanḓa; 
funded	tshikwama; 
funding	tshikwama; 
funds	masheleni;  lambedza; tshelede; 
funeral	mbulungo; 
furnish	ṋetshedza; 
furnished	ṋetshedzwa; 
furniture	fanitshara; 
further	hafhu;  isa phanḓa; 
furthermore	 nga nṱha ha;  futhi; nahone;  habe; 
future	vhumatshelo;  ḽikhathi ḽa; 
gain	 -wana; bindu; 
gained	wana;  bindu; 
gains	wana;  bindu; 
galleries	tshifhaṱo tsha vhutsila;  vhugalatenga; 
gallery	tshifhaṱo tsha vhutsila;  vhugalatenga; 
gamble	u gembula; 
gambling	gembula; mugembuḽo; 
game	 mutambo; phukha; 
games	mitambo;  phukha dza ḓaka; 
gap	gake; 
gaps	gake; 
garden	ngade; 
gardens	ngade; 
garnishee	muthu o ganishiwaho;  ndaela ya pfaramuholo; 
gas	gese; 
gateway	khoro; 
gather	kuvhangana; 
gathered	kuvhangana; 
gathering	 khunyeleli; muṱangano;  khuvhangano;  tshivhidzo; 
gave	fha;  beba;  ṋea;  ira;  laedza; 
gazette	gurannḓa ya muvhuso; 
geared	gere; 
gender	mbeu; 
gender-based	mbeu; 
general	angaredzwa;  dzhenerala; 
generally	 nga u angaredza; kanzhi; 
generate	bveledza; 
generated	bveledza; 
generating	bveledza; 
generation	murafho;  mubveledzo; 
generations	murafho;  mubveledzo; 
genre	lushaka lwa muzika; 
genres	lushaka lwa muzika; 
gentlemen	ngamula; nzhinga; 
geographic	 ḓivhavhupo; ḓivhashango; 
geographical	zwa ḓivhashango;  -ḓivhashango; 
geography	ḓivhashango; 
get	wana; 
gets	wana; 
getting	wana; 
giant	ḽidzhidzhiriba;  muswonḓa; ḽidzhanzhara; 
gift	mpho;  tshifhiwa; 
girl	musidzana; 
girls	musidzana; 
give	fha;  beba;  ṋea;  ira;  laedza; 
given	-khagala; 
gives	fha;  beba;  ṋea;  ira;  laedza; 
giving	fha;  beba;  ṋea;  ira;  laedza; 
glad	takala; 
glass	ngilasi; 
global	mukatelo;  shango nga vhuphara; 
globally	dzitshaka;  dzitshakatshaka;  mukatelo; 
globe	shango;  khungulu; 
glory	 vhurena; vhugala; 
go	 bvela phanḓa; ya;  enda;  ṱuwa; 
goal	 tshipikwa;  tswikelelo; ndivho;  tshikoro; 
goals	 zwipikwa;  tswikelelo; ndivho;  tshikoro; 
goes	 tshimbila na; ṱuwa; 
going	 u ya; ṱuwa; 
gold	musuku; 
golden	tsha muswuku; zwa maṱhakheni;  zwavhuḓi; 
gone	 enda; ṱuwa; 
good	zwivhuya; tshonakaho;  wavhuḓi;  muvhuya;  luga;  zwavhuḓi; 
goods	thundu;  zwirengwa; 
gore	 u runga nga maṋanga; malofha; 
got	wana; 
govern	vhusa;  -luvhisa; 
governance	ndaulo;  maanḓa;  maanḓalanga; 
governed	 luvhisa; vhusa; 
governing	rena;  luvhisa;  u tshimbidza; vhusa; 
government	muvhuso; 
government's	hulumeni;  zwa muvhuso; 
governments	mivhuso; 
governor	muluvhisi; 
governors	muluvhisi; 
grace	tshilidzi; 
grade	 -nangudza;  nangudza;  munangudzo; murole;  gireidi; 
grades	 nangudza;  munangudzo; murole;  gireidi; 
grading	 nangudza;  munangudzo; murole;  gireidi; 
graduate	u ambara; 
graduates	ambara; mutelwadigirii; 
grand	khulukhulu; yavhuḓivhuḓi; 
grant	mundende;  mphomali; 
granted	mundende;  mphomali; 
granting	mundende;  mphomali; 
grants	mundende;  mphomali; 
graphic	zwifanyiso;  nyolo; 
grass	hatsi; 
grassroots	tshitshavha;  masi;  vhunzhi;  mavhuthu;  ḓowelea;  katela; 
grateful	 ṋeya;  u badela;  u takadza; takalela; livhuha;  tshikolodo; 
gratitude	ndivhuho; 
grave	 tshalo; mavhiḓa; 
graves	 tshalo; mavhiḓa; 
great	 nga maanḓa;  khulu; zwihulwane; 
greater	 muhulwane; khulwane;  zwihulwane; 
greatest	tshihulu; 
greatly	zwihulu; 
green	dala;  -dala; 
greenhouse	nnḓu ya zwiraba; 
greetings	dzindumeliso; 
grew	 ṱavha; aluwa; 
grind	 -kuya; u kuya; 
gross	 goroso; guṱe; 
ground	kuya; 
ground-breaking	tshanduko;  zwiswa;  mathomo; 
groundbreaking	tshanduko;  zwiswa;  mathomo; 
grounds	vhuimo;  mavu; mbanḓe; 
group	tshigwada; 
groups	tshigwada; 
grow	aluwa; 
growing	aluwa;  hula; 
grown	aluwa;  lima; 
growth	nyaluwo; 
guaranteed	khwaṱhisedzo; 
guarantees	khwaṱhisedzo; 
guard	-linda; 
guest	mueni; 
guests	vhaeni; 
guidance	thuso;  nyendedzi; ndendedzi; 
guide	 -sumbedza; gaidi;  -endedza; 
guided	sumbedza;  gaidi;  endedza; 
guideline	thuso;  nyendedzi; ndendedzi; 
guidelines	thuso;  nyendedzi; ndendedzi; 
guides	sumbedza;  gaidi;  endedza; 
guiding	 nyendedzi; sumbedza;  endedza; 
guilt	thendamulandu; 
guilty	-mulandu; 
gun	tshigidi; 
had	na; 
hail	tshifhango; 
hailed	tshifhango; 
hails	tshifhango; 
half	hafu; 
hall	holo; 
hand	lutanda;  tshanḓa; 
handed	lutanda;  tshanḓa; 
handing	lutanda;  tshanḓa; 
handle	mukungelo; 
handled	mukungelo; 
handling	kufarele; 
handover	ṋetshedza; 
hands	 vhutanda; zwanḓa; 
happen	bvelela;  itea; 
happened	bvelela;  itea; 
happening	bvelela;  itea; 
happens	bvelela;  itea; 
happy	takala; 
harassment	 sinyusa;  tovhola; dina; 
hard	konḓa; 
hare	muvhuḓa; 
harm	vhaisa;  huvhadza; 
harmful	 tshinyadzaho; -tshinyadzo; 
harmony	pfano; 
has	na; 
hatred	luvhengela; 
have	vha na; 
having	vha na; 
hazardous	khombo; 
he	ene; 
head	ṱhoho; 
headed	ṱhoho; 
heading	ṱhoho; 
headline	ṱhoho ya mafhungo; 
headlines	ṱhoho dza mafhungo; 
heads	ṱhoho; 
heal	 fhodza; lafha; 
healing	 fhodza; lafha; 
health	mutakalo; 
healthcare	ndondolo ya zwa mutakalo; 
healthy	 -takalaho; u vha na mutakalo; 
hear	 thetshelesa; pfa; 
heard	 thetshelesa; pfa; 
hearing	tsengo;  u pfa; 
hearings	 tsengo; pfa; 
hears	 thetshelesa; pfa; 
heart	 tshivhindi; mbilu; 
heavy	 u lemela; -lemelaho; 
hectare	hekithara; 
hectares	hekithara; 
height	 vhunṱha ha thavha; vhulapfu; 
heights	 vhunṱha ha thavha; vhulapfu; 
held	fara; 
help	 thuso; thusa; 
helped	 thuso; thusa; 
helping	mukanzwo; 
helps	thusa; 
hence	ngeno hu na uri; 
her	ene; mu; 
heraldry	 tshigaṱhalu; ngudo ya tshigaṱhalu; 
here	 henefha;  hafha;  fhano; ngeno; 
hereby	 nga hone; fhano; 
hereinafter	henefha nga murahu; 
heritage	 vhufa; ifa; 
hero	vhuhali;  muhali; 
heroes	 vhahali; vhuhali; 
heroine	muhali; 
heroines	vhahali; 
herself	ene; mu; 
hi	 aa;  ndaa; haḽo; 
hidden	mukumba; 
hide	mukumba; 
hierarchies	 ḽeri; thevhekano;  vhunamelo; 
high	nṱha; 
high-level	vhuimo ha nṱha; 
higher	nṱha;  ndapfu; lapfu; 
highest	nṱha; 
highlight	vhuguma nṱha; maṱhakheni;  lumba;  ndumbo;  zwo sedzwaho; 
highlighted	shugushedza;  nakisa;  nyombedzelo;  ombedzela; muvhala;  khavhisa; 
highlights	vhuguma nṱha; maṱhakheni;  vhukunga vhaendelamashango; 
highly	nṱha;  muhulu;  vhuhulu;  ndapfu; lapfu; 
hill	 tshikwara; muvhundu; 
hills	mivhundu;  zwikwara; 
him	ene; mu; 
himself	ene muṋe; 
his	 dzawe; we;  tshawe;  wawe; 
historians	vhaḓivhazwakale; 
historic	ḓivhazwakale; 
historically	ḓivhazwakale; 
histories	ḓivhazwakale; 
hit	 ninga; rwa;  buḓula; goba; nenga;  dia; 
hold	-fara; 
holder	mudzio; 
holders	mudzio; 
holding	 bulasi;  puloto;  tshiṱoko;  mavu;  vhubindudzi; shango;  ndaka;  tsimu; 
holdings	 ndaka;  thundu; khephithaḽa; tshelede;  lupfumo;  zwiko; 
holds	fara; 
holiday	holodeni; 
holidays	holodeni; 
holistic	zwoṱhe;  katela zwoṱhe;  hoṱhe;  nyangaredzo; 
homage	pfanelo;  luvha;  khuliso;  renda; tsumelo;  nduvho;  hulisa;  ndivhanelo; 
home	hayani; 
homelessness	 tshi sina haya;  mutendeleki; monamona; 
homepage	 ḓiresi;  webusaithi;  vhupo;  faela; fhethu; 
homes	mahaya; 
honorary	 thindelo; tshiga; 
honour	 vhuhwavho;  ṱhompha;  hulisa; khuliso;  ṱhompho; 
honourable	muhulisei; muṱhomphei; 
honoured	 huliswa; ṱhomphiwa; ṱhonifhiwa; 
honouring	 ṱhompha; hulisa; 
honours	mulayo; fulufhedzea;  funza milayo; mikwa; 
hope	fulufhelo; 
hoped	fulufhelo; 
hopefully	 fulufhela;  fhulufhela; fulufhelo; fhulofhelo; 
hopes	fulufhelo; 
hospital	 vhuongelo; sibadela; 
hospitality	mafunda; 
hospitals	 maongelo; zwibadela; 
hosted	ṋemuṱa; 
hosting	ṋemuṱa; 
hosts	ṋemuṱa; 
hotel	hodela; 
hotels	hodela; 
hour	awara;  iri; 
hours	awara;  iri; 
house	nnḓu; 
housed	muzika wa hausu; nnḓu; 
household	muṱa;  muṱani; 
households	muṱa;  muṱani; 
houses	muzika wa hausu; nnḓu; 
housing	vhudzulo;  dzinnḓu; 
how	hani; 
however	fhedziha; 
hub	senthara; 
huge	 zwihulwanesa; khulwanesa; 
human	 -vhathu; muthu;  zwa muthu;  -muthu; 
humane	 mvumbo; vhuthu;  mvelo; 
humanities	vhathu;  tshilidzi;  vhuthu; 
humanity	vhathu;  vhuthu; 
humankind	vhathu;  tshilidzi;  vhuthu; 
humans	vhathu;  zwa muthu;  muthu; 
humble	vhulenda;  ṱukufhala;  ḓiṱukufhadza;  ṱukufhadza;  luvheledza; 
humbled	vhulenda;  ṱukufhala;  ḓiṱukufhadza;  ṱukufhadza;  luvheledza; 
humility	vhuthu; 
hundreds	maḓana; 
husband	 vhamuṱani;  mufarisi; munna; 
iconic	 tshiga;  luswayo; tsumbo; 
icons	ikhoni; 
idea	muhumbulo; 
ideals	thaṋwa; 
ideas	mihumbulo; 
identification	vhufaedzi; 
identified	ṱalusa; 
identifies	ṱalusa; 
identify	ṱalusa; 
identifying	ṱalusa; 
identities	mvumbo; 
identity	mvumbo; 
if	arali; 
ill	lwala;  vhaisala; 
illegal	-iledzwaho; 
illiteracy	u sa kona u vhala na u ṅwala; 
illness	vhulwadze; 
illustrate	-sumbedzela;  -fanyisedza; 
illustrated	 fanyisedza; sumbedzela; 
image	tshifanyiso; 
images	zwifanyiso; 
imagination	vhukonesi vhuhumbulewa;  khumbulelo; 
imbalances	 khethululo; phambano;  sa vha na ndinganelo; 
immediate	mbo ḓi; zwenezwino;  nga u ṱavhanya;  na zwenezwo; 
immediately	mbo ḓi; zwenezwino;  nga u ṱavhanya;  na zwenezwo; 
immensely	huluhulu; tshihulu nga maanḓa; 
immigration	mupfulutshelo; 
imminent	 zwi tsini; zwi ḓo itea zwenezwino; 
immovable	sa sudzuluwi;  zwa tshoṱhe; 
immunisation	nyelulo;  haelwa; 
impact	 maanḓa;  ṱhuṱhuwedzo; kwama;  muya;  khuḓano; 
impacts	 kuḓana; kwama;  dzhenisa muya;  ṱuṱuwedza; 
impaired	holefhala; 
impediments	vhulwadze;  zwithithisi;  vhuholefhali;  zwikundisi; 
imperative	ḽimudi ḽilaeli; 
imperatives	ḽimudi ḽilaeli; 
implement	tevhedza;  tshishumiswa; 
implementation	 shumisa; shuma;  shumiswa; 
implemented	tevhedza;  tshishumiswa; 
implementing	tevhedza;  tshishumiswa; 
implements	tevhedza;  tshishumiswa; 
implications	 mahumbulelwa;  madzinginywa; masiandaitwa; 
implies	 dzinginya; amba;  sumba; 
import	 u ṱunḓa; -ṱunḓa; 
importance	ndeme; 
important	ndeme; 
importantly	 zwa ndeme; zwihulwane;  zwa vhuṱhogwa; 
imported	ṱunḓa; zwiṱundwa; 
importer	muṱunḓi; 
imports	ṱunḓa; zwiṱundwa; 
impose	 fhura; tea;  vhofha;  laedza; 
imposed	 fhura; tea;  vhofha;  laedza; 
imposing	 fhura; tea;  vhofha;  laedza; 
imposition	 sinyusa;  tswenya;  muhwalo; kombetshedza;  dina; 
impossible	 zwi sa konadzei; zwi konḓaho; 
impressed	gadiswa;  khwaṱhiswa; shushedzwa;  takadzwa;  tshuwiswa; 
impressive	 fhura; ṱuṱuwedza;  nyanyula;  takadza; 
imprison	valela; 
imprisoned	valela; 
imprisonment	 tshigwevho; valela;  dzheniswa ṱironngoni; 
improper	 sa fhulufhedzea; sa ṱanganedzei;  songo fanelaho;  siho mulayoni; khakheaho; 
improve	-khwinisa; 
improved	kwinisa; khwinisa; 
improvement	khwiniso; 
improvements	khwiniso; 
improving	kwinisa; khwinisa; 
in	kha; 
inability	 sa vha na vhukoni;  balelwa; kundelwa;  sa vha na maanḓa; shaya fhulufhelo; 
inadequate	 songo linganaho; ṱahelaho;  sa fushiho; 
inappropriate	 sa fhulufhedzea; sa ṱanganedzei;  songo fanelaho;  siho mulayoni; khakheaho; 
inaugural	 ḓivhadza;  vula; thoma; 
inauguration	u rwelwa ṱari; 
incapable	 sa vha na vhukoni;  balelwa; kundelwa;  sa vha na maanḓa; shaya fhulufhelo; 
incapacity	 sa vha na vhukoni;  balelwa; kundelwa;  sa vha na maanḓa; shaya fhulufhelo; 
incarceration	 tshigwevho; valela;  dzheniswa ṱironngoni; 
incentive	tshiṱuṱuwedzi;  -ṱuṱuwedzaho; 
incentives	zwiṱuṱuwedzi; zwiṱuṱuwedzaho; 
inception	ḓivhadzwani; thomani;  rangani; 
incidence	tshiwo; 
incident	 tshiwo; khombo; 
incidental	sokou itea; 
incidents	khombo;  zwiwo; 
include	katela;  -katela; 
included	katela; 
includes	katela; 
including	-katelwa; 
inclusion	mukatelo; 
inclusive	 angalala;  fhelelaho; katela;  nyangaredzi;  angaredza;  ṱanḓavhuwa; 
inclusivity	 vhukateli;  sa khethululi; nyangaredzi;  ṱanḓavhuwaho; 
income	mbuelo; 
incomes	mbuelo; 
incomplete	 songo fhelelaho;  tshipiḓa; ṱahela; 
incorporate	-vhumbekanya; 
incorporated	vhumbekanya; 
incorporates	vhumbekanya; 
incorporation	mbumbano; mbumbekano;  ṱhanganelo;  ṱhanganelano;  milwa; 
incorrect	zwo khakheaho; 
increase	engedza; 
increased	engedza; 
increases	engedza; 
increasing	engedza; 
increasingly	 andisa;  anda;  ṋaṋisa;  anza; muengedzo; 
inculcate	ṱuṱuwedza;  funza;  gudisa; pfumbudza;  ḓivhadza;  ḓadza; 
incurred	 ṱanganiwaho; lozwiwaho; wanalaho; kungiwaho; 
indaba	khoro; 
indeed	vhukuma;  ngoho; 
independence	vhuḓilangi; 
independent	-ḓilangaho; 
independently	 ḓilangaho;  ḓiimisa; nga woṱhe; 
index	tsumbamafhungo; 
indicate	 u sumbedza; -sumba; 
indicated	sumbedza;  sumba; 
indicates	sumbedza;  sumba; 
indicating	sumbedza;  sumba; 
indication	 tsumbedzo;  tshisumbi;  ngafhadzo; tsumbo; 
indications	 tsumbedzo;  tshisumbi;  ngafhadzo; tsumbo; 
indicative	 tsumbedzo;  tshisumbi;  ngafhadzo; tsumbo; 
indicator	 tshieli; tshisumbi;  indikheitha; 
indicators	 indikheitha; zwisumbi; zwieli; 
indices	tsumbi; tsumbamafhungo; 
indigenous	zwa iḽo shango; 
indirect	-vhumone; 
indirectly	 vhumone; songo livhaho; 
individual	 -muthihi; muthu; 
individually	nga muthihi;  nga tshithihi; 
individuals	vhathu; 
industrial	zwa feme; 
industries	mushumo;  nḓowetshumo; 
industry	mushumo;  nḓowetshumo; 
inequalities	 khethululo; phambano;  sa vha na ndinganelo; 
inequality	 khethululo; phambano;  sa vha na ndinganelo; 
infected	u pfukiselwa; 
infection	 u kavhiwa;  phirelo ya malwadze;  phirela; vhulwadze; 
infections	 kavhiwa;  phirelo ya malwadze;  phirela; vhulwadze; 
inferior	 fhasi ha muṅwe muthu;  zwiṱoma; zwiṱuku; 
inflows	swika;  ha u dzhena; 
influence	ṱhuṱhuwedzo; 
influenced	ṱhuṱhuwedzo; 
info	 mbuno;  mbalombalo;  zwidodombedzwa; maswamaswa;  muvhigo; mafhungo; 
inform	vhudza; 
informal	inifomaḽa; si nga mulayo;  tshayanzudzanywa; 
information	mafhungo; 
informed	sumiwa;  ḓivhadzwa;  ḓivhiswa; 
informing	vhudza; 
infrastructure	themamveledziso;  themamveledziso ya vhuṱumanyi ya khomphyutha; 
inherent	 zwa ndeme;  zwivhumbi;  zwa mvelo; mamela; 
inherit	u ḽa ifa; 
inherited	ḽa ifa; 
initial	 ranga; thoma; thangadzina; 
initially	mathomoni; 
initiate	 wedza; fumbisa;  mufumbi;  dzumbulula;  tshina;  funza zwa kale; thoma; 
initiated	 wedzwa; dzulumbululwa; thomiwa;  funzwa zwa kale;  ;  fumbiswa; 
initiative	vhurangeli; 
initiatives	vhubaledzi; vhurangeli; 
initiator	 musiki; mubveledzi;  murangi;  muṅwali;  muthomi; 
injuries	mafuvhalo; 
injury	fuvhalo; 
injustice	 u sa tevhedza mulayo; khaṱhulo i si kwayo; 
injustices	 sa tevhedza mulayo; khaṱhulo i si kwayo; 
inmates	 vhafariwa; zwivhotshwa; vhafariwa; 
inner	nga ngomu; 
innovation	vhurangeli; 
innovative	 vhurangeli; tsimuluhoni;  tsikoni; zwiswa; 
input	mafhungodzheniswa;  ndongwa;  -dzhenisa mafhungo; 
inputs	 mafhungodzheniswa;  dzhenisa mafhungo; ndongwa; 
inquest	 tsenguluso; ndingo;  tsedzuluso;  ṱhoḓisiso; 
inscribed	 vhaḓwa; khavhiswa; rekhodwa;  ṅwalwa; 
insert	dzhenisa; 
inserted	dzhenisa; panga; 
insertion	katela;  angaredza;  nyengedzedzo;  longa;  dzhenisa; 
inserts	dzhenisa; panga; 
inside	ngomu; 
insight	 pfesesa; vhona; 
insights	 pfesesa; vhona; 
insolvency	vhuwatshiṱoko; 
inspect	ṱola;  -ṱola; 
inspections	ṱholo; 
inspector	muingameli; 
inspectorate	 vhaingameli; ṱholo;  ṱola;  ingamela; sedzesa;  zwipikiṱere; lavhelesa;  pikiṱera; 
inspectors	muingameli; 
inspire	ṱuṱuwedza;  nyanyula; 
inspired	 nyanyulwa; ṱuṱuwedzwa; 
inspiring	ṱuṱuwedza;  nyanyula; 
install	dzhenisa;  kwea; 
installation	u kwea; 
installed	dzhenisa;  kwea; 
instalments	 tshitolomennde; tshikaṱu; 
instance	tsumbo; 
instances	tsumbo; 
instead	 vhudzuloni ha; nga nṱhani ha; 
institute	thondovhoṱhe;  tshiimiswa;  vhewa; dzangano;  simiwa;  khwaṱhiso; 
instituted	 simiwa;  khwaṱhiso; vhewa; 
institution	tshiimiswa; 
institutional	tshiimiswa; 
institutions	zwiimiswa; 
instruction	ndaela;  ndayo; 
instructional	ndaela;  ndayo; 
instructions	ndaela;  ndayo; 
instrument	tshishumiswa;  tshilidzo; 
instruments	zwishumiswa;  zwilidzo; 
insufficient	tshi sa linganiho; 
insurance	ndindakhombo; 
insurer	burokhara; 
intangible	khumbulelwa; 
integral	-tshivhili; 
integrate	 timbanya; -ṱanganya; 
integrated	 timbanya; ṱanganya; 
integration	u ṱanganyisa; 
integrity	 vhungoho; fhulufhedzea;  fulufhedzea; 
intellectual	vhuṱali;  ṱhalukanyo;  nḓivho; 
intellectuals	vhuṱali;  ṱhalukanyo;  nḓivho; 
intelligence	 vhusevhi; vhuṱali; 
intend	-ṱoḓa u; 
intended	ṱoḓa u; 
intends	ṱoḓa u; 
intensify	 titilidza; engedza; maanḓafhadza;  khwaṱhisa; 
intent	vhuḓiimiseli; 
intention	muhumbulo; 
intentionally	ḓiimisela; 
inter	 bwela; vhulunga; 
interact	u shumisana; 
interacting	shumisana; 
interactive	fhindulana na; 
interception	gavhedza;  fara nḓilani; thivha; 
interdepartmental	mihasho yo ṱanganelanaho;  zwa vhukati ha mihasho; 
interest	 muingapfuma; dzangalelo;  -dzangaledza; 
interested	 fungelela; dzangalelo; 
interesting	-dzangalelo; 
interests	 muingapfuma; dzangalelo;  dzangaledza; 
interfaith	thendo dzo dzhenelanaho; thendo dzo ṱanganelaho; 
interfere	u thithisa; 
interference	dzhenela;  maḓilonge; 
intergenerational	mirafho yo dzhenelanaho; mirafho yo ṱanganelanaho; 
intergovernmental	mivhusoḽedzani; 
interim	tshifhinga tsha u lindela; 
intermediaries	 mulamukanyi; vhukati;  ṋenḓila; 
intermediary	 mulamukanyi; vhukati;  ṋenḓila; 
intermediate	vhukati; vhuṋenḓila; 
internal	 zwa nga ngomu muvhilini; -ngomu; 
international	 shango ḽoṱhe; dzitshaka;  dzitshakatshaka;  ḽifhasi ḽoṱhe;  mukatelo; 
internationally	 shango ḽoṱhe; dzitshaka;  dzitshakatshaka;  ḽifhasi ḽoṱhe;  mukatelo; 
internet	inthanethe; 
interns	fara;  madokotela;  valela;  matshudeni a vhudokotela; 
interpret	-ṱalutshedza;  ḓologa; 
interpretation	ṱhalutshedzo;  vhuḓologi;  ḓologa;  thandululo;  ṱalusa; 
interpreted	 ḓologa; ṱalutshedza; 
interrogate	 vhudzisesa; vhudzisa; 
interval	tshikhala; 
intervals	tshikhala; 
intervene	dzhena;  lamula; 
intervention	dzhena;  lamula; 
interventions	dzhena;  lamula; 
interview	-vhonana; 
interviews	vhonana; inthaviyu; 
intestate	sa vha na vhupfiwa;  sa imelelwa; 
into	 nga ngomu; ngomu; 
introduce	 ḓivhadza; bveledza;  u thoma; 
introduced	 bveledza;  ḓivhadza; thoma; 
introducing	 bveledza;  ḓivhadza; thoma; 
introduction	 marangaphanḓa; tswikiso; 
invalid	tshihole; tshi sa ṱanganedzei;  tshi si tshone;  tshi si na maanḓa; 
invaluable	-sa pimei; 
inventory	 khathalogo;  tshiṱoko;  mutevhe; rekhodo;  akhaunthu; 
invest	vhulunga; 
invested	bindudza; 
investigate	ṱoḓisisa; 
investigated	ṱoḓisisa; 
investigating	ṱoḓisisa; 
investigation	ṱhoḓisiso; 
investigations	tsenguludzo; ṱhoḓisiso; 
investigative	 ṱoḓisisa; sedzulusa;  sengulusa;  wanulusa;  saukanya; 
investigator	musedzulusi;  musengulusi;  muṱoḓisisi; 
investigators	 vhaṱoḓisisi;  vhasengulusi; vhasedzulusi; 
investing	bindudza; 
investment	mbulungelo; 
investments	vhubindudzi; 
investor	mubindudzi; 
investors	vhabindudzi; 
invitation	thambo; 
invite	ramba; 
invited	ramba; 
invites	ramba; 
inviting	ramba; 
involve	kwama;  angaredza;  dzhenisa mafhungoni;  katela; 
involved	 kwamea; katelwa;  dzheniswa mafhungoni;  angaredzwa; 
involvement	 kwamea; katelwa;  dzheniswa mafhungoni;  angaredzwa; 
involves	kwama;  angaredza;  dzhenisa mafhungoni;  katela; 
involving	kwama;  angaredza;  dzhenisa mafhungoni;  katela; 
iron	tsimbi;  aini;  aina;  ayoni; 
irregular	 songo linganelaho;  songo ḓoweleaho; siho mulayoni; 
irregularities	zwi sa yiho nga mulayo; zwi siho mulayoni; 
irregularity	tshi sa yiho nga mulayo; zwi siho mulayoni; 
irrespective	naho zwo ralo;  nangwe zwo ralo; 
irrigation	tsheledzo; 
is	ndi; 
island	tshiṱangadzime; 
issue	fhungo;  nzudzanyo; 
issued	fhungo;  nzudzanyo; 
issues	fhungo;  nzudzanyo; 
issuing	fhungo;  nzudzanyo; 
it	 ḽone;  kwone;  lwone;  tshone;  wone;  yone; hone; 
it's	ndi; 
item	tshiteṅwa; 
items	nyitaṅwe;  thengaṅwe; zwiteṅwa; 
its	yayo;  watsho;  wayo;  yatsho;  vhatsho;  zwayo;  vhayo;  zwatsho; 
itself	yone iṋe;  tshone tshiṋe;  hone huṋe;  kwone kuṋe;  wone uṋe;  lwone luṋe; ḽone ḽiṋe; 
jewellery	dzhuweḽari;  dzhuwele; 
job	mushumo; 
jobs	mishumo; 
join	-ṱanganya; 
joined	ṱanganya; 
joining	ṱanganya; 
joint	tshinungo; 
jointly	vhoṱhe;  ṱanganelana;  shumisana;  farisana;  nga u lingana; 
journalism	khasho ; dzhenalizimu;  nyanḓadzamafhungo; 
journalist	ramafhungo; 
journalists	vhoramafhungo; 
journey	lwendo;  -fara lwendo; 
joy	mutakalo;  dakalo; 
judge	 haṱula; muhaṱuli;  -haṱula; 
judgement	Khaṱhulo; 
judges	 haṱula; vhahaṱuli; 
judgment	Khaṱhulo; 
judgments	Khaṱhulo; 
judicial	tshi mulayo;  zwa mulayo; 
judiciary	vhuhaṱuli; 
junior	tshiṱuku;  phedzi; 
jurisdiction	 maanḓa;  vhurena; ndango;  mikano; 
jurisdictions	 maanḓa;  vhurena; ndango;  mikano; 
juristic	tshi mulayo;  zwa mulayo; 
just	 lugaho;  nga mukhwa wo raloho; bvou; fanelaho; 
justice	 khaṱhulo kwayo; vhulamukanyi; 
justified	 onyoloswa;  imelelwa; ṱalutshedzwa;  lugiswa; khwaṱhisedzwa; 
justify	 onyolosa; khwaṱhisedza;  lugisa; ṱalutshedza;  imelela; 
keen	tama;  -vha na dzangalelo;  -fungelela;  -vha na mafulufulu;  utelela; 
keep	fara;  lisa;  fuwa;  vhulunga;  vhea; 
keeping	fara;  lisa;  fuwa;  vhulunga;  vhea; 
kept	 liswa;  fuiwa;  farwa; vhewa;  vhulungwa; 
key	khii;  khoṋo; 
keynote	 thivho; ndeme; 
kick	raha;  punḓula; 
kick-off	mathomo a mutambo; 
kill	vhulaha; 
killed	vhulaha; 
kilometre	khiḽomitha; 
kilometres	khiḽomitha; 
kind	luga; 
kindly	vhuwhavho; vhuthu;  vhulenda;  luga; 
kinds	luga; 
king	khosi; 
kingdom	muvhuso; 
kings	khosi; 
knew	pfesesa;  ḓivha;  ḓivhadza;  ḓivhea; 
know	pfesesa;  ḓivha;  ḓivhadza;  ḓivhea; 
knowing	 pfesesa;  ḓivha; 
knowingly	ḓivha; 
knowledge	nḓivho; 
known	 ḓivhea; pfesesea; 
knows	pfesesa;  ḓivha; 
laboratories	ḽaborethari;  ḽaboratori; 
labour	 -shuma;  mushumi;  u luma ha ṋowa; mushumo; 
lack	vhushai;  -shaya; 
ladies	mufumakadzi;  musadzi; 
laid	kudzela; 
lake	dzivha;  isha; 
land	 mavu; shango;  tsimu;  -kavha; 
landfill	ḓaleḓale; ḓalaḓale; 
lands	 tsa; ima;  kavha; 
language	luambo; 
languages	nyambo; 
lapse	tshihaṱu;  phausi; ima;  tshikhala;  ita mulandu i si nga khole;  litsha; 
large-scale	zwinzhi;  khulu;  zwihulwane; 
largely	 nga u angaredza; nga maanḓa; 
larger	khulu; 
largest	khulwanesa; 
last	fhedzisela; 
lasting	 lalama;  fhedza; lini na lini;  zwa tshoṱhe; 
lastly	tsha u fhedza; 
late	 lenga; mufu; 
later	nga murahu; 
latest	maswamaswa;  tshiswatshiswa; 
latter	-bulwaho murahu; 
laughter	 mapwapwalala; maseo;  tshiseo; 
launch	 dzhenisa tshikepe maḓini; thoma; 
launched	 dzhenisa tshikepe maḓini; thoma; 
launches	 dzhenisa tshikepe maḓini; thoma; 
launching	 dzhenisa tshikepe maḓini; thoma; 
laundering	vhe mulayoni ;  kulumaga; ngalangadza; kunakisa;  kuvha; 
laureate	muṱanganedzi wa tshiphuga; 
laureates	vhaṱanganedzi vha zwiphuga; 
law	mulayo; 
law-making	mulayo;  vhusimamulayo;  vhuhaṱuli;  zwa mulayo; 
lawful	tshi mulayo;  zwi tendelanaho na mulayo;  zwa mulayo; 
lawfully	mulayoni;  zwi yaho nga mulayo;  lwa mulayo; 
laws	milayo; 
lawyers	vhoramilayo; 
lay	-kudzela; 
laying	kudzela; 
lead	 mutobvu; tshifhirisi;  tshipfukisi; 
leader	murangaphanḓa; 
leaders	vharangaphanḓa; 
leadership	vhurangaphanḓa; 
leading	 ranga phanḓa;  dededza; fhira;  dzula phanḓa;  tshimbidza;  endedza;  xedza; 
leads	 mutobvu; tshifhirisi;  tshipfukisi; 
leaflets	kuṱari; 
learn	ḓifunza; guda; 
learned	 vha na nḓivho;  pfesesaho;  gudaho; funzea; 
learner	mugudi; 
learners	vhagudi; 
learning	 funzwa;  guda; 
learnt	 funzwa; guda; 
lease	 rennde; hira; rennda; 
leased	hirisa;  rendisa; 
leasehold	 nnḓu ya u rendisa; hirisa;  nnḓu ya u hirisa;  rendisa; 
least	zwiṱukuṱuku;  kuṱukuṱuku; 
leave	 ṱutshela;  ḽivi; sia;  takuwa;  ṱuwa;  litsha; 
leaves	 ṱutshela; sia;  takuwa;  ṱuwa;  litsha; 
leaving	 ṱutshela; sia;  takuwa;  ṱuwa;  litsha; 
lecture	pfumbudzo; 
led	 mutobvu; tshifhirisi;  tshipfukisi; 
left	monde; 
leg	mulenzhe; 
legacies	vhufa; 
legacy	vhufa; 
legal	-mulayo; 
legally	mulayoni;  zwi yaho nga mulayo;  lwa mulayo; 
legend	lungano; 
legendary	 tshi re na phungo;  takalelwaho; bvumo;  ḓivheaho; 
legends	mafhungolungano; lungano; 
legislation	theo ya milayo; 
legislative	mulayo;  vhusimamulayo;  vhuhaṱuli;  zwa mulayo; 
legislature	vhusimamulayo; 
legislatures	vhusimamulayo; 
legitimacy	 mulayoni; teaho;  vhukuma;  ngoho;  fanelaho; 
legitimate	 zwa vhukuma; mulayoni; zwi itwaho ngangelekanyo;  zwa ngoho; 
lend	koloda; 
lending	koloda; 
length	 vhunavha; vhulapfu; 
less	fhasi; 
lesser	 zwiṱukuṱuku;  zwi si zwa ndeme;  ṱukufhadza; fhungudza; 
lesson	ngudo; 
lessons	ngudo; 
let	 tendelela;  vhofholola; tendela;  litsha; 
let's	 tendelela;  kha ri;  vhofholola; tendela;  litsha; 
letter	 luṅwalo; vhurifhi;  ḽeḓere; 
letters	 maṅwalo;  thannga;  maḽeḓere; marifhi; 
level	 magumo;  -linganyisa; vhulapfu;  eḓanelaho;  -eḓanaho;  -levhelwaho; 
levels	 levhelwaho;  magumo;  eḓanaho; vhulapfu;  eḓanelaho;  linganyisa; 
levied	muthelo; 
levies	muthelo; 
levy	kosekose; 
liabilities	pfanelo;  milandu;  vhuḓifhinduleli;  khwalo; 
liability	pfanelo;  vhuḓifhinduleli;  muhwalo;  mulandu; 
liable	vhuḓifhinduleli;  zwine zwa nga; 
liaise	 ṱumanya;  kwamanya; konanya; 
liaison	 vhukwamanyi; vhukonanyi;  vhuṱumanyi; 
liberalisation	 rengulula; vhofholola;  pfuṋulula; 
liberation	mbofholowo; 
librarian	muḽaiburari; 
librarians	vhaḽaiburari;  vhaḽaiburari vha phuleithi; 
libraries	 laiburari dza phuleithi; ḽiburari; 
licence	ḽaisentsi; 
licences	ḽaisentsi; 
license	thendelo; 
licensed	tendelwa;  khwaṱhisedzwa;  themendelwa;  ṅwaliswa; 
licensee	mulanguli; mukoma wa nnḓu;  radzihodela;  muṋe; 
licensees	vhalanguli; vhoradzihodela;  vhakoma vha nnḓu;  vhaṋe; 
licensing	thendelo; 
lie	kudzulele kwa ṅwana mbumbeloni; 
lies	kudzulele kwa ṅwana mbumbeloni; 
life	vhutshilo; 
lifetime	vhutshilo hoṱhe; 
light	 tshedza; leluwa;  u fhefhuwa;  -leluwa;  -fhefha; 
lighting	mavhone; 
like	 ingaho;  fanaho; sa;  nga mukhwa muthihi;  funa;  tama; 
likely	zwi tamisaho;  zwine zwa nga; 
limit	mukano;  mugumo; 
limitation	 maanḓa; ndango;  nyiledzo;  mukano;  thivhelo; 
limitations	 maanḓa; ndango;  nyiledzo;  thivhelo;  mikano; 
limited	 kaliwa; fhungudzwa;  songo fhelelaho;  pimiwa;  eliwa; 
limiting	mukano;  mugumo; 
limits	mukano;  mugumo; 
line	mutalo;  mutala; ḽaina; 
line'	mutalo; 
line-up	 tshikwadi;  thimu; tshigwada;  thevhekano ya mbekanyamushumo;  muduba; 
lines	mitaladzi; 
linguistic	zwa nyambo; 
link	-ṱuma; 
linkages	ṱhumo; 
linked	 ṱhuma; ṱuma;  ṱhumo; ḽinki;  tshitumi; 
linking	 ṱhuma; ṱuma;  ṱhumo; ḽinki;  tshitumi; 
links	ṱanganya;  ṱuma; 
liquid	 -tshiluḓi; tshiluḓi; 
liquidation	u wa tshiṱoko; 
liquidator	muṱoli;  mulavhelesi;  muṱanganedzi;  muṱanganedzi mulauli;  muṱanganedzi wa tshiofisi; 
liquidity	 nyelelo ya tshelede;  luḓi;  kheshe;  tsheledembetshelwathungo;  mpambo;  tshiluḓi;  lufhirima; tshelede; 
liquor	tshikambi; 
list	mutevhe; 
listed	mutevhe; 
listen	 thetshelesa; pfa; 
listing	mutevhe; 
lists	mitevhe;  tevhekanya; 
literacy	vhukoni ha u vhala na u ṅwala; 
literally	thevhedzaipfi; 
literary	 maṅwalwa; ḽitheretsha; 
literature	maṅwalwa; 
litigation	mbilo; 
little	ṱukufhala;  ṱukufhadza;  kuṱukuṱuku; 
live	-tshila;  -re muḓagasi; 
lived	 re muḓagasi; tshila; 
livelihoods	 ndondolo;  kutshilele; mushumo; 
lives	vhutshilo; 
livestock	zwifuwo; 
living	 tshidzwa;  lalama; dzula;  tshila;  hanya; 
load-shedding	dzima muḓagasi nga u sielisana; 
loan	khadzimiso; 
loans	khadzimiso; 
local	tshapo; 
locally	henefho;  henefho tsini; 
locals	tshapo; 
located	 dzula;  wanala; fhethu; 
location	tshikolobulasi; 
lock-up	valela;  khiya; hoṋa;  khiṋa; 
lodge	 vheya; dzula;  fhaṱa;  hwelela ; 
lodged	 vheya; dzula;  fhaṱa;  hwelela ; 
lodging	fhethu hune ha dzulwa hone; 
logistics	nzudzanyo dza mushumo u konḓaho; nyendedzo ya thundu; 
long	-lapfa; 
long-term	tshifhinga tshilapfu; 
longer	lapfa; 
look	 lisa; vhona;  ṱoḓa;  lavhelesa;  londola;  ṱhogomela;  mbonalo;  sedza;  basoba; 
looked	 lisa; vhona;  ṱoḓa;  lavhelesa;  londola;  ṱhogomela;  mbonalo;  sedza;  basoba; 
looking	 lisa; vhona;  ṱoḓa;  lavhelesa;  londola;  ṱhogomela;  mbonalo;  sedza;  basoba; 
looks	 lisa; basoba ;  lavhelesa;  londola;  ṱhogomela;  mbonalo; sedza; 
loop	nkhwe; 
lose	-kundwa; 
loss	 tshinyalelo kha ḓana; tshinyalelo;  lozwa; 
losses	 tshinyalelo kha ḓana; tshinyalelo;  lozwa; 
lost	kundwa; 
lot	vhutshilo ha muthu; 
lottery	ḽothari; 
love	lufuno; 
loved	lufuno; 
lovers	vhafunani; vhatakaleli;  vhafuni; 
low	fhasi; 
low-income	muholo wa fhasi;  malamba a fhasi;  mbuelo ya fhasi; 
lower	 tsisa;  sinyalala khofheni;  ṱukufhadza; tsisela fhasi; fhungudza;  tsitsa; 
lowest	fhasi; 
ltd	Ltd; 
machine	 Mutshini; mutshini; 
machinery	mitshini; 
machines	mitshini;  Mitshini; 
macro-economic	ngudo ya ekonomi nyangaredzi; 
macroeconomic	ngudo ya ekonomi nyangaredzi; 
made	ita;  lushaka; 
magazine	 dzhenala; magazini; 
magazines	 dzhenala; magazini; 
magisterial	zwa madzhisiṱaraṱa; 
magistrate	madzhisiṱaraṱa; 
magistrate's	 zwa madzhisiṱaraṱa; ha madzhisiṱaraṱa; 
magistrates	madzhisiṱaraṱa; madhisṱaraṱa; 
magnificent	 tshavhuḓi; tshimangadzaho; 
magnitude	vhuhulu; 
mail	poswo;  posa; 
main	 muhulwane;  ṱhoho;  tshidziki; ndeme; 
mainly	zwihulu;  fhirisa ndinganyo; 
mainstream	 vhukati ha gondo;  zwa nga misi;  zwo ḓoweleaho;  katela matshudeni a vhukoni ho fhambanaho; muhumbulo nyangaredzi; 
mainstreaming	katela matshudeni a vhukoni ho fhambanaho; 
maintain	londota;  -unḓa; 
maintained	londota;  unḓa; 
maintaining	londota;  unḓa; 
maintains	londota;  unḓa; 
maintenance	ndondolo; 
major	medzha; 
majority	vhunzhi;  vhuḓi; 
make	lushaka;  -ita; 
makers	vhaiti;  vhasiki;  vhabveledzi;  vhavhumbi; 
makes	ita;  lushaka; 
making	ita;  lushaka; 
malaria	dali; 
male	munna;  -lume;  -mbeu tshiduna; 
males	vhanna;  mbeu tshiduna;  lume; 
mall	mavhengeletserekano ;  senthara ya mavhengele; mavhengeleni; 
man	 munna; muthu; 
manage	 langa; kona; 
managed	 langa; kona; 
management	 vhalangi; ndangulo; 
manager	mulanguli; 
managers	vhalanguli; 
manages	 langa; kona; 
managing	 langa; kona; 
mandate	ndaela; 
mandated	ndaela; mandate; 
mandates	ndaela; mandate; 
mandatory	 ṱoḓea;  khombekhombe; ndeme; 
manifestations	 tsumbedzo; sumbedza;  vhonadza; 
manner	maitele; 
manual	 -zwanḓa; bugupfarwa; 
manufacture	-bveledza; 
manufactured	bveledza; 
manufacturer	mubveledzi; 
manufacturing	vhubveledzi; 
manuscripts	thangelakhanḓiso; 
many	nnzhi; 
map	 mepe; mapa; 
mapping	 rekhoda; ola; 
maps	 mepe; mapa; 
march	 luhwenyisi;  matsha; gwalaba; 
marched	mumatsho;  luhwenyisi;  matsha; gwalaba; 
margin	magumo;  lukombo; 
marginal	fhasi;  zwi si zwa ndeme;  zwiṱuku;  lukombo; 
marginalized	tsisela fhasi; 
marine	-ḓanzhe; 
maritime	 ḓanzhe;  tsini na lwanzhe; lwanzhe;  ya lwanzhe; 
mark	 luswayo;  -ṋea maraga; maraga;  -swaya; 
marked	 limuswa; sumbedzwa;  swaiwa; korekiwa; 
market	 -vhambadza; maraga; 
marketing	mbambadzo; 
markets	 vhambadza; mimaraga;  mimakete; 
marking	u thivha; 
marks	 luswayo;  swaya; maraga; 
marriage	 u vhingana; mbingano; 
marriages	 vhingana; mbingano; 
married	 dzewa;  vhingwa; malwa;  tshata; 
mass	 masi; vhunzhi; 
massive	tshilemelaho; zwihuluhulu;  tshihuluhulu; 
master	 ṱhoho; kona;  vhasa;  ṋemashango;  muṋe; 
master's	 zwa muṋe;  zwa ṱhoho;  zwa ṋemashango; zwa vhasa; 
match	 mentshisi;  -elana; mutambo;  fananyisa;  metshe; 
matches	mitambo;  elana; mitshe;  mentshisi;  pfananyiso;  fananyisa; 
material	tshiitwa; 
materially	zwa ndeme; 
materials	zwiitwa; 
maternal	zwa vhomme; 
mathematical	mathematiki;  metse; mbalo; 
mathematics	ḓivhambalo; 
matric	maṱiriki; 
matrimonial	mbingano;  lumalo; 
matter	vhulwa;  metha; 
matters	vhulwa; thukhita;  metha; 
maturity	vhualuwa;  khulo; 
max	phasa zwavhuḓi;  bvelela nga maanḓa; 
maximise	hudza; 
maximum	zwa nṱhesa; 
may	nga; 
maybe	 ṱhaṅwe; khaṅwe; khamusi;  ṱhamusi; 
mayor	meyara; 
mayors	meyara; 
me	nṋe; 
mean	 tsho kotamaho; ḓasi;  humbula; amba; 
meaning	ṱhalutshedzo; 
meaningful	amba; 
meaningfully	amba; 
meanings	ṱhalutshedzo; 
means	 ṱhalutshedzo;  nḓila;  mali yo vhulungwaho;  humbula; amba;  maitele; 
meant	 humbula; amba; 
measurable	-kaleaho; 
measure	muelo;  -ela; 
measured	 kaliwa;  pimiwa;  eliwa; linganyiswa; 
measurement	muelo; 
measures	ela;  muelo; 
measuring	u ela; 
mechanism	kushumele;  mekhenizimu; 
mechanisms	kushumele;  mekhenizimu; 
media	vhoramafhungo; 
mediation	vhupfumedzani;  vhulamuli; 
medical	 lafha;  zwa mutakalo;  vhuṅanga; dzilafho; 
medicine	mushonga; 
medicines	mishonga; 
medium	luambo lwa u gudisa; 
medium-term	tshifhinga tsha vhukati; 
meet	 lugaho; ṱangana;  fanelaho; 
meeting	muṱangano; 
meetings	miṱangano; 
meets	 lugaho; ṱangana;  fanelaho; 
mega	zwihulwane; 
melting	ṋwa; ṋoka; 
member	muraḓo; 
member's	zwa muraḓo; 
members	miraḓo; 
membership	vhuraḓo; 
memorable	tshihumbudzo; 
memorandum	memorandamu;  ḽiṅwalo; 
memorial	tshihumbudzo; tshi eletshedzi; 
memories	mihumbulo; nyelelwo; 
memory	muhumbulo; 
men	 vharwa; vhanna;  tshinnani; 
mental	muhumbulo; 
mentally	muandiso; 
mention	 bula; amba; 
mentioned	ambiwa;  bulwa; 
menu	menyu; 
merchant	muvhambadzi; 
mere	fhedzi; 
merely	fhedzi; 
merger	ṱhanganelo; 
merit	vhukoni; 
merits	vhukoni; 
message	mulaedza; 
messages	milaedza; 
messenger	zhendedzi; 
met	 lugaho; ṱangana;  fanelaho; 
metals	methaḽa; 
method	maitele;  nḓila; 
methods	maitele;  nḓila; 
metro	 muvhuso wapo; tshiporo tsha tshidimela tsha nga fhasi; 
metropolitan	 masipala muhulu; ḓorobo khulwane; 
micro	tshiṱukusa; khomphyuthathendeleki;  khomphyutha ṱhukhu; 
middle	vhukati; 
midst	vhukati; makatini; 
might	 maanḓa; nga;  tshifhungu; 
milestone	tswikelo khulwane; 
milestones	tswikelo khulwane; 
military	mmbi; 
milk	 mikando; mafhi;  luvhisi; 
million	miḽiyoni; 
millions	miḽiyoni;  miḽioni; 
mind	muhumbulo;  ṱhalukanyo; 
mindful	 ṱhogomele;  ḓivha; humbulela; 
minds	mihumbulo;  ṱhalukanyo; 
mine	 -bwa; mugodi; 
mineral	 mineraḽa;  minirale; minerale; 
minerals	minirala; minerala;  mineraḽa; 
mines	migodi;  bwa; 
minimise	-fhungudza;  u fhungudza; 
minimum	gumofulu; 
minister	 mufunzi; minista; 
minister's	minisiṱa; khosi;  mufunzi; 
ministerial	zwa minisiṱa;  zwa khosi; zwa mufunzi; 
ministers	minisiṱa; mufunzi; 
ministry	vhushumeli;  zwa muhasho; 
minor	 mufhindulelwa; -mufhindulelwa; 
minority	vhuṱuku;  vhufhindulelwa; 
minutes	maambiwa; 
misconduct	vhukhakhi;  mutshimbidzi muvhi; 
misleading	khakhisa;  xedzwa;  khelusa;  kanganyisa;  xedza; 
missing	-siiwaho; 
mission	vhurumiwa; 
missions	vhurumiwa; 
mitigate	netisa; ḽerisa;  sekenisa; 
mitigation	netisa; ḽerisa;  sekenisa; 
mix	-ṱanganyisa;  -vanganya; 
mixed	 ṱanganywa;  vangwa;  vangana;  tshakatshaka;  ṱanganelana;  ṱanganyiswa;  vanganywa; fhambanaho; 
mobile	dzinginyisea;  pfulusea;  sudzulusea;  endedzea;  sendedzea;  tshimbidzea; dzinginyea;  ;  hwalea; 
mobilisation	shumisa;  lugisela;  dzudzanya; 
mobilise	kunga; 
mobility	vhuendi;  tsudzuluwo; 
model	tshiedza;  -edzisa; 
models	edzisa; zwiedzwa;  zwiedza; 
moderate	 zwa vhukati; vhutshilo ha tshizwinozwino; 
modern	 wa musalauno;  tsha musalauno;  ya tshino tshikhathi; musalauno;  dza musalauno; 
modernisation	 tshanduko;  vusuludza;  mbuedzedzo; khwinisa; 
modified	 shandula; khwinisa; 
modify	 -shandula; khwinisa; 
moments	kufhinganyana; 
momentum	 maanḓa; nungo;  mafulufulu; 
monetary	 zwa mali; zwa tshelede; 
money	tshelede; 
moneys	 mali; tshelede; 
monies	 mali; masheleni;  mithelo; tshelede; 
monitor	ṱola;  mulavhelesi;  monitha; 
monitored	ṱola;  mulavhelesi;  monitha; 
monitoring	ṱola;  mulavhelesi;  monitha; 
monitors	 mulavhelesi;  monitha; vhaṱoli; 
month	ṅwedzi; 
monthly	-ṅwedzi; 
months	miṅwedzi; 
monument	tshihumbudzo; 
monuments	zwihumbudzo; 
more	zwiṅwe; 
moreover	hafhu;  nṱha ha zwenezwo; 
morning	matsheloni; 
mortality	vhuswaho nga lufu; 
mortgage	tshikolodo tsha thundu; 
most	zwinzhi; 
mostly	 anzela;  zwihuluhulu; kanzhi; 
mother	mme; 
mothers	mme; 
motion	 u sudzuluwa; ḽikumedzwa; 
motions	makumedzwa;  sudzuluwa; 
motivation	ṱhuṱhuwedzo; 
motor	motho; 
motto	tshilivho; 
mountain	thavha; 
mountains	thavha; 
mouth	mulomo; 
movable	dzinginyisea;  pfulusea;  sudzulusea;  sendedzea;  tshimbidzea; dzinginyea; 
move	-tshimbidza; 
moved	mutho; tshimbidza; 
movement	ḽihoro;  tsudzuluwo; 
movements	 tsudzuluwo; mahoro; thitho; 
moves	mutho; tshimbidza; 
moving	tsukunyea; tshimbila;  sudzulusa;  pfuluwa;  dzinginyisa;  pfulusa;  sendela;  sudzuluwa;  dzinginya;  sendedza; 
much	 ngafhani;  manzhi;  nga maanḓa;  zwinzhi;  nnzhi;  vhanzhi; vhunzhi;  minzhi; 
multi-party	 madzangano manzhi; mahoro manzhi; 
multilateral	 mashango manzhi; ṱanganelana;  masia manzhi; muṱanganelwa; 
multilingual	 shumisa nyambo nnzhi; nyambo nnzhi; 
multilingualism	vhushumisanyambonnzhi; 
multiparty	-mahoro manzhi; 
multiple	nyandiso; 
municipal	 -masipala; masipala; 
municipalities	mimasipala; 
municipality	masipala; 
murals	zwifanyiso zwa luvhondoni; miolo ya luvhondoni;  makolo a luvhondoni; 
murder	 vhupondi; vhulaya; 
museum	muziamu; 
museums	mimusiamu;  mimuziamu; 
music	muzika; 
musical	ḽitambwa ḽa muzika; 
musician	muimbi; 
musicians	vhaimbi; 
must	fanela;  pfanelo;  kona; 
mutual	 vhoṱhe; khathihi;  ṱangana;  nga u lingana; 
mutually	 vhoṱhe; khathihi;  ṱangana;  nga u lingana; 
my	 zwanga;  tshanga; wanga;  dzanga; 
myself	nṋe muṋe; 
name	 -ira; dzina; 
named	 ira; dzina; 
namely	zwivhidzwa;  ndi uri; zwipfi; 
names	madzina;  ira; 
narrative	nganea; 
narrow	vhusekene; 
natal	beba; 
nation	lushaka;  tshitshavha; 
national	 -lushaka; lushaka; 
nationality	lushaka; 
nationally	lushaka;  tshaka dzoṱhe; 
nationals	lushaka; 
nationhood	lushaka;  tshaka dzoṱhe; 
nations	 zwitshavha; lushaka; 
native	murema; 
natural	 tsha mupo; -mupo; 
nature	mupo;  vhuvha; 
near	tsini;  vhandekana;  sendela tsini; 
nearest	tsini;  vhandekana;  tsinisa;  sendela tsini;  tsini tsini; 
nearly	tsini;  ṱoḓou;  ṱoḓa u vha; 
necessarily	zwithu zwi ṱoḓeyaho; 
necessary	-fanelaho; 
need	tshayo;  ṱhoḓea; 
needed	tshayo;  ṱhoḓea; 
needs	tshayo;  ṱhoḓea; 
negative	 nomboro ya fhasi ha noto;  -khanedza; khanedza; 
negatively	 tshilandulaho; tshilambaho; 
neglect	ṅaledza;  -litshedzela; 
neglected	nditsheledzo; litshedzela;  ṅaledza; 
negligence	vhulitshedzi; 
negotiate	ambedzana; 
negotiated	ambedzana; 
negotiating	ambedzana; 
negotiation	nyambedzano; 
negotiations	nyambedzano; 
neighbouring	vhahura;  mudzulatsini; mufhaṱisani; 
neither	naho e muṅwe; 
net	mambule; 
network	nethiweke; 
networking	netiweke; 
networks	nethiweke; 
never	na khathihi; 
nevertheless	naho zwo ralo;  nangwe zwo ralo; 
new	tshiswa; 
newly	tsini;  zwenezwino; 
news	maswa; 
newsletter	 bammbiri ḽa maswa; bammbiri ḽa mafhungo; 
newsletters	 mabammbiri a maswa; mabammbiri a mafhungo; 
newspaper	gurannḓa; 
newspapers	gurannḓa; 
newsroom	 lufhera lwa mafhungo; lufhera lwa maswa; 
next	zwi tevhelaho; 
night	vhusiku; 
nine	ṱahe; 
no	Aiwa;  evho;  ebo; hai; 
noble	 ṱhonifhea; vhuthu;  luga; 
nominal	 zwi si zwa ndeme; zwiṱuku; 
nominated	ta; 
nominations	muto;  ta; 
non	 sa khethulula; sa vha na tshiṱalula; 
non-compliance	sa tevhedza; 
non-governmental	 tshi si tsha hulumeni; tshi si tsha muvhuso; 
non-profit	tshayambuelo; 
non-racial	 sa khethulula; sa vha na tshiṱalula; 
non-racialism	-sa khethululi; 
non-refundable	sa badela murahu; 
non-sexism	sa ya nga mbeu; 
non-sexist	sa ya nga mbeu; 
non-tax	tshayamuthelo; 
none	a huna; 
nor	kana; 
normal	zwo ḓoweleaho; 
normally	kanzhi;  nga misi; 
norms	mikwa yo tendelwaho; 
north	devhula;  wa devhula; 
northern	tshibvaho devhula; thungo ya devhula; 
not	 nga si;  hayi;  a si; songo; athu; 
notable	ire na phungo; 
notably	ire na phungo; 
note	 noti; ṱari;  tshelede ya ṱari;  -ṅwala; 
noted	 noti; ṱari;  ṅwala;  tshelede ya ṱari; ḽuṅwalo;  tshelede ya mabammbiri; 
notes	notsi; 
nothing	si na tshithu; 
notice	tshenzhemo; 
notices	nḓivhadzo; 
notification	nḓivhadzo; 
notified	ḓivhiswa;  ḓivhadzwa; 
notify	ḓivhisa; ḓivhadza; bvumisa; 
noting	 noti; ṱari;  ṅwala;  tshelede ya ṱari; ḽuṅwalo;  tshelede ya mabammbiri; 
notion	 kuvhonele; muhumbulo; 
notwithstanding	naho zwo ralo; 
novel	 bugu ya nganea; nganea; 
now	zwino;  zwinozwino; 
nuclear	nuklia; 
null	 pumu; gumba;  noto;  si na mushumo;  si zwa ndeme; 
number	 mbalo; tshivhalo;  nomboro; 
numbers	mbalo;  dzinomboro; 
numerous	 tshixele; andesa; 
nurse	muongi;  u onga; 
nurses	 onga; muongi; 
nursing	onga;  lela; 
nurture	 bveledzisa;  londola; tikedza; ṱhongomela; 
nurturing	 ndondolo; mveledziso; ṱhongomelo; 
nutrition	mufusho; 
oath	muano; 
object	 tshiitwa; tshithu; 
objection	kalala; hana;  nyadza; 
objections	kalala; hana;  nyadza; 
objective	ndivho; 
objectives	zwipikwa; 
objects	 zwiitwa; zwithu; 
obligation	pfanelo; 
obligations	pfanelo; 
obliged	fanela;  kombetshedzwa;  takadzwa; 
observatory	tshifhaṱo tsha u lavhelesa ṋaledzi; 
observe	-sedzulusa;  -vhona; 
observed	vhona;  sedzulusa; 
obsolete	laṱwa;  fhirelwaho;  sa tsha shumiswa; 
obtain	wana; 
obtainable	wanala; 
obtained	wana; 
obtaining	wana; 
obvious	-vhonalaho; 
obviously	khagala;  vhonalaho;  pfalaho; 
occasion	 tshikhathi; tshifhinga;  zwi bvelelaho; 
occasions	 zwikhathi; zwifhinga;  zwi bvelelaho; 
occupation	 dzhenelela; mushumo; 
occupational	mushumo; 
occupied	 dzulwa; dzhiwa;  thubiwa; 
occur	bvelela;  itea; 
occurred	bvelela;  itea; 
occurring	bvelela;  itea; 
occurs	bvelela;  itea; 
ocean	 ḓanzhe; lwanzhe; 
of	 vha; ya;  zwa;  tsha;  ḽa;  dza;  ha;  wa;  lwa; 
off	swara; 
offence	 sinyusa;  vhutshinyi;  dinwa;  pfuka; khakhelo;  vhukhakhi;  tsinyuso;  khakhela;  sinyuwa;  dina; mulandu; 
offences	 sinyusa;  vhutshinyi;  dinwa;  pfuka; khakhelo;  vhukhakhi;  tsinyuso;  khakhela;  sinyuwa;  dina; mulandu; 
offender	 mupfuki wa mulayo;  mukhakhi; mutshinyi; 
offenders	 vhapfuki vha mulayo; vhatshinyi;  vhakhakhi; 
offer	tshiṋewa;  tshifhiwa;  kumedza; thendelano;  mpho;  ṋea;  fha;  madzinginywa;  ḽikumedzwa;  kumedzela;  ṋekedza;  gemo; 
offered	fha;  ṋea;  ṋekedza; 
offerings	munikelo;  tshiṋewadzimu; 
offers	fha;  ṋea;  ṋekedza; 
office	 vhuimo; ofisi; 
office-bearers	vhafari vha ofisi; 
officer	-hulumeni; 
officers	vhaofisiri; 
offices	vhuimo;  dziofisi; 
official	mushumeli;  -ofisi; 
officially	zwa tshiofisi; 
officials	 vhashumeli; tshiofisi; 
offset	fhira;  dzima vhuhali;  ṱuma lurere nga thungo;  linganyisa;  ndinganyiso; 
offshore	vhugabeloni; khunzikhunzini; 
often	 lunzhi; kanzhi;  lungana; 
oil	ole; 
old	 tsha kale;  kegula;  kalaha; lala; 
older	 tshihulwane;  zwihulwane; muhulwane; 
oldest	zwihulwanesa;  zwilala; 
omission	vhukhakhi;  hangwa;  khangwa; 
omissions	vhukhakhi;  hangwa;  khangwa; 
on	kha; 
on-going	 sa tumuwi;  bvelaho phanḓa; sa tumuwiho; dzulela;  ṱwa; 
once	luthihi; 
once-off	 kaṅwe;  luthihi fhedzi; luthihi;  kathihi; 
ones	thihi; 
ongoing	 sa tumuwi;  bvelaho phanḓa; sa tumuwiho; dzulela;  ṱwa; 
online	 lubuvhi; shuma; 
only	fhedzi;  iṅwe fhedzi; 
onto	kha; 
open	 aṱama; vula; tibuwa;  ruḓa;  bonyolola/bonyolowa;  tibula;  vulea; 
opened	 aṱama; vula; tibuwa;  ruḓa;  bonyolola/bonyolowa;  tibula;  vulea; 
opening	mvulo; 
opens	 aṱama; vula; tibuwa;  ruḓa;  bonyolola/bonyolowa;  tibula;  vulea; 
operated	ara; 
operates	ara; 
operating	ara; 
operation	maitele;  muaro;  mashumele; 
operational	shuma; 
operations	maitele; marekenele;  mashumele;  miaro; 
operator	mushumisi; 
operators	vhashumisi; 
opinion	vhupfiwa; 
opinions	vhupfiwa; 
opportunities	tshifhinga; 
opportunity	tshifhinga; 
opposed	 hanedzwa; fhambanywa; 
opposite	phambana; 
opposition	mahanedzi; 
oppressed	 shengedzwa; tambudzwa; ṱhuphiwa; 
oppression	ṱhupha; tambudza;  tshengedzo; 
oppressive	ṱhupha; tambudza;  shengedza; 
optimal	 maṱhakheni; khwine; 
optimism	fulufhedzisa;  fhulufhedzisa; 
option	 munango; khetho; 
options	 munango; khetho; 
or	kana; 
oral	orala; 
orange	swiri; 
order	 ndaela;  oda;  thevhekano;  nzudzanyo;  dzudzanya; teaho;  -hoda; 
ordered	 ndaela;  oda;  thevhekano;  nzudzanyo;  dzudzanya; teaho;  hoda; 
orders	 laya;  ṋea ndaela; oda;  hoda; 
ordinance	mulayo; 
ordinarily	nga misi; 
ordinary	 zwa nga misi;  zwawo;  ḓoweleaho;  zwaḽo ; zwawe;  zwatsho; 
organ	 muraḓo;  tshiraḓo; ogeni; 
organisation	ndangulo;  dzangano; 
organisational	 tshiimiswa; ndangulo;  dzangano; 
organisations	ndangulo;  madzangano;  zwiimiswa; 
organised	 dzudzanywa;  nakiswa;  lugiselwa; langulwa; 
organisers	 vhadzudzanyi; vhalanguli; 
organising	 nakisa; langula;  dzudzanya; 
organization	 tshiimiswa;  nakisa; ndangulo;  lugisela;  dzangano;  dzudzanya; 
organizations	ndangulo;  madzangano;  zwiimiswa; 
organized	 dzudzanywa;  nakiswa;  lugiselwa; langulwa; 
organizers	 vhadzudzanyi; vhalanguli; 
organs	zwiraḓo zwa u amba; 
orientation	 sia;  pfumbudza;  khwaṱhisedza; engele;  ḓivhadza;  vhuvha; fhethu;  nḓowelo; 
origin	vhubvo;  tsiko;  mathomo; 
original	rangaho; 
originally	mathomoni; 
origins	vhubvo;  tsiko;  mathomo; 
other	 vhuṅwe; maṅwe;  muṅwe;  dziṅwe;  zwiṅwe;  tshiṅwe; 
others	vhaṅwe; 
otherwise	 nga iṅwe nḓila; nga muṅwe mukhwa; 
ought	fanela;  nga kona;  kona; 
our	yashu;  zwashu; 
ours	yashu;  zwashu; 
ourselves	riṋe vhaṋe;  riṋe vhukuma; 
out	 nga nnḓa;  sa vha haya; nnḓa; 
outcome	 mawanwa; mvelelo;  masiandaitwa; 
outcomes	 mawanwa; mvelelo;  masiandaitwa; 
outdoor	 -nnḓa; nnḓa; 
outgoing	ane a khou bva; 
outline	-tandula; 
outlined	tandula; puḽane; 
outlines	tandula; puḽane; 
outlook	 kuvhonele;  kuhumbulele; vhuimo;  muhumbulo;  kupfesesele; 
output	zwibveledzwa; 
outputs	zwibveledzwa; 
outreach	swikela;  fhirisa;  nḓisedzo ya tshumelo tshitshavhani; 
outside	vhunnḓa;  nnḓa; 
outsourced	itelwa mushumo nga vhaṅwe; 
outstanding	 zwo salelaho; zwihulwanesa;  zwa maṱhakheni;  zwa nṱhesa; 
outward	 nga nnḓa; thungo ya nnḓa; 
oval	-ngaho gumba; 
over	 nṱha nga ṱaḓulu;  zwo fhira; nṱha ha; 
overall	ovarolo; 
overarching	zwihulwanesa; zwo angalalaho; 
overcome	 balela;  fhenya; kunda; 
overcrowding	u ḓalesa; 
overseas	seli ha lwanzhe; 
oversee	 tandula;  ingamela; lavhelesa; 
overseeing	 tandula;  ingamela; lavhelesa; 
oversight	thidza; 
overview	 manweledzo;  samari; mavhalanngwe; mbonalo; 
overwhelming	 sa takalela;  kundwa;  ṱukufhadza; kunda; 
owed	 vha na mulandu; koloda; 
owing	 vha na mulandu; koloda; 
own	tshithu tsho fuiwaho;  vha muṋe wa tshithu;  vha na; 
owned	langiwa; 
owner	ṋemuḓi;  muṋe; 
owners	vhaṋe; 
ownership	vhuṋe; 
pace	luvhilo; 
package	paka;  putela; zwiputelwana;  thundu yo putelwaho; 
packages	paka;  putela; zwiputelwana;  thundu yo putelwaho; 
page	siaṱari; 
pages	masiaṱari; 
paid	badela;  malamba; 
pain	vhuṱungu; 
painful	 pfisaho vhuṱungu; ṱungufhadza; 
painting	u pennda; 
paintings	muolokone; pennda; zwipenndwa; 
palace	pfamo;  nnḓu ya vhuhosi; 
paper	phepha; 
papers	maphepha; mabammbiri; 
paragraph	ndima; 
paragraphs	ndima; 
parameters	mikano;  masakha; 
parent	mubebi; 
parental	-tsha mubebi; 
parenting	mubebi; 
parents	vhabebi; 
park	 -paka; phakha;  phakhani; 
parking	paka;  phakha;  phakhani; 
parks	paka;  phakha;  phakhani; 
parliament	phalamennde; 
parliament's	 zwa phalamennde; zwa phaḽamennde; 
parliamentarians	 miraḓo ya phalamennde; miraḓo ya phaḽamennde; 
parliamentary	 Zwa phalamennde; Zwa phaḽamennde; 
parliaments	phalamennde; 
parole	parula; 
part	tshipiḓa;  thinwaipfi; 
part-time	tshifhinganyana; 
partial	tshipiḓa;  songo fhelelaho; 
partially	tshipiḓa;  songo fhelelaho; 
participant	vhadzheneli; 
participants	muitanae; vhadzheneli; 
participate	ḓidzhenisa;  shela mulenzhe; 
participated	ḓidzhenisa;  shela mulenzhe; 
participates	ḓidzhenisa;  shela mulenzhe; 
participating	ḓidzhenisa;  shela mulenzhe; 
participation	ḓidzhenisa;  shela mulenzhe; 
participatory	vhushelamulenzhe; 
particular	khetha huhulu; 
particularly	nga u khetha huhulu; 
particulars	zwidodombedzwa; 
parties	mahoro; 
partly	tshipiḓa;  songo fhelelaho; 
partner	mushumisani;  mufunwa; 
partnered	mufarakani; mushumisani;  mufunwa; 
partners	mufarakani;  mufunwa; vhashumisani; 
partnership	vhufarakani; 
partnerships	binduṱhanganelwa; vhufarakani; 
parts	fhambana;  zwipiḓa;  thinwaipfi; 
party	ḽihoro; 
pass	 u rahela; phasa;  basa; 
passed	 rahela; muṋekedzo; phasa;  basa; 
passenger	vhanameli; 
passengers	vhanameli; muṋamedzwa; 
passes	 rahela; muṋekedzo; phasa;  basa; 
passing	 fhirisa; thendelo;  ngalangala;  fhira;  ṋekedza;  phasa; 
passport	phasipoto; 
past	u bva kha; 
path	nḓila; 
patient	mulwadze; 
patients	mulwadze; 
patriotism	lufuno lwa shango ḽa hawe; 
pattern	phetheni; 
patterns	phetheni; 
paved	lugisela;  semendelwa; pheiviwa; 
pavilion	 dennde khulu; vhugalatenga; phaviḽioni; 
pay	badela;  malamba; 
payable	badelwaho;  ndifho; holelwaho; 
paying	badela;  malamba; 
payment	mbadelo; 
payments	mbadelo; 
pays	badela;  malamba; 
peace	mulalo; 
peaceful	nga mulalo; 
peak	maṱhakheni;  tshiuludzani; muṱumbani wa thavha;  ṱhodzi;  ṱhodzi ya thavha; 
peer	thanga; 
penalties	ndaṱiso; 
penalty	ndaṱiso; 
pending	lindelaho; sa thu fhelaho; 
pensions	phensheni; 
people	vhathu;  dzitshaka; 
people's	zwa dzitshaka;  zwa vhathu; 
peoples	vhathu;  dzitshaka; 
per	nga; 
perceived	 limuha;  sedzesa; pfa; 
percent	phesenthe; 
percentage	phesenthedzhi; 
percentages	phesenthedzhi; 
perception	 kuvhonele; muhumbulo;  kupfesesele;  nḓivho; 
perceptions	 kuvhonele; muhumbulo;  kupfesesele;  nḓivho; 
performances	tamba; 
performed	tamba; 
performer	vhutambi; 
performers	vhutambi; 
performing	tamba; 
performs	tamba; 
perhaps	 ṱhaṅwe; khaṅwe; khamusi;  ṱhamusi; 
period	tshifhinga; 
periodical	dzhenala;  -misi yatsho; 
periods	 u ya maḓuvhani;  u vhona ṅwedzi; zwifhinga; 
perjury	mulandu wa u aneya u zwifha; nganelamafhanza; 
permanent	tshoṱhe; 
permission	thendelo; 
permit	thendelo;  -tendela; 
permits	thendelo;  tendela; 
permitted	thendelo;  tendela; 
perpetuate	bvisela tshithu phanḓa; 
person	muthu;  muthu wa vhuraru;  muambi; 
person's	zwa muthu; 
personal	 tshi re tsha muthu; muthu; 
personally	muthu ene muṋe; 
personnel	vhashumi; 
persons	vhathu;  muthu wa vhuraru;  vhaambi; muambanae; 
perspective	vhuvhambedzanyi; 
perspectives	vhuvhambedzanyi; 
pertaining	kwama;  tshimbilelana; 
petition	phethisheni;  ḽiṅwalo ḽa u gwalaba; 
petitions	phethisheni;  maṅwalo a u gwalaba; 
petrol	piṱirolo; 
pharmaceutical	 mishonga; dzilafho; 
pharmacist	murengisi wa mishonga; 
pharmacy	 vhurengisamishonga; khemisi; 
phase	ndima ya vhutshilo; 
phased	ndima ya vhutshilo; 
phases	ndima ya vhutshilo; 
phenomenon	tshibveleli; 
phone	 founu; luṱingo; 
photo	tshifanyiso;  tshinepe; 
photograph	tshinepe;  mudzhii wa zwinepe; 
photographer	mufodi wa khamera; 
photographers	vho rakhamera; 
photographic	tshinepe tsho itwaho;  tshifanyiso tsho itwaho; 
photographs	zwinepe; vhadzhiyazwinepe; 
photos	zwinepe;  zwifanyiso; 
physical	 zwa muvhili; muvhili;  -muvhili; 
physically	 mbumbo; muvhili; 
picture	tshifanyiso; 
pictures	zwifanyiso; 
piece	tshipiḓa; 
pieces	zwipiḓa; 
pillar	phuphu; 
pillars	phuphu; 
pilot	mutshimbidzabufho;  mutshimbidzafulaimatshini; 
pioneers	 mazhakanḓila;  vhasiki;  vhatumbuli; vhaphuḽanḓila; vhabveledzi; 
piracy	vhuvhava; 
pivotal	ndeme; 
place	fhethu; 
placed	vhewa; 
placement	 thola; vhea; 
places	fhethu; 
placing	fhethu; 
plain	-pfalaho; 
plains	pfalaho; bale; 
plaintiff	 muvhilaeli; muhweleli; mumangali; 
plaintiff's	 muvhilaeli; muhweleli; mumangali; 
plan	nzudzanyo; 
planned	puḽane; nzudzanyo; 
planning	 mudzudzanyo; vhupulani; 
plans	puḽane; nzudzanyo; 
plant	 -sima;  -ṱavha; tshimela; 
plants	 ṱavha;  sima; zwimela; 
plastic	 luṋonzhe; -luṋonzhe; 
plate	baphathi; 
platform	puḽatifomo;  tshiṱanḓavhathu; tshiteidzhi; 
platforms	 zwiṱanḓavhathu; puḽatifomo; zwiteidzhi; 
platinum	pulatinamu; 
play	 ḽitambwa; mutambo; 
played	 ḽitambwa; mutambo; 
player	mutambi; 
players	vhatambi; 
playhouse	tshitudio;  nnḓu ya mitambo; 
playhouses	 tshitudio; nnḓu dza mitambo; 
playing	 ḽitambwa; mutambo; 
plays	 matambwa; mutambo; 
plea	 ḓifhindulela; khumbelo;  ipfi ḽa u ḓiambela; 
pleading	ḓifhindulela;  ḓiambela; 
pleadings	ḓifhindulela;  ḓiambela; 
please	takadza; 
pleased	takadzwa; 
pleasure	dakalo; 
pledge	 fulufhedzisa;  ana;  khwaṱhisedzo; khwaṱhisedza;  fhulufhedzisa;  muano; 
pledged	 fulufhedzisa;  ana;  khwaṱhisedzo; khwaṱhisedza;  fhulufhedzisa; 
plenary	fhelelaho;  muṱangano; 
plight	thaidzo;  vhuleme; fashea;  hanganea; 
plus	 tshiga tsha u ṱanganya; na; 
poaching	vhutswaphukha; 
poem	tshirendo; 
poet	murendi; 
poetry	vhurendi; 
poets	vharendi; 
point	 ṱhodzi;  tshithoma; sumba; 
pointed	khiso;  ṱhodzi;  tshithoma; sumba; 
points	khiso;  ṱhodzi;  tshithoma; sumba; 
police	 mapholisani; pholisa; 
policies	dzanganelo;  phoḽisi ya zwa ndindakhombo; mbekanyamaitele;  konṱiraka; 
policing	pholisa; 
policy	 phoḽisi ya zwa ndindakhombo; mbekanyamaitele;  konṱiraka; 
politics	poḽotiki; 
pollution	mutshikafhadzo; 
pool	tivha; 
poor	vhushai; 
poorer	vhushai; 
poorest	vhushai; 
poorly	lwala;  phoswo;  vhaisala; 
popular	-takalelwaho;  ḓivheaho; 
population	vhathu;  vhadzulapo; 
pornography	phonogirafi; 
port	vhuimangalavha; photho;  hune tshikepe tsha kona u swika; 
portfolio	muhasho; 
portion	mukovhe;  tshipiḓa; 
portray	-fanyisa; 
portrayed	fanyisa; 
ports	vhuimangalavha;  hune tshikepe tsha kona u swika; 
posed	phouza; 
position	vhuimo;  tshiimo; 
positions	vhuimo; 
positive	phosethivi; 
positively	 nga ngoho; vhukuma; 
possess	fuwa;  vha na; 
possession	ndaka;  u vha na bola; 
possibilities	khonadzeo; 
possibility	khonadzeo; 
possible	itea;  konadzea;  konea; 
possibly	 ṱhaṅwe; khaṅwe; khamusi;  ṱhamusi;  ngavha; 
post	 poswo; mushumo;  -rumela; 
post-apartheid	ho no fhira tshiṱalula; 
postal	zwa poswo; 
postgraduate	 tshitshudeni; bvelelaho;  muṱweladigirii;  muḓigudisi; digirii ya vhuvhili; mutshudeni; 
postponed	imiswa;  fhiriswa;  lengiswa; 
postponement	 imisa;  lengisa; fhirisa; 
posts	 poswo; mishumo;  rumela; 
pot	 khali; bodo; 
potential	khonadzeo;  tshi nga iteaho; 
potentially	konadzea;  nga bvelelaho; 
poverty	vhushai; 
power	 maanḓa;  phawa; ḓiandisa; 
powerful	tshi re na maanḓa; 
powers	 maanḓa;  phawa; ḓiandisa; 
practicable	konea;  tshi nga itwaho; 
practical	no itwa; hu nga shumwa ngayo; 
practice	mushumo;  nḓowenḓowe;  nḓowelo; 
practices	mishumo;  nḓowenḓowe;  nḓowelo; 
practise	 ita nḓowenḓowe; -ita nḓowenḓowe; 
practitioner	mutsila; 
practitioners	vhatsila; 
praise	 khoḓa;  thendo;  renda;  nduvho;  tshikhoḓo; luvha; 
prayer	thabelo; 
pre-colonial	phanḓa ha zwa vhukoḽoni; 
pre-trial	fhira;  kunda; 
preamble	 tswikiso; marangaphanḓa; 
precede	-rangela; 
preceded	rangela; 
preceding	rangela; 
precinct	 vhupo;  mukano; khethekanyo; 
precincts	 vhupo;  mukano; khethekanyo; 
precious	 tshavhuḓi; tshi ḓuraho; 
precisely	nga vhuronwane; 
preference	tama;  funa; 
preferential	tameaho;  funeaho; khetheaho; 
preferred	tama;  funa; 
pregnancy	vhuimana; 
pregnant	u vhifha muvhilini;  -vhifha muvhilini; 
prejudice	khethululo; 
preliminary	-ndugiselo; 
premier	mulangavundu; 
premised	ḓivhadza khanedzano;  muteo wa khanedzano; 
premises	masimu;  dzinnḓu; 
preparation	 nzudzanyo;  ndugiselo; mbekanyo; 
preparations	 nzudzanyo;  ndugiselo; mbekanyo; 
preparatory	-ndugiselo; 
prepare	lugisa; 
prepared	 vhekanya; dzudzanya;  lugisela;  lugisa; shungusedza; 
preparing	lugisa; 
prescribe	 vhea mulayo;  randela; laela;  vhudza mushonga; 
prescribed	-randelwaho; 
prescribing	 vhea mulayo;  randela; laela;  vhudza mushonga; 
prescription	mushonga une dokotela a ri u fanela u shumiswa; 
prescripts	milayo; 
presence	zwino; 
present	 tshifhiwa;  mpho;  ṋea;  fha;  nduvho;  ṋamusi; hone; 
presentation	mukumedzo; 
presentations	mukumedzo; 
presented	fhiwa;  ṋewa; 
presenting	fha;  ṋetshedza; 
presently	zwino;  zwenezwo; 
presents	fha;  dzimpho;  zwifhiwa;  ṋea;  nduvho; 
preservation	ndondolo; 
preserved	tshithivhelatsino; 
preserving	tshithivhelatsino; 
preside	 dzula phanḓa; tshimbidza; 
presidency	 zwa mutshimbidzi; zwa ṱhoho;  zwa muphuresidennde;  zwa mulangashango; 
president	phuresidennde; 
president's	pwanyeledza;  gada;  tsikeledza;  ṱereka; gadeledza;  aina;  phuresa; 
presidential	 zwa mutshimbidzi; zwa ṱhoho;  zwa muphuresidennde;  zwa mulangashango; 
presidents	phuresidennde; 
presiding	takalelwa;  tamiwa; 
press	puṱedza;  -pwanyeledza; 
pressing	fhulufhedzwa; lingedzwa;  fulufhelwa; 
pressure	mutsiko; 
pressures	mutsiko; 
prestigious	tsha ndeme; 
presumed	ndingothangeli;  tsengothangeli; 
pretty	fhira;  kunda; 
prevail	 mathomoni; fhiraho; 
prevailing	fhira;  kunda; 
prevalence	tshivhalo tsha vho kavhiwaho; 
prevent	 u thivhela; -thivhela; 
prevented	thivhela; 
preventing	thivhela; 
prevention	muthivhelo; 
previous	zwa murahu; 
previously	 mathomoni; fhiraho; 
price	mutengo; 
prices	mitengo; 
pricing	mutengo; 
pride	u ḓikukumusa; 
priest	mufunzi;  tshifhe; 
prima	wa mathomo kha vhoṱhe;  wa khwine kha vhoṱhe; 
primarily	 nga maanḓa; tsha phanḓa;  tsha u thoma; 
primary	 zwa mutheo; phuraimari; 
prime	 i ṱavhanyaho; ya u thoma; 
principal	pfuma;  ṱhoho ya tshikolo; 
principals	pfuma;  ṱhoho ya tshikolo; 
principle	mulayo;  maitele; 
principles	maitele;  milayo; 
print	-ṅwala;  -gandisa;  silagandiswa; 
printed	ṅwala;  silagandiswa; ganḓisa;  muganḓiso; 
printing	ṅwala;  silagandiswa; ganḓisa;  muganḓiso; 
prior	u thomani;  phanḓa;  nga phanḓa; 
priorities	zwa ndemesa; 
prioritise	thoma ngazwo;  rangisa phanḓa; 
prioritised	thomiwa ngazwo; rangiswa phanḓa; 
priority	tsha ndemesa; 
prison	 ṱironngo;  khothoni; dzhele; 
prisoner	mufariwa;  tshivhotshwa; 
prisoners	 vhafariwa;  zwibandidi; zwivhotshwa; 
prisons	 ṱironngo;  khothoni; dzhele; 
privacy	tshiphiri;  tshidzumbe; 
private	 i re yoṱhe; tshiphiri;  phuraivethe; 
privilege	vhuṱalu; 
privileged	ṱaluswa; 
prize	pfufho; 
prizes	pfufho; 
pro	 makone; zwa;  muḓivhi; phurofeshinaḽa; 
proactive	vhurangeli;  ḓalaho mafulufulu; 
probably	khamusi; 
probation	lingisa; ndingo; 
probe	 linga;  ṱola zwavhuḓi; 
problem	thaidzo; 
problems	thaidzo; 
procedural	 mukhwa wa kutshimbidzele; kuitele; 
procedure	maitele;  kuitele; 
procedures	maitele;  kuitele; 
proceed	 isa phanḓa;  ya phanḓa; bvela phanḓa; 
proceeding	dzudzanywaho;  zwiitei; 
proceedings	matshimbidzele; 
proceeds	 isa phanḓa;  ya phanḓa; bvela phanḓa; 
process	maitele;  nḓila ya u ita zwithu;  nḓila;  -bveledza;  kuitele; 
processed	maitele;  bveledza;  nḓila ya u ita zwithu;  nḓila;  kuitele; 
processes	maitele;  bveledza;  nḓila ya u ita zwithu;  nḓila;  kuitele; 
processing	maitele;  bveledza;  nḓila ya u ita zwithu;  nḓila;  kuitele; 
procession	 u tevhelelana; salana murahu; muduba; 
proclamation	mulevho; 
procurement	 renga;  wana;  wanela muṅwe; 
produce	bveledza;  -bveledza;  tshibveledzwa; 
produced	bveledza;  tshibveledzwa; 
producer	mubveledzi; 
producers	mubveledzi; 
produces	bveledza;  tshibveledzwa; 
producing	bveledza;  tshibveledzwa; 
product	tshibveledzwa; 
production	vhubveledzi; 
productions	vhubveledzi; 
productive	tshi no bveledza; 
productivity	vhubveledzi; 
products	nyandiselo; tshibveledzwa; 
profession	 mushumogudwa; phurofesheni;  bula;  ḓiambulula; 
professionals	mishumogudwa;  phurofeshinaḽa; 
professions	 mushumogudwa; phurofesheni;  bula;  ḓiambulula; 
professor	mufunzi wa tshikolo tshihulu; 
profit	mbuelo;  bindu; 
profits	mbuelo;  bindu; 
profound	 tshihulu tsho thomaho fhasi; ndeme; 
program	phurogireme; 
programme	mbekanyamushumo; 
programmed	mbekanyamushumo; 
programmes	mbekanyamushumo; 
programming	u phrogirema; 
programs	phurogireme; 
progress	mvelaphanḓa;  -bvela phanḓa; 
progression	mvelaphanḓa; 
progressive	bvelela; 
prohibit	iledzwa; 
prohibited	iledzwa; 
prohibition	 nyiledzo; thivhela; 
project	-posela; 
projected	thandelo; posela; 
projection	phosela; 
projections	phurodzhekisheni; phosela; 
projects	 posela; thandela; 
prominent	tshi fhiraho zwiṅwe; 
promise	 fhulufhedziso; fulufhedzisa;  fulufhedziso;  fhulufhedzisa; 
promised	 fulufhedziswa; fhulufhedziswa; 
promises	 fhulufhedziso; fulufhedzisa;  fhulufhedzisa; 
promote	bveledza; 
promoted	takuselwa nṱha; 
promotes	ṱuṱuwedza; 
promoting	bveledza; 
promotion	mufhiriso; 
promptly	nga u ṱavhanyedza; 
promulgated	 vhea mulevho;  ḓivhadzwa; khwaṱhisedzwa; 
promulgation	mulevho; khwaṱhisedzo; nḓivhadzo; 
proof	 tsumbo;  u bvisa phoso ya u ṅwala; vhuṱanzi; 
proper	linganaho vhukuma; 
properly	nga pfanelo yayo; 
properties	ndaka;  vhunzani;  zwiṱalusi; 
property	ndaka;  vhunzani; 
proportion	ndivhanele;  tshipiḓa; 
proposal	ḽikumedzwa;  u dzinginya; 
proposals	makumedzwa;  dzinginya; 
propose	-kumedza; 
proposed	kumedza; 
proposes	kumedza; 
prosecute	tshutshisa; 
prosecuted	tshutshiswa; 
prosecuting	tshutshisa; 
prosecution	vhutshutshisi; 
prosecutions	vhutshutshisi; 
prosecutor	muvheamulandu; 
prosecutors	vhatshutshisi; 
prospect	-ṱoḓa; 
prospecting	ṱoḓa; 
prospective	 hu si kale; konadzea;  tsha ndeme; 
prospects	ṱoḓa; 
prospectus	mutevhe;  tshibugwana; burosha;  phamufuḽethe; 
prosperity	bvelela; 
prosperous	bvelelaho; 
protect	 -tsireledza; u tsireledza; 
protected	tsireledza; 
protecting	tsireledza; 
protection	tsireledzo; 
protective	-tsiredzo; 
protector	mutsireledzi; 
protest	mugwalabo;  -gwalaba; 
protests	 migwalabo; gwalaba; 
protocol	thevhekano ya maga a dzilafho; 
protocols	thevhekano ya maga a dzilafho; 
proud	ḓihudza; 
proudly	 ḓikukumusa; ḓiṱongisa;  ḓihudza; 
prove	sumbedza;  khwaṱhisedza;  ṱanziela; 
proved	sumbedziswa;  khwaṱhisedzwa;  vhungoho ha tshithu;  ṱanzielwa; 
proven	sumbedziswa;  khwaṱhisedzwa;  vhungoho ha tshithu;  ṱanzielwa; 
provide	fha;  ṋea;  u ḓilugisa;  u lugisela; 
provided	 lugiselwa; fhiwa;  ṋewa; 
provident	vhuronwane; dzudzanywaho zwavhuḓi; vhutsila; 
provider	muṋetshedzi; 
providers	vhaṋetshedzi; 
provides	fha;  ṋea;  u ḓilugisa;  u lugisela; 
providing	fha;  ṋetshedza;  ṋea;  lugisela; 
province	vundu; 
province's	vundu; 
provinces	mavundu; 
provincial	zwa vundu; 
provision	 mbuvha; thendelo;  zwiḽiwa;  mbetshelwa; 
provisional	zwenezwo;  tshifhinga tshauri; 
provisions	 mbuvha; thendelo;  zwiḽiwa;  mbetshelwa; 
proviso	mbetshelwa; 
proxy	muimeli; 
prudent	vhutsila;  vhuronwane; 
prudential	vhutsila;  vhuronwane; 
psychological	zwa saikhoḽodzhi; 
public	nnyi na nnyi; 
publication	khanḓiso; 
publications	khanḓiso; 
publicly	 luvhanḓeni khagala; vhathuni; 
publish	anḓadza; 
published	anḓadza; 
publisher	mugandisi; 
publishers	 vhaganḓisi; vhagandisi; 
publishes	anḓadza; 
publishing	anḓadza; 
punishment	ṱhamu; 
purchase	u renga; 
purchased	renga; 
purchases	renga; 
purporting	humbula; 
purpose	ndivho; 
purposes	ndivho; 
pursuant	 tovhola;  tevhelela;  pandamedza;  londa; shuma; 
pursue	 tovhola;  tevhelela;  pandamedza;  londa; shuma; 
pursued	 tovhola;  tevhelela;  pandamedza;  londa; shuma; 
pursuing	 tovhola;  tevhelela;  pandamedza;  londa; shuma; 
pursuit	 ṱoḓa;  pandamedzwa;  tevhelelwa;  tovholwa;  londwa; funa; 
push	-sukumedza; 
put	 gadza;  vhekanya;  ladza;  khakhulula;  longela;  longa;  lugisa; vhea;  tiba; 
puts	 gadza;  vhekanya;  ladza;  khakhulula;  longela;  longa;  lugisa; vhea;  tiba; 
putting	vhea; 
qualification	ndalukanyo;  ndalukano; 
qualifications	ndalukano; 
qualified	-re na ndalukano; 
qualify	 -tea;  -ṱalula; u swikela; 
qualifying	 ṱalula; tea;  swikela; 
qualitative	vhuvha;  vhunzani; 
qualities	vhunzani; 
quality	vhunzani; 
quantitative	 zwi kaleaho; zwi vhaleaho; ḽisalambalo; 
quantity	vhunzhi; 
quarter	kotara; 
quarterly	nga kotara; 
quarters	vhudzulo; 
queen	khosi; 
queries	mbudziso; 
quest	ṱhoḓisiso; 
question	mbudziso; 
questioned	mbudziso; 
questionnaires	mbudzisoṱholi; 
questions	mbudziso; 
quickly	 nga luvhilo;  nga u ṱavhanya; ṱavhanyisa;  zwinozwino; 
quite	nga mukhwa wo ḓalaho; 
quorum	 khoramu; vhunzhi; 
quotation	muredzo; 
quotations	muredzo; 
quote	redza;  khoutha; 
race	 mbambe;  -ita mbambe; lushaka; 
races	 mbambe;  mirafho;  ita mbambe; tshakha;  matsinde; 
racial	-tsinde; 
racism	 khethano nga muvhala; tshiṱalula; 
racist	khethululo nga lushaka; 
raid	 ṱasela; u shandukela; mudodo; 
rail	muthambi; 
railway	tshiporo; 
rain	mvula;  mvula i a na; 
rainbow	 musengavhadzimu; musingavhadzimu; 
rainfall	vhuno;  u na ha mvula; 
raise	-imisa; 
raised	imisa; 
raises	imisa; 
raising	imisa; 
rand	rannda; 
range	tsielano; 
ranges	vhugimo; tsielano;  vhupimakoni; 
ranging	vhugimo; tsielano;  vhupimakoni; 
rank	vhuimo;  tshiimo; 
ranks	dzirennge;  vhuhulu; fhethu; 
rape	binya;  -tshipa;  mutshipo;  u binya;  mubinyo; 
rapid	 -ṱavhanya; lutsinga; 
rapidly	 nga luvhilo; nga u ṱavhanya; 
rare	tshi sa wanali; 
rate	phimo;  -pima; 
rates	phimo; phimamvelela;  pima; 
rather	-khwine; 
ratification	thendelo;  khwaṱhisedzo; 
ratified	 khwaṱhisedzwaho; tendelwaho; 
rating	vhuimo ha; 
ratings	vhuimo ha; 
ratio	ndivhanele;  reshio; 
rationalisation	ṱhalutshedzo;  khwaṱhisedzo;  tshiitisi; 
raw	 tshivhisi;  songo bikwaho; mbisi; 
reach	swika;  swikela; 
reached	swika;  swikela; 
reaching	swika;  swikela; 
read	vhala; 
reader	muvhali; 
readers	vhavhali; 
readily	ḓiimisela; 
readiness	ḓiimisela; 
reading	tshivhalo;  -vhala; 
ready	 lugiswaho; linganaho; 
reaffirm	khwaṱhisedza; 
real	vhukuma;  ngoho; 
realisation	vhona;  limuha;  limuwa;  ṱalukanya; 
realise	vhona;  limuha;  limuwa;  ṱalukanya; 
realised	vhona;  limuha;  limuwa;  ṱalukanya; 
realising	vhona;  limuha;  limuwa;  ṱalukanya; 
realities	ngohongoho vhukuma; 
reality	ngohongoho vhukuma; 
realization	vhona;  limuha;  limuwa;  ṱalukanya; 
realize	vhona;  limuha;  limuwa;  ṱalukanya; 
really	 vhukuma kuma; ngoho; 
reason	tshiitisi;  -ṱaṱa; 
reasonable	pfesesea; 
reasonably	pfalaho; 
reasons	 ṱaṱa; zwiitisi; 
reburial	 vhulungwa hafhu; 
recall	u bvisa tshiduloni; 
recapitalisation	thundu;  tshandukiso ya mbumbo ya ndaka;  tshelede; khephithaḽa; 
receipts	rasithi; 
receive	 u wana; -ṱanganedza; 
received	wana;  ṱanganedza; 
receives	wana;  ṱanganedza; 
receiving	wana;  ṱanganedza; 
recent	tshiswa tshi kha ḓi bva uḓa; 
recently	tsini;  mulovha;  zwenezwino; 
reception	mugavho; 
recession	wa ha ekonomi ha tshifhinganyana; 
recipient	muṱanganedzi; 
recipients	vhaṱanganedzi; 
reclaim	 dzhiulula; tshidza;  mbuyedzedzo; 
recognise	ḓivha; 
recognised	 ṱaluswa; tendelwa;  ḓivhiwa; 
recognises	tenda;  ḓivha;  ṱalusa; 
recognising	tenda;  ḓivha;  ṱalusa; 
recognition	nzhele;  nḓivho; 
recognize	tenda;  ḓivha;  ṱalusa; 
recognized	 ṱaluswa; tendelwa;  ḓivhiwa; 
recommend	-themendela; 
recommendation	mahumbulwa; 
recommendations	mahumbulwa; 
recommended	themendela; 
recommends	themendela; 
reconciliation	vhupfumedzanyi; 
reconstruction	fhaṱulula;  mbuyedzedzo; 
record	 rekhodo ya tshomedzo;  rekhoda; rekhodo; 
recorded	 rekhodo ya tshomedzo;  rekhoda; rekhodo; 
recording	-rekhoda; 
records	 rekhodo dza tshomedzo;  rekhoda; rekhodo; 
recover	dzhiulula;  dzumbulula zwo xelaho; dzivhuluwa; fhola; 
recovered	dzhiululwa; dzivhuluwa; fhola; 
recovery	u fhola; 
recreational	netuluso; vhuḓimvumvusi; 
recruitment	 thoma vhuswole; thola; 
rectify	khakhulula;  lugisa zwo kombamaho;  lulamisa; 
recycling	mbuyedzedzo;  vhukunakisi; 
red	tswuku; 
redistribution	kovhekanyulula; nzudzanyululo; 
redress	 petulula;  khakhulula; lugisa;  lulamisa; 
reduce	 shandula;  -fhungudza; fhungudza; 
reduced	 shandula; fhungudza; 
reducing	 shandula; fhungudza; 
reductions	ṱhumbulo; 
refer	laedza; 
reference	bugu tshumiswa; 
references	bugu tshumiswa; 
referral	ndaedzo; 
referred	laedzwa; 
referring	 amba nga ha; zwi amba; 
refers	laedza; 
refined	-nangudzwaho; 
reflect	-vhonisa; 
reflected	vhonisa; 
reflecting	vhonisa; 
reflection	khumiso;  tshivhoniswa; 
reflective	dzeula; 
reflects	vhonisa; 
reform	tshanduko; 
reforms	tshanduko; 
refund	lifha;  mbuyedzedzo;  mbuiselo; 
refurbishment	 vusuludza;  mbuedzedzo; lugisa;  lulamisa; 
refusal	ndandulo; khano; 
refuse	-hana; 
refused	hana; 
refuses	hana; 
regard	 dzhia; vhona;  thetshelesa; 
regarded	 thetsheleswa; dzhiwa;  vhonwa; 
regarding	 ho sedzwa; hu tshi humbulwa;  malugana na; 
regardless	 hu songo thetsheleswa; hu songo sedzwa; 
regards	 dzhia; vhona;  ndumeliso;  lumelisa;  thetshelesa; 
regeneration	 bebwa lwa vhuvhili; 
regime	muvhuso; 
region	dzingu; 
regional	-dzingu; 
regions	madzingu; 
register	redzhisiṱara; 
registered	 ridzhisiṱara; redzhisiṱara; 
registering	redzhisiṱara; ridzhisiṱara; 
registers	redzhisiṱara; ridzhisiṱara; 
registrar	muofisirimutshimbidzi;  mabalane; mulanguli; 
registration	u ḓiṅwalisa; 
registries	 ofisi dza ndaulo; ofisi; vhuvhulungamaṅwalo;  ofisi dza dzirekhodo; 
registry	 ofisi ya ndaulo; ofisi; vhuvhulungamaṅwalo;  ofisi ya dzirekhodo; 
regular	 -misi yoṱhe;  -ḓowelaho; misi yoṱhe; 
regularly	misi yoṱhe; 
regulate	 u laula; langa; 
regulated	 laula; langa; 
regulates	 laula; langa; 
regulating	 laula; langa; 
regulation	ndaulo; 
regulations	ndaulo; 
regulator	mulangi;  mutshimbidzi; 
regulators	vhatshimbidzi;  vhalangi; 
regulatory	tshimbidzwaho;  langwaho; 
rehabilitation	mbueledzo; 
rehearsal	nḓowenḓowe; 
rehearsals	nḓowenḓowe; 
reinforce	khwaṱhisa; 
reintegration	 dzivhuluwa;  dzilafho; thuso;  mbuedzedzo; 
reiterate	dovholola;  amba hafhu;  ita hafhu; 
reiterated	dovhololwa;  itwa hafhu;  ambiwa hafhu; 
reject	-hana; 
rejected	hana; ḽilambelo; 
relate	tondisa;  hanelela;  toolola; tevhedza;  anetshela; 
related	elana; 
relates	tondisa;  hanelela;  toolola; tevhedza;  anetshela; 
relating	tondisa;  hanelela;  toolola; tevhedza;  anetshela; 
relation	vhushaka; 
relations	vhushaka; 
relationship	vhushaka; 
relationships	vhushaka; vhufunani; 
relative	 -vhushaka; shaka; 
relatively	 mbambedzo; linganaho; 
relatives	ḽiitiḽiṱaluli; vhushaka;  mashaka; 
release	-vhofholola;  anḓadza; 
released	vhofholola;  anḓadza; 
releases	vhofholola;  anḓadza; 
relevance	ndeme; 
relevant	tshimbilelanaho; 
reliable	fulufhedzeaho; 
religion	vhurereli; 
religions	vhurereli; 
religious	-vhurereli; 
rely	 pika;  fhulufhela; fulufhela;  fulufhedza;  fhulufhedza; 
remain	sala; 
remainder	salaho; 
remained	sala; 
remaining	sala; 
remains	masalela; 
remand	 valelwa dzhele;  humiselwa dzhele; khothoni; 
remarkable	 tshimangadzo; tshi eleliwaho; 
remarks	mihumbulo;  limuha;  elelwa; 
remedies	dzilafho; 
remedy	dzilafho; 
remember	humbula;  elelwa; 
remembered	humbula;  elelwa; 
remembrance	tshihumbudzo;  khumbulo;  khumbudzo; 
remind	 tsivhudza;  humbudza; eletshedza; 
reminded	eletshedzwa;  humbudzwa;  tsivhudzwa; 
reminder	 nyeletshedzo; tsivhudzo; tshihumbudzi; 
reminders	 zwihumbudzi;  nyeletshedzo; tsivhudzo; 
remote	kule; 
removal	 tsiruswa;  sudzuluswa;  fulwa;  tibula; bviswa;  ṱuwa;  thathwa; bvulwa;  rulwa; 
remove	 tsiruswa;  fulwa;  tibula;  sudzuluwa;  ṱuwa; bvisa;  thatha; bvulwa;  rulwa; 
removed	 tsiruswa;  sudzuluswa;  fulwa;  tibula; bviswa;  ṱuwa;  thathwa; bvulwa;  rulwa; 
removing	 tsiruswa;  fulwa;  tibula;  sudzuluwa;  ṱuwa; bvisa;  thatha; bvulwa;  rulwa; 
remuneration	madelo;  malamba; muholo; 
renaissance	mbebuluwo; 
renamed	rinahafhu; 
renaming	rinahafhu; 
render	ṋetshedza; dzhia tsheo; luḓea; kunakisa;  fhungudza; pfutelelo; 
rendered	tsheo;  pfutelelo;  luḓea;  fhungudza;  kunakisa; 
rendering	tsheo;  pfutelelo;  luḓea;  fhungudza;  kunakisa; 
renew	 vusulusa; vusuludza; 
renewable	vusuludzwaho; 
renewal	u vusulusa; 
renewed	 vusulusa; vusuludza; 
renovations	 shandula; mvusuludzo;  lugisa; 
renowned	bvumo;  ḓivheaho; 
rent	 -hira; rennde; 
rental	 rennde; hira; 
repair	-lugisa; 
repairs	lugisa; 
repatriation	thivhelwa;  humiswa;  pandela; swakuliswa; 
repeal	fhelisa mafhungo o tendiwaho; 
repealed	fheliswa ha mafhungo o tendiwaho; 
repeals	fhelisa mafhungo o tendiwaho; 
repeat	 -dovholola; dovha; 
replace	 -thivha vhudzulo; bvisa;  tshintsha; 
replaced	 thivha; bvisa;  tshintsha; 
replacement	thivhatshidzulo; 
replies	fhindula; 
reply	fhindula; 
report	muvhigo;  vhiga; 
report-back	vhiga; 
reported	muvhigo;  vhiga; 
reporting	muvhigo;  vhiga; 
reports	 mivhigo; vhiga; 
reposition	 sudzuluwa; pfuluwa; 
repositioning	 sudzuluwa; pfuluwa; 
repository	tshiko;  mbulungelo; 
represent	imela; 
representation	 vhuimeleli; vhuimeli; 
representations	 vhuimeleli; vhuimeli; 
representative	 muimeleli; muimeli; 
representatives	vhaimeleli;  vhaimeli; 
represented	imela; imelalela; 
representing	imela; imelalela; 
represents	imela; imelalela; 
repressive	tshiṱuhu; muimawoga; tsikeledzwa; 
republics	riphabuḽiki; 
request	khumbelo; 
requested	khumbelo; 
requester	muhumbeli; 
requesting	khumbelo; 
requests	khumbelo; 
require	-ṱoḓa; 
required	ṱoḓa; 
requirement	ṱhoḓea; 
requirements	ṱhoḓea; 
requires	ṱoḓa; 
requiring	ṱoḓa; 
requisite	 zwa mutheo;  zwa ndeme; ṱhoḓea; 
rescue	phulusa;  u phulusa; 
research	ṱhoḓisiso; 
researcher	muṱoḓisisi; 
researchers	vhaṱoḓisisi; 
reservation	vhaledza; 
reserve	 -vhulunga; muthivhi; 
reserved	 vhetshelwa thungo; tsho fhumulaho; vhaledzwa; 
reserves	 vhaledza;  muthivhi; vhulunga; 
residence	vhudzulo; 
resident	mudzuli; 
residential	vhudzulo; 
residents	vhadzuli; 
resides	dzula;  fhaṱa; 
residing	dzula;  fhaṱa; 
resignation	tsiruwo; 
resilience	 maanḓa a muya;  vhutepe; muya; 
resolution	tsheo; 
resolutions	tsheo; 
resolve	u tandulula; 
resolved	tandulula; 
resolving	u tandulula; 
resounding	 sa tea;  sa vhudziswi; vhukuma;  ngoho; 
resource	tshiko; 
resources	zwiko; 
respect	 ṱhonifho; khuliso;  u ṱhonifha; 
respected	 ṱhonifho;  ṱhonifha; khuliso; 
respective	 kwameaho; ndivhano; teaho;  fhambanaho; 
respectively	nga ndivhano; 
respects	 ṱhonifho;  ṱhonifha; khuliso; 
respond	fhindula; 
responded	fhindula; 
respondent	mufhinduli;  muvhudziswa; 
respondents	 vhavhudziswa; vhafhinduli; 
responding	fhindula; 
responds	fhindula; 
response	phindulo; 
responses	phindulo; 
responsibilities	vhuḓifhinduleli; 
responsibility	vhuḓifhinduleli; 
responsible	 -vhuḓifhinduleli; vhuḓifhinduleli; 
responsive	fhindula; 
rest	awela; 
restitution	pfumedzano ya nzekano; 
restoration	 vusuludza;  mbuedzedzo;  vhuedzedza; lugisa; 
restorative	 fhodza; lafha; 
restore	vhuedzedza; 
restored	vhuedzedza; 
restoring	vhuedzedza; 
restraint	vhetshelwa mikano; 
restricted	vhetshelwa mikano; 
restriction	mikano;  masakha; 
restrictions	mikano;  masakha; 
restructuring	dzudzanyulula; 
result	 mvelelo; mbuelo; 
resulted	 mvelelo; khovhelo; mbuelo;  nyandiselo;  thekenyelo; 
resulting	 mvelelo; khovhelo; mbuelo;  nyandiselo;  thekenyelo; 
results	 mvelelo; khovhelo; mbuelo;  nyandiselo;  thekenyelo; 
retail	thengo nga zwiṱuku; 
retain	fara;  vhulunga;  lambela; 
retained	 lambela; farwa;  vhulungwa; 
retention	fara;  vhulunga;  lambela; 
retired	pensheni; awela;  notha; 
retirement	 pensheni;  awela;  notha; 
retrieval	dzhiulula; 
return	 huma;  orowa;  humela murahu; vhuya; 
returned	 huma;  orowa;  humela murahu; vhuya; 
returns	mbelo;  huma;  orowa;  humela murahu; vhuya; 
reveal	 dzumbulula; bula;  ambulula; 
revealed	 dzumbululwa;  ambululwa; bulwa; 
revenue	 muthelo wa mbuelo; mbuelo; 
revenues	mbuelo;  mithelo ya mbuelo; 
reverse	 phambano;  huma; fhindula;  humisa; rivese;  rivesa; 
review	 tandula;  ṱolela; sedzulusa;  sengulusa; 
reviewed	 tandulwa; sedzuluswa; ṱolelwa;  senguluswa; 
reviewing	 tandula;  ṱolela; sedzulusa;  sengulusa; 
reviews	 tandula;  ṱolela; sedzulusa;  sengulusa; 
revised	sedzulula; 
revision	ndovhololo; 
revisions	ndovholoso; ndovhololo; 
revitalisation	 vusuludza; mvusuludzo; 
revoke	thutha;  phumula; 
revolution	 mumono; mutengelele wo fhelelaho; 
revolutionary	-mvutshelano;  muvutsheli; 
reward	 malamba; muholo; 
rhino	tshugulu; 
rich	pfuma;  pfumaho;  mupfumi; 
right	pfanelo;  tsha u ḽa;  zwone; 
rightful	 ndinganelo;  fanelaho lwa mulayo; fanelaho; 
rights	pfanelo;  ndugelo; 
rise	-gonyela nṱha; 
rising	 kukumuwa ;  vuwa lufuni;  bva;  takuwa;  vhafuni; vuwa;  fhinduwa;  buba;  gonya; 
risk	khonadzeo ya khombo; 
risks	khonadzeo ya khombo; 
river	mulambo; 
rivers	milambo; 
road	bada;  gondo; 
roads	 magondo; bada; 
robust	ya maanḓa;  yo khwaṱhaho; 
rock	tombo ḽa lubaba; 
rod	lutanda; 
role-players	vhatambi; 
roles	mishumo; 
roll	bele; 
roll-out	 rwelwa ṱari;  ṱano ḽa mathomo; adza; bandedza;  ḓivhadzwa;  vhanyuludza;  phaḓaladza; 
rolled	bele; 
rolling	peta;  dzinginyea ha tshikepe;  kungulusa;  adzulula;  finya;  kunguluwa;  vhumbuluwa;  bidigama; bidiga;  phigulusa;  phiguluwa;  vhumbulusa; 
rollout	 rwelwa ṱari;  ṱano ḽa mathomo; adza; bandedza;  ḓivhadzwa;  vhanyuludza;  phaḓaladza; 
rolls	 kungulusa;  bidiga;  adzulula;  finya;  kunguluwa;  vhumbuluwa;  bidigama;  peta;  phigulusa;  phiguluwa;  rolo;  vhumbulusa; bale; bele; 
room	 kamara; rumu;  lufhera; 
rooms	 kamara;  phera; rumu; 
root	mudzi; 
rooted	 tupulwa; simiwa; 
roots	vhubvo;  midzi; 
rose	gonyela nṱha; 
round	 -mona na;  khungulu; tshipulumbu;  kate;  -mutengelele;  phikhulano; 
rounded	 mutengelele;  khungulu; tshipulumbu;  kate;  mona na;  phikhulano; 
roundtable	nyambedzano;  therisano;  muṱangano;  mufhindulano; 
route	nḓila; 
routes	nḓila; 
routine	maitele;  maitele o ḓoweleaho; 
royal	vhuhosi;  vhukololo; 
royalties	 vhurena;  vhuhosi; mbadelo; 
royalty	 vhurena; vhuhosi; 
rugby	ragabii; 
rule	mulayo;  rula;  ndayo; 
rules	milayo;  mivhuso;  ndayo; 
ruling	tsheo; 
rulings	tsheo; 
run	 gidima;  dodoma; shavha; 
running	-fara; 
runs	 gidima;  dodoma; shavha; 
rural	-mavhalani;  -mahayani; 
sacred	 -khethwa; khethwa; 
sacrifice	tshidzimu; 
sacrifices	tshidzimu; 
sad	bilufhala; 
saddened	ṱungufhadzwa; 
sadness	u ṱungufhala; 
safe	tsireledzo;  sefo;  vhulungea;  -vhulungwaho; 
safeguard	u tsireledza; 
safeguarding	tsireledza; 
safety	tsireledzo; 
said	vho ri; ori; 
salaries	miholo; 
salary	muholo; 
sales	mbambadzo;  thengiso; mutshipiso; sele; 
salute	vusa;  salutha;  resha;  lumelisa;  losha; saluthi; 
same	-fana; 
sample	sambula; 
samples	sambula; 
sampling	u ita sambula; 
sanction	mulayo wa nyiledzo; 
sanctions	mulayo wa nyiledzo; 
sap	maḓi; 
saps	maḓi; 
satellite	satheḽaithi; 
satisfaction	pfusho; 
satisfactory	 pfusho; fushaho; 
satisfied	fushea; 
satisfies	fusha; 
satisfy	-fusha; 
save	 thivha;  sengedza; vhulunga; 
saving	 thivha;  sengedza; vhulunga; 
savings	tshelede yo vhulungwaho; 
saw	saha; 
say	 vhudza; amba; 
saying	luambo;  maipfi;  ḽiambele; 
says	 vhudza; amba; 
scale	 makwanda;  gwanda;  tshikali tsha mapa;  goko; tshikalo; 
scarce	-shaeaho; 
scene	bono; 
scenes	bono; 
schedule	shedulu; 
scheduled	shedulu; sheduḽu; 
schedules	shedulu; sheduḽu; 
scheduling	shedulu; sheduḽu; 
schemes	zwikimu; 
scholar	 muḓivhi; ṅwana wa tshikolo; mugudiswa; 
scholars	vhana vha tshikolo;  vhaḓivhi; vhagudiswa; 
school	 tshikolo tsha phuraimari ya fhasi;  tshikolo tsha phuraimari ya nṱha; tshikolo;  tshikolo tsha sekondari; 
schooling	dzhena tshikolo; 
schools	 zwikolo zwa sekondari;  zwikolo zwa phuraimari ya fhasi; zwikolo;  zwikolo zwa phuraimari ya nṱha; 
science	saintsi; 
sciences	saintsi; 
scientific	-saintsi; 
scope	muangarambo;  tshikoupu; 
score	 fumbili; mvelelo;  -kora;  kora;  tshikoro; 
scorecard	muvhigo; 
scoring	 fumbili; mvelelo;  kora;  tshikoro; 
scourge	 u rwa; mboma;  phamba; 
screen	 u ṱhaṱhuvha; tshikirini; 
screening	nanguludza; hasha;  tsira; 
script	maṅwalwa; 
scrutinise	 ṱoḓisisa;  linga; sedzulusa;  sengulusa;  sedzesa; 
scrutiny	 tsenguluso; ndingo;  tsedzuluso;  ṱhoḓisiso; 
sculpture	 vhuvhaḓaive; vhuvhaḓi; 
sea	lwanzhe; 
seal	sili;  -thivha; 
sealed	 thivha; nambatedzwa; sili; 
search	tandula; ṱoḓa; livhalivha; 
searched	tandula; ṱoḓa; livhalivha; 
season	khalaṅwaha; 
seasonal	nga tshifhinga; 
seasons	khalaṅwaha; 
seat	 tshidulo; musanda; 
seats	 tshidulo; musanda; 
sec	the; 
second	 muthethe; -ima na;  -vhuvhili; 
secondary	tshiṱuku; 
secondly	tsha vhuvhili; 
secret	tshiphiri;  tshibulebule;  tshidzumbe; 
secretariat	vhuṅwaleli; 
secretary	muṅwaleli; 
secretary-general	muṅwaleli muhulu; muṅwaleli dzheneraḽa; 
section	 tshipiḓa; khethekanyo; 
sectional	khethekanyo; 
sections	 zwipiḓa; khethekanyo; 
sector	 sekhithara; khethekanyo; 
sectors	 sekhithara; khethekanyo; 
secure	 -tsireledza; -tsireledzwaho; 
secured	tsireledza;  tsireledzwaho; 
securing	tsireledza;  tsireledzwaho; 
securities	tsireledzo;  vhutsireledzi; 
security	tsireledzo;  vhutsireledzi; 
see	vhona;  lavhelesa;  sedza; 
seeing	 hufha; vhunga; 
seek	 ṱoḓa; livhalivha; 
seeking	 ṱoḓa; livhalivha; 
seeks	 ṱoḓa; livhalivha; 
seem	 zwi vhonala; zwinga; 
seems	 zwi vhonala; zwinga; 
seen	sedzwa;  vhonwa; 
segment	dungo;  tshipiḓa; 
segregation	khethululo; 
seize	 dzhavhula;  thuba;  fara; dzhia; 
seized	dzhiwa;  thubwa;  farwa; dzhavhulwa; 
seizure	tshiririvha; 
select	nanga; khetha; 
selected	 nangwa; khethwa; 
selection	khetho; 
self	vhone vhaṋe; ṋe; ene muṋe; 
self-determination	vhuḓiimiseli; 
self-sufficiency	ḓiimisa nga eṱhe; vhuḓilangi; ḓiimisa; 
selfless	 ḓikumedzela;  sa dzima; kovha;  sa vha na vhutshivha; 
sell	rengisa;  -rengisa; 
selling	rengisa; 
seminar	semina; 
seminars	semina; 
send	rumela;  ruma; 
sending	rumela; 
sends	rumela;  ruma; 
senior	fhira muṅwe nga miṅwaha; muhulwane; 
sense	 tshipfi; zwipfi; 
sensitive	tata; 
sent	rumela;  ruma; 
sentence	 khaṱhulo; fhungo;  tshigwevho;  mutaladzi;  -haṱula; 
sentenced	 haṱula;  khaṱhulo; fhungo;  tshigwevho;  mutaladzi; 
sentences	 haṱula;  khaṱhulo; fhungo;  mutaladzi;  zwigwevho; 
sentencing	 haṱula;  khaṱhulo; fhungo;  tshigwevho;  mutaladzi; 
separate	fhambanyisa;  -fhambanyiswaho;  -fhandekanya;  -fhambanyisa; 
separated	fhambanyisa;  fhandekanya;  fhambanyiswaho; 
separately	 fhambanyisa; fhambanya;  khethekanya; 
separation	 phambanyiso; khethekanyo; 
sequestration	 dzhiwa murahu; fara;  thuba nga maanḓa; 
series	 serisi; tsielano; 
serious	tshi itwaho nga ngelekanyo; 
seriously	 nga u fulufhedza;  nga ngoho; nga ngelekanyo;  nga maanḓa ; 
servants	 vhalanda; vhashumeli; 
serve	 -shuma; rumela; 
served	 rumela; shuma; 
serves	 rumela; shuma; 
service	 sevisi; tshumelo;  mushumo; sevisa;  thabelo; 
serviced	sevisiwa; 
services	 mishumo;  dzithabelo; sevisi; tshumelo; 
serving	 rumela; shuma; 
session	tshipiḓa; 
sessions	zwipiḓa; 
set	 mutavha;  sethe; rea; 
sets	 ḓeka;  mutavha;  sethe; rea; 
setting	 maḓekele; nyimele;  fhethuvhupo; 
settle	dzudza; 
settled	 dzulisea;  haṱulwa; fhedzwa;  lifhiwa; 
settlements	mudzudzo; 
settler	musetelare; 
settlers	museteḽara;  museteḽare; 
seven	sumbe; 
several	-vhalaho; 
severe	 zwo kalulaho; tshi re na maanḓa; 
sew	runga; 
sewing	runga; rungu; 
sex	mbeu;  u lalana; 
sexual	zwa u lalana; 
sexually	zwa vhudzekani; 
shall	ḓo; 
shape	 -ṋea tshivhumbeo; tshivhumbeo; 
shaped	vhumbea; 
shapes	 ṋea tshivhumbeo; zwivhumbeo; 
shaping	shandukisa tshivhumbeo; 
share	mukovhe;  u kovha; 
shared	mukovhe; shumisa roṱhe;  kovha; 
shareholder	mufaramukovhe; 
shareholders	mufaramukovhe; 
shareholding	vhufaramikovhe; 
shares	shumisa roṱhe;  kovha; mikovhe; 
sharing	mukovhe; shumisa roṱhe;  kovha; 
shark	shaka; 
sharks	shaka; 
sharp	 shaphu; fhiraho; 
she	wa, a;  tsha tsadzi; 
shed	-ḓuvhudza; 
shedding	ḓuvhudza; swotola; 
sheet	ṱari;  lagane; 
sheets	maṱari;  malagane; 
shelter	vhukhudo;  tshitsireledzi; 
sheriff	musherifu; mukoma; 
sheriffs	vhakoma; vhaḓinḓa vha khothe; 
shifted	diso; 
shifting	diso; 
shifts	madiso; 
ship	tshikepe;  ngalavha; 
shipping	rumela;  endedza;  phaḓaladza;  nḓisedzo; 
ships	zwikepe;  ngalavha; 
shock	dzhenuwo; 
shocked	dzhenuwo; 
shocks	dzhenuwo; 
shop	vhengele; 
shopping	u renga; 
shops	mavhengele;  mashopho; 
shore	khunzikhunzini;  vhugabelelo; 
shores	khunzikhunzini;  vhugabelelo; 
short	pfufhi; 
short-term	tshifhinga tshipfufhi; 
shortage	ṱhahelelo; 
shortages	ṱhahelelo; 
shorter	pfufhi; 
shortly	hu si kale; 
should	tea;  fanela; 
shoulders	shaḓa; 
show	-sumbedza; 
showcase	ṱano; 
showcasing	sumbedza;  ṱana; 
showed	sumbedza; 
showing	 vhonala;  ṱana;  sumbedza;  sumba; 
shown	sumbedza; 
shows	sumbedza; 
side	 thungo ya sila;  -thungo; sia;  bama; 
sign	 tsumbadwadze; tshiga;  -saina; 
signal	ngafhadzo;  -gafhadza; 
signals	 siginaḽa;  gafhadza; afhadza; ngafhadzo; 
signature	tsaino; 
signed	 tshiga;  tsumbadwadze; saina; 
significance	zwa ndeme; 
significant	ndeme; 
significantly	zwa ndeme; 
signifies	ḓivhisa; tsumbedzo; 
signing	 tshiga;  tsumbadwadze; saina; 
signs	 saina;  tsumbadwadze; zwiga; 
similar	fanaho;  -elana; 
similarly	fana; 
simple	 -leluwaho; zwayo; 
simply	 fhedza; fhedzi;  sokou; 
simultaneously	khathihi;  mazha; 
since	 u bva;  hufha; tshi tsheetsho;  u ṱuwa; vhunga; 
sincere	 tshavhuḓi; tshivhuya; 
sincerely	 nga mbilu yoṱhe; nga ngoho; 
sing	imba; 
singer	muimbi; 
singing	 imba; 
sister	mukomana;  murathu wa musidzana;  khaladzi wa musidzana; 
sisters	 khaladzi dza vhasidzana;  vharathu vha vhasidzana; vhakomana; 
sit	dzula;  tandavhala; 
site	fhethu; 
sites	fhethu; 
sitting	dzulo; 
sittings	dzulo; 
situated	tsho dzulaho; 
situation	vhuimo;  nyimele; 
situations	vhuimo;  nyimele; 
six	ṱhanu na nthihi; 
sixth	tsha rathi;  tsharathi; 
size	vhuhulu;  muelo; 
skill	vhukoni;  vhutsila;  nḓivho; 
skilled	 vha na vhukoni;  vha na vhutsila; 
skills	 zwikili; vhukoni;  vhutsila; 
slave	phuli; 
slavery	vhupuli; 
slaves	phuli; 
slightly	 zwiṱukuṱuku; zwiṱuku; 
slip	 u suvha; tshitumulwa; 
slow	u dedengela;  ongolowa; 
small	ṱhukhu; 
small-scale	zwiṱuku; 
smaller	ṱhukhu; 
so	zwino; 
so-called	vha nopfi; zwi vhidzwa; 
soccer	futhibola; 
social	matshilisano; 
socially	zwa matshilisano; 
societal	 kovhana;  tshigwaga;  zwa vhoṱhe;  vhoṱhe; tshitshavha; matshilisano; 
societies	 zwitshavha;  vhapo; madzangano; 
society	tshitshavha;  vhapo;  dzangano; 
socio-economic	matshilisano a ikonomo; 
socioeconomic	matshilisano a ikonomo; 
soil	mavu; 
solar	ḓuvha; 
sold	rengisa; 
soldiers	maswole; 
sole	tshirethe; 
solely	 fhedza; zwenezwo fhedzi; 
solid	-tshiomate;  -tsho omaho;  tshiomate; 
solution	 tshiluḓi; thandululo; 
solutions	 muṋwelo;  tshiluḓi; thandululo; thasululo;  munwelo; 
some	zwiṅwe;  muṅwe;  dziṅwe; 
someone	muṅwe muthu; 
something	tshiṅwe tshithu; 
sometimes	 tshiṅwe tshifhinga; tshikhathi;  ḽiṅwe ḓuvha; 
somewhat	 nyana;  tshi sa solise; khwine;  tsha vhuḓ; 
son	murwa; 
song	luimbo; 
songs	nyimbo; 
soon	zwenezwino;  nga tshihaḓu;  nga u ṱavhanya; 
sophisticated	serekanaho; tserekano;  maimo a nṱha; 
sort	-nanguludza;  -dzudzanya; 
sought	 ṱoḓa;  ṱhoḓea; ṱoḓea; 
soul	muthu;  muya;  mbilu ya maanḓa; 
souls	muthu;  mimuya; 
sound	mubvumo; 
sounds	mibvumo; 
source	tshiko;  tshisima; 
sources	 zwisima; zwiko; 
sourcing	tshiko;  tshisima; 
south	tshipembe; 
southern	tshipembe; 
sovereign	 khosikhulu; vhuḓivhusi; 
space	tshikhala; 
spaces	zwikhala; 
spatial	 mutalambavhi; vhunṱha; mutalobuḓo; 
speak	amba; 
speaker	 mulangadzulo; muambi;  tshipikara; 
speakers	 vhalangadzulo; zwipikara; vhaambi; 
speaking	amba; 
speaks	amba; 
spear	pfumo; 
special	 i si ya misi; khetheaho; 
specialisation	vhugudeli; 
specialised	vhugudeleli; 
specially	khetheaho; 
species	lushaka; 
specific	-tiwaho; 
specifically	tiwaho; 
specification	vhusumbedzi; 
specifications	vhusumbedzi; 
specified	vhalela; 
specify	-vhalela; 
specimen	tsumbo; 
specimens	zwisumbedzwa; tsumbo; 
spectacular	mutambo wa maimo; 
spectrum	tshakatshaka; 
speech	 muambo; tshipitshi; 
speeches	 zwipitshi; muambo; 
speed	luvhilo; 
speedy	nga tshihaḓu;  nga u ṱavhanyedza;  nga luvhilo; 
spend	 fhedza; shumisa; 
spending	 fhedza; shumisa; 
spent	fhedza;  ṱwa;  shumisa tshelede; 
sphere	khungulu; 
spheres	khungulu; 
spirit	muya; 
spiritual	 -muya; muya; 
split	-fhandekanya; 
spoken	amba; 
spokesperson	muambeli; 
sponsored	lambedzwa; 
sport	mutambo; 
sporting	zwa mitambo; 
sports	mutambo; 
spotlight	lumba; ndumbo fokusi;  kunga maṱo; sedzwaho; 
spouse	mufarisi;  mufunwa; 
spouses	vhafarisi;  vhafunwa; 
spread	 -endela;  -phaḓalala; phaḓaladza; 
square	tshikwea; 
stability	vhudziki; 
stable	tshi sa shandukiho; tsho khwaṱhaho;  tshitale; 
stadium	tshitediamu; 
stadiums	zwitediamu; 
staff	vhashumi; 
stage	 tshiteidzhi;  tshitediamu;  vhugalatenga; ḽiga; 
stages	zwiteidzhi; 
staging	khethekanyo ya tshiimo tsha vhulwadze; 
stakeholder	mushelamulenzhe; 
stakeholders	vhadzhiamikovhe; vhashelamulenzhe; 
stalwarts	gala; 
stamp	tshiṱemmbe; 
stance	vhuimo; 
standard	 tshilinganyo; murole; 
standardised	linganywaho; 
standardization	 linganyisa;  linganya; 
standards	 mirole; zwilinganyo; 
standing	tshitiki; 
stands	tshitiki; 
stanza	 vese; ndima; 
stars	ṋaledzi; 
start	thoma; 
started	thoma; 
starting	thoma; 
starts	thoma; 
state	muvhuso;  nyimele;  shango; 
state-owned	zwi langwaho nga muvhuso; 
stated	muvhuso;  nyimele;  shango; 
statement	fhungo; 
states	 nyimele; mashango;  mivhuso; 
stating	muvhuso;  nyimele;  shango; 
stationery	vhuṅwali; 
stations	zwiṱitshi; 
statistical	zwa dzimbalombalo;  zwa zwitatistika; 
statistician-general	radzimbalombalo muhulu; 
statistics	tshitatistiki; 
stature	mulayo; 
status	maimo; 
statute	mulayo; 
statutes	mulayo; 
statutory	zwa mulayo; 
stay	 imisa; dzedza;  ima; dzula;  tshesa; 
steadily	 nga zwiṱuku nga zwiṱuku; tshi sa shandukiho; tsho khwaṱhaho; 
steady	tsho khwaṱhaho; 
steal	tswa; 
steel	tsimbi; 
steer	tshimbidza; 
steering	tshimbidza; 
step	tshiṱepe; 
steps	maga; 
sterling	 ya vhukuma; ya ngoho; 
still	 fhumudza;  dzikisa;  kha ḓi;  tsho fhumulaho; tshee; 
stimulate	karusa; 
stimulating	karusa; 
stipulate	pfana; 
stipulated	pfana; 
stock	mukovhe;  zwifuwo;  thakha; 
stolen	tswa; 
stone	thambo;  -bvisa thambo; 
stood	tshitiki; 
stop	 imisa;  ima;  guma; tsha;  litsha; 
storage	u vhulunga; 
store	 -vhulunga; vhulunga;  mbulungelo; 
stored	vhulunga;  mbulungelo; 
stories	 nganetshelo zwiṱori; nganea; 
storm	ḓumbu; 
story	tshiṱori; 
storyteller	muanetsheli; 
storytellers	vhaanetsheli; 
storytelling	u anetshela nganea; 
strategic	tshiṱirathedziki; 
strategies	zwiṱirathedzi; 
stream	ludambwana; 
streams	milambo; zwiṱirimu; 
street	tshiṱaraṱa; 
streets	zwiṱarata; zwiṱaraṱa; 
strength	u dzia; 
strengthen	 khwaṱha;  dzwiḓela; khwaṱhisa; 
strengthened	khwaṱhiswa; 
stress	mutsiko; 
strict	vhutevheleli; tshiyaho nga mulayo;  tsha vhutevheleli; 
strides	 vhukando; vhulapfu; 
strike	tshiṱereke; 
string	muḓali; 
strip	fadugu ya vhubuli;  lumveru; 
strips	fadugu ya vhubuli;  lumveru; kwatula; 
strive	lingedza; 
striving	lingedza; 
strong	khwaṱha;  tshi re na maanḓa; 
stronger	 tshi re na maanḓa; khwaṱhaho; 
strongly	nga maanḓa khwaṱhisa; 
struck	tshiṱereke; 
structural	 mbumbo;  tshiimiswa;  tshifhaṱo; tshivhumbeo; 
structure	 tshifhaṱo; tshivhumbeo; 
structured	 tshifhaṱo; tshivhumbeo; 
structures	zwivhumbeo;  zwifhaṱo; 
struggle	muombano;  kakarika; 
struggles	muombano;  kakarika; 
struggling	muombano;  kakarika; 
student	mutshudeni; 
students	matshudeni; 
studies	vhuḓigudisi; 
studio	tshitudio; 
studios	zwiṱudio; 
style	tshitaila; 
sub	ṱhukhu; 
sub-item	tshiteṅwa tshiṱuku; 
sub-programme	mbekanyamushumo ṱhukhu;  phurogireme ṱhukhu; 
sub-regulation	ndaulo ṱhukhu; 
subject	 -luvhisa; muluvha; 
subjected	ṱhoho;  muluvha;  luvhisa; 
subjects	ṱhoho;  muluvha; luvhisa; 
submission	vhupfiwa; 
submissions	vhupfiwa; 
submit	 u ḓi ṱukufhadza; swikisa;  vheya nga ḓasi; 
submitting	 ḓiṋetshedza;  swikisa;  ḓinyadza; 
subparagraph	phara ṱhukhu; 
subpoena	dagafala; nḓivhadzamulandu; 
subpoenaed	 vhidzwa;  ḓivhadzwa mulandu; 
subscribe	 ṅwalisa;  ridzhisiṱara; vhuṱanzi;  vhea dzina; 
subscribed	ṅwaliswaho; ridzhisiṱarwa; 
subsections	khethekanyoṱhukhu; 
subsequent	-tevhelaho; 
subsequently	 zwi tevhelaho; nga mulandu wa zwenezwo; 
subsidiary	khamphanindaulwa;  zwi si zwa ndeme;  khamphaninyunḓwa; davhi ḽa khamphani;  tshumelothikhedzi; 
subsidies	mutikedzelo;  sabusidi; 
subsidy	mutikedzelo;  sabusidi; 
subsistence	tshi nga tshidzaho muthu; 
substance	tshithu; 
substances	zwithu; thukhita; 
substantial	tsha vhukuma; 
substantially	tsha vhukuma; 
substantive	dzina; 
substitute	-imela; 
substituted	imela; muanguli; 
substitutes	imela; muanguli; 
substituting	imela; muanguli; 
succeed	-tevhela; 
succeeded	tevhela; 
success	mvelelo; 
successes	mvelelo; 
successful	-wanaho; 
successfully	bvelelaho;  konaho;  wanaho; 
succession	 dziṱhoho;  thevhekano; ifa; 
successor	mutevheli; 
such	raloho;  zwo tou ita hani;  raliho; 
suffer	 ṱugufhala; ṱhuphea;  u pfa vhuṱungu; tambula; 
suffered	 pfa vhuṱungu; ṱhuphea;  ṱungufhala; tambula; 
suffering	tambula; 
sufficiently	 eḓanaho;  lugaho; linganaho; 
sugar	swigiri; 
suggest	humbudza; 
suggested	humbudza; 
suggestion	mahumbulwa; 
suggestions	mahumbulwa; 
suggests	humbudza; 
suitable	tewa;  fanelwa; 
suitably	 tewa;  fanelwa; 
summary	 samari; manweledzo; 
summer	tshilimo; 
summit	guvhangano; 
summits	guvhangano; 
summoned	 rambiwa; vhidzwa; 
sun	ḓuvha; 
sung	vho imba;  o imba; 
superior	-re muhulwane; 
supervisees	 lavhelesa; langa; 
supervision	ndavheleso; 
supervisory	vhulavhelesi;  vhulangi; 
supplement	tshiswikisedzi; 
supplied	ṋetshedza;  zwiḓisedzwa; tshitoko;  ṋetshedzo; 
supplier	muḓisedzi; 
suppliers	vhaḓisedzi; 
supply	 -ṋetshedza; ṋetshedzo; 
support	 thikho;  unḓa;  -tika; tikedza;  thikhedzo; 
supported	 ṱhogomelo;  tika;  thikho;  unḓa; tikedza;  thikhedzo; 
supporting	 ṱhogomelo;  tika;  thikho;  unḓa; tikedza;  thikhedzo; 
supportive	 tika; tikedza; 
supports	 ṱhogomelo;  tika;  thikho;  unḓa; tikedza;  thikhedzo; 
supposed	 linganya; 
supreme	tsho hulaho u fhirisa; 
sure	vha na ngoho; 
surely	ngoho; 
surface	vhunnḓa; 
surplus	mufhalala; 
surrounding	vhupo; 
surveillance	 sala murahu; lavhelesa; 
survey	ṱhoḓuluso; 
surveyor	 musaveyi; tsedzuluso; 
surveyors	 musaveyi; tsedzuluso; 
surveys	ṱhoḓuluso; 
survival	 u ponya; tshila; 
survive	hanya;  u tshila; 
surviving	tshila;  hanya; 
suspect	 vhilahela; humbulela; 
suspected	humbulelwa; vhilahelwa; 
suspects	 vhahumbulelwa;  vhilahela; muvhilahelwa; humbulela; 
suspend	 imisa; imiswa;  fhahea; 
suspended	 imisa; imiswa;  fhahea; 
suspension	 phaphamalo;  muvanganyo;  tshinembeledzi; nyimiso; 
suspensions	 zwinembeledzi;  phaphamalo;  nyongolodzo; mivanganyo; nyimiso; 
sustain	bveledza; 
sustained	bveledza; 
sustaining	bveledza; 
swear	ana; 
swearing	ana; 
switch	switshi;  -switsha; 
sworn	aniswa;  seṅwa; 
symbol	tshiga; 
symbolic	 tshiga; tshifanyiso; 
symbolically	sumbedza;  fanyisa;  ita tshiga; 
symbolises	sumbedza;  fanyisa;  ita tshiga; 
symbolism	 tshiga; tshifanyiso; 
symbols	zwiga; 
symposium	muṱangano;  khuvhangano; simphoziamu; 
symptom	tsumbadwadze; 
symptoms	tsumbadzwadze; tsumbadwadze; 
systematic	nga sisiṱeme; nga u tevhekana; 
systemic	 fhelelaho; zwoṱhezwoṱhe; angaredza; 
systems	sisiṱeme; 
table	ṱafula;  thebulu; 
tabled	ṱafula;  thebulu; tafula; 
tables	ṱafula;  thebulu; 
tabling	u swikisa ṱafulani; 
tabs	thikhithi; zwiṱikara; dziḽebuḽu; 
tackle	thakhulo;  u lwela; 
tags	garaṱa dza mutengo; 
take	 fara;  fhahulula;  bvula;  isa;  takula; dzhia; 
taken	dzhiiwa; 
takeover	u dzhiiwa;  u milwa; 
takes	 fara;  fhahulula;  bvula;  isa;  takula; dzhia; 
taking	 fara;  fhahulula;  bvula;  isa;  takula; dzhia; 
tale	lungano; 
talent	taḽente; 
talented	vhukoni; 
talents	taḽente; 
tales	ngano; 
talk	 fhindulana;  tshipitshi; amba; 
talking	amba; 
talks	nyambedzano;  mifhindulano; 
tangible	tshi kwameaho; 
tap	 thephe; khokhonyanyana; 
tape	lubannda; 
target	tshipikwa; 
targeted	tshipikwa; 
targeting	tshipikwa; 
targets	zwipikwa; 
tariff	mbadelo;  mbadelotiwa; 
tariffs	mbadelo;  mbadelotiwa; 
task	mushumo; 
tasked	mushumo; 
tasks	mishumo; 
taught	gudisa; 
tax	muthelo; 
taxation	muthelo; 
taxed	muthelo; 
taxes	muthelo; 
taxi	thekhisi; 
taxpayer	mutheli; 
taxpayers	mutheli; 
teach	gudisa; 
teacher	thitshara; 
teachers	mudededzi; 
teaching	vhugudisi; 
team	thimu; 
teams	thimu; 
teaser	khanganyiso;  tswenya;  dina; 
technical	zwa thekiniki; 
technicians	rathekhiniki; 
techniques	thekhiniki; 
technologies	thekhinoḽodzhi; 
telecommunication	vhudavhidzani ha kule; 
telecommunications	vhudavhidzanikule; 
telephone	luṱingo; 
television	theḽevishini; 
tell	 vhudza;  bvumba; amba; 
telling	 vhudza;  bvumba; amba; 
tells	 vhudza;  bvumba; amba; 
temporarily	zwa tshifhinganyana; 
ten	fumi; 
tend	 lavhelesa;  linda; 
tendered	thenda; 
tenders	thenda; 
tension	mazhuluzhulu;  vhuakhi; 
tenure	thendelano ya vhuhiri;  thendelano ya vhusendelelwa; 
term	 themo; kotara; 
terminate	fhelisa; 
terminated	fhelisa; 
termination	 guma; fhedza;  phetha; 
terms	milayo; 
terrestrial	zwa shangoni; 
territorial	zwa ḓisi;  zwa ḽifhasi;  zwa muvhuso;  zwa shango; 
territories	ḓisi; disi; 
territory	ḓisi; 
terrorism	vhutherorisi; 
terrorist	ḽitherorisi; 
tertiary	theshiari; 
test	ndingo;  -linga;  u linga; 
tested	 linga; ndingo; 
testing	 linga; ndingo; 
tests	 linga; ndingo; 
text	zwi re ngomu; 
than	hu nauri;  u fhira; 
thank	livhuha; 
thanks	ndivhuho; ndi a livhuha; 
that	hetsho; uyo;  uri;  huvhani;  heyo; 
that's	hetsho; heyo;  uyo; 
theater	thyetha; vhuareloni; 
theatre	vhuareloni; 
theatres	thyetha; vhuareloni; 
theft	vhuvhava; 
their	 ya vhone; zwa vhone; 
them	 zwone; vhone; 
theme	thero; 
themes	thero; 
themselves	 vhone vhaṋe; vhone vhukumakuma; zwone zwiṋe; 
then	ya vha;  ha vha;  zwo ralo;  nga tshi; 
theory	khumbulo i sina mushumo; 
therapy	dzilafho; 
there	afho;  henefho;  fhaḽa;  hangei; 
thereafter	nga murahu ha zwenezwo; 
thereby	nga hezwo; 
therefore	ngauralo; 
therein	nga ngomu; 
thereof	nga zwenezwo; 
thereon	henefho; 
thereto	 ṱutshela; 
thereupon	nga nṱhani ha hezwo; 
therewith	nga izwo; 
these	izwi;  havha; hezwi; 
they	 vho; vha;  zwi; 
thing	tshithu; 
things	zwithu; 
think	humbula; 
thinking	 elekanya; humbula; 
third	 tsha raru; tshararu; 
thirdly	tsha vhuraru; 
thirds	 tsha raru; tshararu; 
thirty	furaru; 
this	ene;  kwone;  tshone; 
thorough	vhudodombedzi; 
those	 idzo;  hezwo;  izwo; havho; 
though	fhedzi;  naho zwo ralo; 
thought	humbula; 
thoughts	mihumbulo;  ngelekanyo ṱhalukanyo; 
thousand	tshigidi;  tshigidi tshithihi; 
thousands	zwigidi; 
threat	vhushushedzi; 
threaten	-shushedza; 
threatened	shushedza; 
threats	vhushushedzi; 
three	raru; 
three-day	zwa maḓuvha mararu; 
three-year	zwa miṅwaha miraru; 
threshold	tshivhalo tsha fhasisa; 
thriving	 bvela phanḓa;  aluwa; bvelela;  tenda;  hula; 
throughout	u swikela; 
thus	 izwo;  ngaurali; ngauralo; 
ticket	thikhithi; 
ticketing	thikhithi; 
tickets	thikhithi; 
tie	lingana;  khokhovhi; 
tiers	mbemba;  zwipiḓa; 
ties	lingana;  khokhovhi; 
till	thiḽi; isa kha;  lima;  swikela; 
time	tshifhinga;  mutevhetsindo; 
timeframes	zwifhinga zwo vhewaho; 
timely	nga tshifhinga; 
times	andisa; 
tirelessly	sa dina;  sa neta; 
title	ṱhoho;  dzina; 
titled	vhidzwa; 
titles	ṱhoho;  dzina; 
to	u ya kha; 
tobacco	fola; 
together	nga huzwo; vhoṱhe;  zwoṱhe;  oṱhe;  yoṱhe; 
toilet	bunga; 
toilets	mabunga; 
told	vhudzwa; 
tolerance	konḓelela; 
tomorrow	matshelo; 
ton	thani; 
tonight	 vhusiku vhuno; vhusiku ha ṋamusi; 
tonnage	vhuthani; 
tons	thani; 
too	hafhu;  mukhwa muṅwe; 
took	 fara;  fhahulula;  bvula;  isa; dzhia; 
tool	tshishumiswa; 
toolkit	khithi ya zwishumiswa; 
tools	zwishumiswa; 
top	nṱha; 
topic	thophikhi; 
topics	thero; 
total	ṱhanganyelo; 
totalled	thanganyelo; ṱhanganyelo; 
touch	u kwama; 
tough	lemela;  konḓa; tshi sa khotheiho; 
tour	vhuendelamashango; 
touring	vhuendelamashango;  madalo; 
tourism	vhuendelamashango; 
tourist	muendelamashango; 
tourists	vhaendelamashango; 
tournament	thonamennde; muṱaṱisano; 
tournaments	thonamennde; miṱaṱisano; 
tours	vhuendelamashango; 
toward	nga thungo ya; 
towards	nga thungo ya; 
town	ḓorobo; 
towns	ḓorobo; 
township	ḽokhesheni; 
townships	ḽokhesheni; 
toy	tshitambiswa; 
trace	wana;  ṱoḓa;  oledzela;  -tevhedzela; 
track	tshiporo;  nḓila; 
trade	mbambadzo; 
trading	u rengisa; 
tradition	maitele; 
traditional	-zwa sialala;  -maitele; 
traditionally	maitele;  zwa sialala; 
traditions	maitele; 
traffic	vhuendi; 
trafficking	vhuendi; Thirafiki; 
tragedy	ḽikhaulambilu; 
tragic	vhuṱungu;  tshiṱuhu;  ḽikhathulambilu; ḽisinḓambilu; 
train	gudisa;  tshidimela; 
trained	 gudiswa; gudisa; 
training	pfumbudzo; 
trajectory	mukwila; vhuṱala;  luḓila;  nḓila; 
transaction	murengelano; 
transactions	murengelano; 
transfer	 tsudzuluso; sudzulusa;  u pfulusa; 
transferred	 tsudzuluso; sudzulusa; muainedzo;  u pfulusa; 
transferring	 tsudzuluso; sudzulusa; muainedzo;  u pfulusa; 
transfers	 tsudzuluso; sudzulusa; muainedzo;  u pfulusa; 
transform	shandula; 
transformation	tshanduko;  shandukisa; 
transformed	shandulwa; 
transforming	 shandula; 
transition	u pfukela; 
transitional	tshifhinganyana; vhukati;  tshifhinga tsha uri; 
translate	 ḓologa;  shandulela; ṱalutshedza;  pindulela; 
translated	 pindulelwa; ḓologwa; ṱalutshedzwa;  shandulelwa; 
translation	tshandulelo; 
translators	vhafhinduleli; 
transmission	vhurathisi;  phiriso ya tshitzhili;  phirisafulufulu; 
transmit	 u fhirisa;  rathisa; -phirisa; 
transmitted	 rathisa;  phirisa; fhirisa; 
transparency	u vha khagala; 
transparent	vhonadzaho;  tshivhonadzi; 
transport	vhuendedzi; 
transportation	vhuendedzi; 
travel	enda; 
travelled	tshimbila;  enda; 
travelling	vhutshimbili; 
treasure	lupfumo; 
treasures	lupfumo; 
treasuries	vhufaragwama; 
treasury	vhufaragwama; 
treat	u ilafha; 
treated	ilafha; 
treaties	Thendelano; 
treatment	 dzilafho.; dzilafho; 
treaty	Thendelano; 
tree	muri; 
trees	miri; 
trend	 mvelaphanḓa; zwiambaro; 
trends	 mvelaphanḓa; zwiambaro; 
trial	tsengo; 
trials	tsengo; 
tribunal	khothe; 
tribunals	khothe; 
tribute	 mpho;  nduvho; muthelo; 
tried	 lingwa;  lingedzwa;  sengiswa;  edziswa; ṱolwa; 
triumph	 ḓi renda;  kunda; 
trophy	khaphu; 
troupe	tshigwada tsha vhamvumvusi; 
truly	 ngohongoho; ngangoho; ngoho; 
trust	fulufhela; 
trustee	muthu o fhulufhelwaho; 
trustees	vhathu vho fhulufhelwaho; 
trusts	fulufhela; 
truth	ngoho; 
try	 linga;  ṱola;  sengisa; lingedza; tshikoro tsha ragabi;  edzisa; 
trying	lemela;  netisa;  kula nungo; 
turfs	gwada ḽi re na hatsi;  luvhanḓe lwa mbambe ya dzibere; 
turn	mona;  huma;  khona; dzhiga;  furalela;  somba;  shanda;  u shandula;  rembuluwa;  u phigulusa; 
turnaround	rembuluwa;  shandukela; tshikhala tsha u dzhiga;  tshifhinga tsha u fhedza;  tshikhala tsha u khona; 
turned	mona;  huma;  khona;  rembuluswa;  phiguluswa; dzhiga;  furalela;  shanda;  rembuluwa; sombololwa; 
turning	mupeto; 
turnover	mbuelo; mbueloguṱe;  kuṱutshele kwa vhashumi; 
twelve	fumi mbili; 
twentieth	vhufumbili; 
twenty	fumbili; 
twice	luvhili; 
two	mbili; 
two-day	zwa maḓuvha mavhili; 
two-thirds	tshararu; 
type	lushaka;  khanḓiso;  u thaipha; 
types	tshaka; 
typically	 kanzhi; lushaka; 
ultimate	zwa u fhedzisela; 
ultimately	magumoni;  mafhedziseloni; 
unable	 balelwa; kundelwa; 
unacceptable	zwi sa ṱanganedzei; 
unanimous	thendelano ya vhoṱhe; 
unauthorised	zwi songo tendelwaho; 
uncertainty	zwi songo khwaṱhaho;  tshi sa ḓivhi; 
unconstitutional	-lwaho na ndayotewa; 
under	fhasi ha; 
underdevelopment	songo bvelelaho tshoṱhe; 
undergo	 pfa vhuṱungu;  lemelwa; 
underlying	zwiṱuṱuwedzi;  zwa mutheo;  zwa ndeme; 
undermine	nyadza; 
underpin	tika; 
understand	pfesesa; 
understanding	 pfesesa;  vha na nzhele; thendelano; 
understood	pfesesa; 
undertake	 dzhia mushumo;  fhulufhedzisa;  thoma mushumo; 
undertaken	 dzhia mushumo;  thoma mushumo; 
undertaking	bindu;  fhulufhedzisa; ndangulo ya motshara; 
undertook	 dzhia mushumo;  fhulufhedzisa;  thoma mushumo; 
underwater	ngomu maḓini; 
underway	 zwine zwa khou ya u bvelela; zwi re nḓilani; 
undue	 nnḓa ha mulayo; tshi songo lugaho; 
unemployed	-sa shuma; 
unfair	 zwi songo lugaho;  zwi songo fanelaho; tsha khombo; 
unfortunately	mashudu mavhi; 
unhappy	 ṱungufhala; vhusiwana; 
unified	vhofhekanya; 
uniform	fanaho;  yunifomo; 
unify	vhofhekanya; 
union	mbumbano;  yunioni; 
unions	mbumbano;  yunioni; 
unique	khetheaho; 
unit	yunithi; 
unitary	vhuoga; 
unite	 -ṱangana;  ṱanganya; ṱangana; 
united	vhumbana; 
units	vhuthihi; 
unity	thendelano;  ṱhanganyo;  vhuthihi;  vhuoga;  mbofhano; 
universal	faraho zwoṱhe; 
universe	ḽinnḓa; 
universities	yunivesithi; 
university	yunivesithi; 
unknown	zwi sa ḓivhei; 
unlawful	 zwi siho mulayoni; nnḓa ha mulayo; 
unleash	 bvisa;  vhofholola; tendela; 
unless	nga nnda-; 
unlike	zwi sa faniho; 
unlikely	a zwi anzeli; 
unnecessary	zwi si zwa ndeme; 
unprecedented	zwi sa athu vhonwa; 
unqualified	si na ndalukano; 
unreasonable	sa humbulela; 
unregistered	u ridzhisiṱalula; 
unsafe	tshi re na phanzi/khombo;  sa tsireledzea; 
unsubscribe	 sainulula; 
until	 swikela; 
untold	zwi sa ambei;  zwi songo ambiwaho; 
unusual	 zwi si zwa misi;  zwi songo ḓoweleaho; zwi mangadzaho; 
unveil	 pengula; dzumbulula;  tibula; 
unveiled	 tibulwa; dzumbululwa;  pengulwa; 
unveiling	 pengula;  dzumbulula;  tibula; 
up	nṱha; 
upcoming	zwine zwa khou ḓa;  zwa kha ḓi ya u bvelela; 
update	maswamaswa; khwinisa; 
updated	khwiniswaho; ḓivhadzwa maswamaswa; 
updates	maswamaswa; khwinisa; 
upgrade	khwinisa; 
upgraded	khwinisa; 
upgrades	khwinisa; 
upgrading	khwinisa; 
uphold	 tikedzela;  khwaṱhisa; 
uploading	 ḽaisa; 
upon	 ṱaḓulu ha; kha;  nṱhani ha; 
urban	 ḓoroboni; -ḓorobo; 
urge	u fhisea; 
urged	fhisea; 
urgency	 luvhilo;  tshihaḓu; ṱavhanya; 
urgent	shishi; 
urgently	nga u ṱavhanya;  nga tshihaḓu; 
urges	fhisea; 
us	riṋe; 
usage	 mashumisele;  ḓowela; mashumele; 
use	 mashumisele a tshigero; shumisa; 
used	shumiswa;  ḓowela; 
useful	 tshi re thuso; vha na mushumo; 
user	mushumisi; 
users	vhashumisi; 
uses	 mashumisele a tshigero; shumisa; 
using	Shumisa;  mashumisele a tshigero; shumisa; 
usually	kanzhi; 
utilisation	 shumiswa; 
utilise	shumisa;  u shuma nga; 
utilised	shumiswa; 
v	V; 
vacancies	zwikhala; 
vacancy	tshikhala; 
vacant	u vulea; 
valid	kwazwo; 
validity	khwaṱhisedzo; 
valley	govha; 
valuable	-tsha mutengo; 
valuation	u ṱoḓisisa;  u anganya;  u sedza ndeme;  u vheya mutengo wa tshithu; 
value	ndeme; 
valued	ndeme; 
values	mikhwa ya vhuḓifari; 
van	veni; 
variation	phambano;  zwo fhambanaho; 
varied	 shandukiswaho;  ṱanganyiswaho;  ṱangananaho; fhambananaho; sa faniho; 
varies	fhambana; 
variety	tshakha;  fhambananaho;  tshakatshaka; 
various	 tshakatshaka; fhambanaho; sa faniho; 
vary	fhambana; shanduwa; 
varying	 shanduwaho; fhambanaho; sa faniho; 
vat	vethe; 
vehicle	 tshiendisi; tshiendedzi; 
vehicles	zwiendisi;  zwiendedzi; 
venture	thoma; 
ventures	thoma; 
venue	mudavhi; 
venues	midavhi; 
verification	khwaṱhisedzo; 
verify	khwaṱhisedza; 
version	lushaka;  iṅwe nḓila;  tshivhumbeo; 
very	 zwihulu;  nga maanḓa; vhukuma; 
vessel	 mudzio;  lueledzi;  lutsinga; tshikepe; 
vested	u ṋewa pfanelo ya mulayo;  hweswa maanḓa; 
veterans	 muthu o shumaho kale;  ḽiswole ḽo shumaho kale; mazhakanḓila; 
via	nga;  fhira nga; 
viability	khonadzeo; 
viable	bvelela;  konadzea; 
vibrant	 nzhenzhema; takala; 
vice	tshimanyi;  vaisi; 
vice-chairperson	mufarisa;  muthusa; tshanḓa tsha mudzulatshidulo; 
victim	mupondwa; 
victims	vhapondwa; 
victor	mukundi;  o kundaho; 
victory	gundo; 
video	 u dzhia vidio; vidio; 
videos	 dzhia vidio; vidio; 
view	mbonalo; 
viewed	mbonalo; 
viewing	mbonalo; 
views	mihumbulo; 
village	muḓi; 
villages	mivhundu;  miḓi; 
violation	u pfuka ndaela;  vhupfukamulayo; 
violations	pfuka ndaela;  vhupfukamulayo; 
violence	nndwa;  khakhathi; 
violent	maanḓa; 
virtual	tshiedziswa tsha kholekhole; 
virtually	lugaho;  vhugala; 
virtue	vhuthu;  luga; 
visible	vhonalaho; 
vision	bono; 
visionary	 muporofita; bono; 
visit	dalela; 
visited	dalela; 
visiting	 dalela;  ṱola; 
visitor	mueni; 
visitors	vhaeni; 
visits	madalo; 
visual	vhonalaho;  tsha u vhona; 
visually	vhonalaho;  zwi vhonwaho; 
vital	 maanḓa;  tshine muthu a si tshile a si natsho; ndeme; 
voice	 ipfi;  muhumbulo; amba; 
voices	maipfi; 
void	 hu si na tshithu; tshi re fhedzi; 
volatility	tshi songo khwaṱhaho;  tshi fhelaho nḓilani; 
voluntarily	nga u tou funa; 
voluntary	nga u tou funa; 
volunteer	maḓilonga; 
volunteers	madilonga; maḓilonga; 
vote	khetho;  vouta; 
voted	khetho;  vouta; 
voter	mukhethi;  muvouthi; 
voters	vhakhethi;  vhavouthi; 
votes	khetho;  vouta; 
voting	u voutha;  u vouta; 
vulnerability	sa kona u ḓipilela; 
vulnerable	-sa koni u ḓitsireledza; 
wage	muholo; 
wages	 malamba; muholo; 
waiting	imela;  lindela; 
walk	tshimbila;  enda;  mutshimbili;  zwanyuka; lepalepa;  hwenya; 
walks	tshimbila;  enda;  zwanyuka; lepalepa;  hwenya; 
wall	luvhondo; 
walls	mbondo; 
want	ṱhoḓea; 
wanted	ṱhoḓea; 
wants	 ṱoḓa;  ṱhoḓea; funa; 
war	nndwa; 
ward	wadi; 
wards	wadi; 
warm	-dudelaho;  hu a dudela; 
warmth	vhududo; 
warning	ngeletshedzo; 
warrant	thendelo;  khwaṱhisedzo;  ṱhanziela; 
warrants	tendela; 
wars	nndwa; 
was	 ndi; tshi; 
waste	malaṱwa; 
watch	watshi; 
water	sheledza;  -nwisa;  -sheledza;  maḓi; 
waters	sheledza;  maḓi; madi;  nwisa; 
wax	makunzwu; 
way	 nḓila;  mulila; kuitele;  matshilele; 
ways	maitele;  milila;  nḓila;  matshilele; 
we	ra;  riṋe; ri;  ro; 
we've	ro; 
weakness	vhuṱudzeṱudze;  U fhela maanḓa; 
weaknesses	vhuṱudzeṱudze;  fhela maanḓa; 
wealth	lupfumo; 
weapon	tshihali; 
weapons	zwihali; 
weather	mutsho;  Vhuimo ha mutsho; 
web	lubuvhi; 
websites	lubuvhisia; webusaithi; 
week	vhege; 
week-long	vhege yoṱhe; 
weekend	mafhelo a vhege; 
weeks	vhege; 
weight	tshileme;  kala; 
welcome	ṱanganedza; 
welcomed	ṱanganedzwa; 
welcomes	ṱanganedza; 
welcoming	ṱanganedzaho; 
welfare	vhulondoli; 
well	bidzi; 
well-being	mutakalo; 
well-known	 tshi re na phungo; bvumo;  ḓivheaho; 
wellbeing	mutakalo; 
went	ya;  tshimbila;  ṱuwa; 
were	ri; 
west	 ya vhukovhela; vhukovhela; 
western	vhukovhela; 
wetland	matzhava; 
wetlands	matzhava; 
what	 vha;  mini; ya; tshifhiyo;  dza;  -nzani; zwifhiyo; 
what's	 zwikene; tshikene;  mukene; 
whatever	zwiṅwe na zwiṅwe;  tshiṅwe na tshiṅwe; 
whatsoever	zwiṅwe na zwiṅwe;  tshiṅwe na tshiṅwe; 
when	musi;  ya ri;  lini;  zwiḽa;  ho ri;  misi;  ha ri musi;  -ri; 
whenever	nga misi ha; 
where	ngafhi; 
whereas	 matsiko;  nga ha; yari; vhunga; 
whereby	heyo nga yone; 
whereupon	yavha; 
wherever	 hoṱhe hoṱhe; ngafhi na ngafhi; 
whether	ufhiyo kha vhavhili;  ingavha; kana; 
which	ya;  dza;  zwifhio;  hezwo;  tshifhio;  hedzo;  dzifhio; ifhio; 
whichever	zwiṅwe na zwiṅwe; 
while	 musi;  tshikhathi; tshifhinganyana;  tshifhinga; ha;  matsiko; yari; 
whilst	 nga tshikhathi; musi;  tshifhinga tshenetsho; 
whip	tshimebi; 
whips	zwimebi; 
white	 yo nakaho; tshena;  zwitshena;  Mutshena;  tshitshena; 
whites	zwitshena;  Vhatshena; 
who	ya; ufhiyo;  tsha;  nnyi;  ha;  vhonnyi;  we; 
whole	-oṱhe; 
wholesale	holosela; 
wholly	zwoṱhe nga tshithihi; 
whom	nnyi; 
whose	 ya nnyi; yawe; 
why	 nga mini; ngani; 
wide	aṱama; 
widely	 angalala;  ṱanḓavhuwa;  vhuphara; anzela; 
wider	aṱama; 
widespread	phaḓalala; 
wife	mufumakadzi;  musadzi; 
wild	zwa ḓaka;  tshi songo ḽeraho; 
wildlife	phukha dza ḓaka; 
will	 luṅwalo lwa mufu;  lutamo;  vhuthu; lufuno;  vhulenda;  ḓo; 
willing	tama;  funa; 
willingness	 lutamo; lufuno; 
win	gundo; 
wind	muya; 
winding-up	mvuledzo;  tandedza; khunyeledzo;  wainda; 
wine	 veini; waini; 
winner	mukundi; 
winners	vhafhenyi; vhakundi; 
winning	 gundo;  fhenya;  wina; kunda; 
winter	 vhuria; vhuriha; 
wisdom	vhuṱali; 
wish	 tshiṱuvho; funa;  tama; 
wishes	lutamo; 
wishing	tamela; 
with	 nga;  na nga; na; 
withdraw	u bvisa tshelede; 
withdrawal	 u bvisa; kokodza;  vhuisa;  u humela murahu ; 
withdrawn	bvisa tshelede; 
within	nga ngomu;  ngomu ha; 
without	nga nnḓa ha;  si na;  nnḓa ha; 
witness	ṱhanzi; 
witnessed	ṱhanzi; 
witnesses	ṱhanzi; 
woman	musadzi; 
women	vhafumakadzi; 
women's	zwa vhafumakadzi; 
won	gundo; 
wonderful	nakaho;  zwavhuḓi; 
wood	 khuni; thanda; 
word	ipfi; 
words	maipfi; 
work	 shuma;  u shuma; mushumo; 
worked	 shuma; mushumo; 
worker	mushumi; 
workers	vhashumi; 
workforce	vhashumi; 
working	 shuma; 
workplace	Ḓuvha ḽa Vhashumi; 
works	 mishumo; shuma; 
workshop	tshapo;  nnḓu ya u shuma;  wekishopho; 
workshops	 nnḓu dza u shuma; tshapo;  wekishopho; 
workspace	fhethu ha u shumela; 
world	 ḽifhasi; shango; 
world's	zwa ḽifhasi; 
world-class	maṱhakheni;  zwa nṱhesa; 
worlds	 ḽifhasi; mashango; 
worldwide	tsha ḽifhasi nga vhuphara; 
worrying	dina; ṱhupha;  tswenya;  vhilahedzisa; 
worse	 vhifhaho u fhirisa; vhuṱungu; 
worst	kalulaho;  vhifhaho zwihuluhulu; 
worth	 fanelwa nga; mutengo; 
worthy	fanelwaho nga; 
would	ḓo; 
wound	tshilonda; 
wounds	zwilonda; 
write	ṅwala; 
writer	muṅwali; 
writers	 vhuṅwali; vhaṅwali; 
writers'	vhaṅwali; 
writings	miṅwalo;  zwiṅwalwa; 
written	ṅwala; 
wrong	-khakhea;  -khakheaho; 
wrote	ṅwala; 
xenophobia	khethano nga mirafho; 
xenophobic	vengo ḽa vhabvannḓa; 
year	ṅwaha; 
year's	ṅwaha; 
year-on-year	ṅwaha nga ṅwaha; 
years	miṅwaha; 
yes	iyina; ee; 
yesterday	mulovha; 
yet	naho zwo ralo; 
yield	 aṋwa;  ṋea;  khaṋo;  u tenda; bveledza;  mbuelo; 
yields	 aṋwa;  ṋea;  u tenda; bveledza; 
you	inwi;  iwe; 
young	ṅwana;  vhana vha phukha; 
younger	 ṅwana; vhana vha phukha; 
your	 yaṋu;  zwaṋu; tshau;  yau;  zwau; 
youth	vhaswa; 
zero	pumu; 
zone	zounu; 
zones	zounu; 
zoo	vhufuwaphukha; 
