Act of Parliament	uMthetho WePhalamende
Adult Basic Education and Training	iMfundo Eyisisekelo Noqeqesho  Yabantu Abadala
Africa Institute of South Africa	isikhungo; i-Africa Institute of South Africa
African American	umMelikana odabuka e-Afrika
African Christian Democratic Party	i-African Christian Democratic Party
African Development Bank	iBhange Lezentuthuko Yase-Afrika
African Diaspora	ama-Afrika asezinze kwamanye amazwekazi
African Economic Community	inhlangano yezentuthuko yamazwe ase-Afrika; i-African Economic Community 
African National Congress	i-African National Congress
African National Congress Youth League	uphiko lwentsha lwe-African National Congress
African Union	iNhlangano Yobumbano Lwamazwe Ase-Afrika
African country	izwe lase-Afrika
African language	ulimi lwase-Afrika
African nationalist	okhulumela ukuzimela kwe-Afrika ngokwezombusazwe
African people	abantu base-Afrika
African renaissance	ukuvuselelwa kobu-Afrika
African state	izwe lase-Afrika
African wild cat	impaka
Agricultural Research Council	UMkhandlu Wocwaningo Lwezolimo 
Ambassador of	inxusa lase-
Arts and Culture Trust	isiKhwama Sezobuciko Namasiko
Basic Conditions of Employment Act	uMthetho Wemisebenzi Yezimo Eziyisisekelo
Black Consciousness Movement	Umbhidlango Ngokuzigqaja Ngokuba mnyama
Black Economic Empowerment	ukuthuthukiswa kwabamnyama kwezomnotho
Board of Directors	IBhodi Labaqondisi
British High Commissioner	uKhomishana Omkhulu WaseBhrithani
Broad-based Black Economic Empowerment Act	uMthetho Wokuthuthukiswa KwabaNsundu Kwezomnotho Ngokubanzi
Bureau of Heraldry	ihhovisi lezemicimbi; i-Bureau of Heraldy
Call of South Africa	isicelo seNingizimu Afrika
Central Energy Fund	Inkampani yezamandla; i-Central Energy Fund
Chamber of Mines	Inhlangano yabaqashi bemboni yezimayini; i-Chamber of Mines
Chief Executive Officer	iSikhulu Esiphezulu
Chief Justice	iJaji Eliyinhloko
Christian Democratic Party	inhlangano yezombusazwe; iChristian Democratic Party
Civil Rights Movement	inhlangano elwela amalungelo omphakathi; i-Civil Rights Movement
Coat of Arms	isifanekisophawu esiyisiphandla sesihlangu
Commission for Conciliation, Mediation and Arbitration	iKhomishana Yokubuyisana, Ukuxazulula Nokwahlulela
Commission for the Promotion and Protection of the Rights of Cultural, Religious	iKhomishana Yokukhuthaza Nokuvikela Amalungelo Amasiko, Ezenkolo Nezilimi Emiphakathini Eyahlukene
Commission for the Promotion and Protection of the Rights of Cultural, Religious and Linguistic Communities	iKhomishana Yokukhuthaza Nokuvikela Amalungelo Amasiko, Ezenkolo Nezilimi Emiphakathini Eyahlukene
Commission on Gender Equality	iKhomishana Yezokulingana Ngokobulili
Commonwealth of Independent States	inhlangano yezifunda; iCommonwealth of Independent States
Congress of Democrats	inhlangano yezombusazwe yaseNamibia iCongress of Democrats
Constitution of the Republic of South Africa	uMthethosisekelo WeRiphabhliki YaseNingizimu Afrika
Constitutional Assembly	uMbuthano Wabahlanganele Ukuhlanganiswa Komthethesisekelo
Constitutional Court	iNkantolo YoMthethosisekelo
Council for Scientific and Industrial Research	uMkhandlu Wocwaningo Lwezesayensi Nezezimboni
Council of Ministers	uMkhandlu WawoNgqongqoshe
Council of Provinces	uMkhandlu Wezifundazwe
Council of Traditional Leaders	uMkhandlu Wabaholi Bendabuko
Cradle of Humankind	indawo yamagugu; i-Cradle of Humankind
Criminal Procedure Act	uMthetho Olawula Ubugebengu
Customs and Excise	intela yempahla ekhiqizwa ezweni neyempahla evela kwamanye amazwe
Day of Reconciliation	Usuku Lokubuyisana
Day of the Covenant	Usuku lwesivumelwano
Democratic Alliance	inhlangano yezombusazwe iDemocratic Alliance
Democratic Party	inhlangano yezombusazwe iDemocratic Party
Department of Agriculture	uMnyango Wezolimo
Department of Arts and Culture	uMnyango Wezobuciko Namasiko
Department of Communications	uMnyango Wezokuxhumana
Department of Defence	uMnyango Wezokuvikela
Department of Education	uMnyango Wezemfundo
Department of Finance	uMnyango Wezezimali
Department of Home Affairs	uMnyango Wezindaba Zasekhaya
Department of Justice	UMnyango WeZomthetho
Department of Justice and Constitutional Development	uMnyango Wezobulungiswa Nokuthuthukiswa Komthethosisekelo
Department of Land Affairs	uMnyango Wezindaba Zomhlaba
Department of National Education	uMnyango Wezemfundo KuZwelonke
Department of Public Service and Administration	uMnyango Wezemisebenzi Kahulumeni Nokuphathwa Kwayo
Department of Public Works	uMnyango Wezemisebenzi Yomphakathi
Department of Science and Technology	uMnyango Wezesayensi Nobuchwepheshe
Department of Social Development	uMnyango Wezokuthuthukiswa Komphakathi
Department of Sport and Recreation	uMnyango Wezemidlalo Nokungcebeleka
Department of State	uMnyango Kahulumeni
Department of Transport	uMnyango Wezokuthutha
Department of Water Affairs	UMnyango WeZamanzi
Department of Water Affairs and Forestry	uMnyango Wezamanzi Namahlathi
Deputy Speaker	Isekela LikaSomlomo
Deputy Speaker of Parliament	Isekela LikaSomlomo WePhalamende
Director of Public Prosecution	UMqondisi Wokushushiswa Komphakathi 
Director of Public Prosecutions	UMqondisi Wokushushiswa Komphakathi 
Dutch Reformed Church	Ibandla; i-Dutch Reformed Church 
Eastern Cape	iMpumalanga Kapa
Employment Equity Act	uMthetho Wokuqasha Ngokulinganisa
Environmental Impact Assessment	Ukulinganisa Umthelela Kwezemvelo
European Union	iNyunyana Yamazwe AseYurophu
Executive Council	uMkhandlu Weziphathimandla
Financial Services Board	iBhodi lezezimali; i-Financial Services Board
Financial and Fiscal Commission	iKhomishini Yezezimali Zikahulumeni, iFinancial and Fiscal Commission
Fire Protection Association	iNhlangano Yokuvikeleka Emlilweni
First World	iZwe Elithuthuke Ngokwanele
First World War	iMpi Yokuqala Yomhlaba
Foundation for Creative Arts	iNhlangano Yamaciko; i-Foundation for Creative Arts
Free State	iFree State
Free State Stadium	iNkundla Yezemidlalo YaseFree State
Freedom Charter	uSomqulu WeNkululeko
Freedom Day	uSuku LweNkululeko
Freedom Front	inhlangano yezombusazwe iFreedom Front
Gauteng Provincial Government	UHulumeni Wesifundazwe SaseGauteng
Government of National Unity	Uhulumeni Wobumbano
Group Areas Act	uMthetho Wokuhlalisa Ngokobuhlanga
Heads of Diplomatic Missions	iZinhloko Zamanxusa
Health Professions Council of South Africa	uMkhandlu Wemisebenzi Yezempilo WaseNingizimu Afrika
High Court	iNkantolo Enkulu
High Court of South Africa	iNkundla Ephakeme YaseNingizimu Afrika
Horn of Africa	Ingasiqhingi yamazwe ase-Afrika eseNyakatho
House of Assembly	iPhalamende
House of Commons	iNdlu YePhalamende LaseBrithani iHouse of Commons
House of Delegates	iNdlu eyayimele amaNdiya ePhalamende lenqubo yobandlululo
House of Lords	iNdlu YePhalamende LaseBrithani iHouse of Lords
House of Representatives	iNdlu eyayimele amaKhaladi ePhalamende lenqubo yobandlululo
Human Rights Commission	iKhomishini Yamalungelo Esintu
Human Rights Day	uSuku Lwamalungelo Esintu
Human sciences research	ucwaningo ngezabantu
Independent Electoral Commission	Ikhomishani Yokhetho Ezimele
Industrial Development Corporation	isikhungo sezezimboni; i-Industrial Development Coorporation
Information Society and Development	inhlangano yolwazi lwezobuchwepheshe nentuthuko, i-Information Society and Development
Inkatha Freedom Party	Inkatha Freedom Party
International Labour Organisation	iNhlangano Yomhlaba Yabasebenzi
International Monetary Fund	iNhlangano Yomhlaba Yezezimali, i-IMF
International Olympic Committee	Ikomiti Lomhlaba Lama-olimpikhi 
International Olympic Committee	Ikomiti lomhlaba lama-Olimpiyadi
International Relations	Ubudlelwano Namazwe Omhlaba
International Telecommunications Union	iNyunyana Yomhlaba Yezokuxhumana Ngezingcingo
Judicial Service Commission	iKhomishana Yemisebenzi Yezobulungiswa
Labour Relations Act	uMthetho Ophathelene Nezabasebenzi
Land Claims Court	iNkantolo Yezibizo Zemihlaba
Language Task Group	iThimba Elimiselwe Ezolimi
Leader of the House	uMholi Wendlu
Leader of the Official Opposition	uMholi Weqembu Elisemthethweni Eliphikisayo
Member of Parliament	Ilungu Lephalamende
Minister of Education	uNgqongqoshe weMfundo
Minister of Justice	uNgqongqoshe weZobulungiswa
Minority Front	inhlangano yezombusazwe; iMinority Front
Municipal Demarcation Board	iBhodi Lokuklanywa Komasipala
NCOP Committee	iKomidi Lomkhandlu Kazwelonke Wezifundazwe
Natal Indian Congress	inhlangano; iNatal Indian Congress
National Agricultural Marketing Council	uMkhandlu Wezokudayiswa Kwezolimo; i-National Agricultural Marketing Council
National Arts Council	Umkhandlu Wezobuciko Kazwelonke
National Arts Festival	Umgidi Wezobuciko Kazwelonke
National Assembly	iSigungu Sikazwelonke
National Commissioner	uKhomishana Kazwelonke
National Council of Provinces Committee	iKomidi Lomkhandlu Kazwelonke Wezifundazwe
National Cultural History Museum	isigcinamagugu; i-National Cultural History Museum
National Environmental Management Act	uMthetho olawula ukuphathwa kwezemvelo; i-National Environmental Management Act
National House of Traditional Leaders	iNdlu Kazwelonke Yabaholi Bendabuko
National Intelligence Agency	iNhlangano Kazwelonke Yezobunhloli
National Marketing Council	uMkhandlu wezokudayisa; i-National Marketing Council
National Monuments Council	uMkhandlu wamatshe esikhumbuzo; iNational Monuments Council
National Party	inhlangano yezombusazwe; iNational Party
National Peace Accord	Isivumelwano Soxolo Sikazwelonke
National Qualifications Framework	uhlaka lwezeziqu; i-National Qualifications Framework
National Revenue Fund	iSikhwama semali engenayo; i-National Revenue Fund
National Swimming Federation	inhlangano yezokubhukuda; i-National Swimming Federation
National Training Board	iBhodi Likazwelonke Lezokuqeqeshwa 
National Women's Day	Usuku Lomama Kuzwelonke
National Youth Commission	iKhomishana Yentsha Kazwelonke
New National Party	inhlangano yezombusazwe; iNew National Party
New Year's Day	uNcibijane
Nkosi Sikelel' iAfrika	ihubo lesizwe; uNkosi Siklelel'i-Afrika
Nobel Peace Prize	uMklomelo; i-Nobel Peace Price
Northern Cape	iNyakatho Kapa
Organisation for African Unity	iNhlangano Yobumbano Lwamazwe Ase-Afrika
Organisation of African	iNhlangano Yobumbano Lwamazwe Ase-Afrika
Organisation of African Unity	iNhlangano Yobumbano Lwamazwe Ase-Afrika
Pan Africanist Congress of Azania	iNhlangano; i-Pan Efricanist Congress of Azania
Pan South African Language Board	iBhodi Lezilimi ZaseNingizimu Afrika
People Against Gangsterism and Drugs	inhlangano yabalwa nobugebengu nezidakamizwa; iPeople Against Gangsterism and Drugs
Perishable Products Export Control Board	iBhodi lemikhiqizo eya kwamanye amazwe; i-Perishable Products Export Control Board
President of the Senate	uMengameli Womkhandlu Wezigele
Pretoria Art Museum	isigcinamagugu; i-Pretoria Art Museum
Pretoria East Cemetery	amaliba asempumalanga nePitoli; i-Pretoria East Cemetery
Prohibition of Mixed Marriages Act	uMthetho Ovimbela Umshado Wezinhlanga Ezahlukene
Provincial Commissioner	uKhomishana Wesifundazwe
Provincial House of Traditional Leaders	iNdlu Yesifundazwe Yabaholi Bendabuko
Public Administration	Ukuphathwa Komphakathi
Public Order Policing	Ukulawulwa Kwezinxushunxushu Emphakathini
Public Protector	uMvikeli Womphakathi
Public Service Commission	iKhomishini elawula umsebenzi womphakathi; i-Public Service Commission
Reconstruction and Development Programme	Uhlelo Lokwakha Kabusha Nentuthuko
Reserve Bank	iBhange LoMbuso
SA Library for the Blind	umtapo wolwazi waseNingizimu Afrika wabangaboni emehlweni
San rock painting	imifanekiso yasematsheni yamaSani
Second World War	iMpi Yesibili Yomhlaba
Secretary to Parliament	uNobhala wePhalamende
Sector Education and Training Authority	inhlangano yezokuqeqeshelwa amakhono; i-Sector Education and Training Authority
Skills Development Act	Umthetho Wokuthuthukiswa Kwamakhono
South African Bureau of Standards	inhlangano yezamazinga ezimpahla; i-South African Bureau of Standards
South African Chamber of Commerce	inhlangano yawosomabhizinisi; iSouth African Chamber of Commerce
South African Communist Party	inhlangano yezombusazwe; iSouth African Communist Party
South African Constitution	uMthethosisekelo WaseNingizimu Afrika
South African Council of Churches	uMkhandlu wamabandla; iSouth African Council of Churches
South African Defence Force	uMbutho Wezokuvikela; iSouth African Defence Force
South African Human Rights Commission	iKhomishana Yamalungelo Esintu
South African Local Government Association	iNhlangano Yohulumeni Basekhaya YaseNingizimu Afrika
South African National Civic Organisation	inhlangano yezomphakathi; i-South African National Civic Organisation
South African National Defence Force	uMbutho Kazwelonke Wezokuvikela
South African National Parks	inhlangano ebhekele ezamapaki; i-South African National Parks
South African Native National Congress	inhlangano yezombusazwe; iSouth African Native National Congress
South African Police	uMbutho Wamaphoyisa
South African Police Service	uPhiko Lwamaphoyisa AseNingizimu Afrika
South African Qualifications Authority	inhlangano yezemigomo yeziqu; iSouth African Qualifications Authority
South African Reserve Bank	iBhange loMbuso; i-South African Reserve Bank
South African Revenue Service	isikhungo sakuleli esiqoqa intela; i-South African Revenue Service
South African Secret Service	iNhlangano Kazwelonke Yezobunhloli
South African Sugar Association	inhlangano kashukela; i-South African Sugar Association
South African citizen	isakhamuzi saseNingizimu Afrika
South African design	ukuklama kwakuleli
South African design	ukuqamba kwakuleli
South African tea	itiye laseNingizimu Afrika
Southern Africa	i-Afrika eseNingizimu
Southern African Development Community	iNhlangano yamazwe ase-Afrika eseNingizimu
Southern African Large Telescope	isibonakude esikhulu sase-Afrika eseNingizimu
Speaker of Parliament	Usomlomo Wephalamende
Speaker of the National Assembly	Usomlomo Wesishayamthetho Sikazwelonke
State Department	uMnyango Kahulumeni
State President	uMengameli Wezwe
Statistics South Africa	isikhungo sezocwaningozibalo; i-Statistics South Africa
Supreme Court	iNkantolo Ephakeme
Supreme Court of Appeal	iNkantolo Ephakeme Yokwedluliswa Kwamacala
The Call of South Africa	iSicelo SeNingizimu Afrika
The National Qualifications Framework	uhlaka lwezeziqu; i-National Qualifications Framework
The South African National Council for the Blind	uMkhandlu wabangaboni emehlweni; i-South African National Council for the Blind
Tropic of Capricorn	i-Tropic of Capricorn
Truth and Reconciliation Commission	iKhomishana Yamaqiniso Nokubuyisana
UN Security Council	uMkhandlu Wezokuvikela WeNhlangano Yezizwe
Union of South Africa	iNyunyana YeseNingizimuAfrika
United Christian Democratic Party	inhlangano yezombusazwe; i-United Christian Democratic Party
United Democratic Front	inhlangano yezombusazwe; i-United Democratic Front
United Democratic Movement	inhlangano yezombusazwe; i-United Democratic Movement
United Nations	iNhlangano Yezizwe
United States of America	i-United States of America
Universal Declaration of Human Rights	Ukumenyezelwa Kwamalungelo Abantu Emhlabeni Wonke
Water Research Commission	iKhomishana Yokucwaninga Ngezamanzi
West Bank	ibhange; iWest Bank
Western Cape	iNtshonalanga Kapa
Willem Prinsloo Agricultural Museum	isigcinamagugu sezolimo; i-Willem Prinsloo Agricultural Museum
World Health Organisation	Inhlangano Yezempilo Kazwelonke
World Heritage Site	iSizinda Samagugu Omhlaba
World Trade Organisation	iNhlangano Yezohwebo Yamazwe Omhlaba
World War I	iMpi Yomhlaba Yoku-1
World War II	iMpi Yomhlaba Yesi-2
World Wildlife Fund	inhlangano elwela ukulondolozwa kwemvelo; i-World Wildlife Fund
abuse of power	ukusetshenziswa kabi kwamandla
academic freedom	inkululeko kwezemfundo
account for	nika isizathu esilungile
account to	landa ku-
accountable for	olindeleke ukuba aziphendulele kokuthile
accounting officer	obhekele ezama-akhawunti
acid mine drainage	ukunukubezwa kwamanzi yisibabuli
act of parliament	umthetho wephalamende
act of state	umthetho wombuso
acts of sabotage	ukucekela phansi
ad hoc	okwesikhashana
ad hoc committee	ikomidi lesikhashana
administration of justice	inqubo nohlaka okusetshenziselwa ukuxazulula ukungqubuzana
administrative action	isinyathelo sezokuphatha
administrative function	umsebenzi wezokuphatha
administrative powers	amandla ezokuphatha
advancement of technology	inqubekelaphambili kwezobuchwepheshe
advisory body	uhlaka lwabeluleki
affirmative action	isenzangakhona
against the law	okuphambene nomthetho
agent of change	osiza ekuletheni izinguquko enhlanganweni
air traffic	ukuhamba kwamabhanoyi
air traffic control	ukulawula ukuhamba kwamabhanoyi
all rights reserved	wonke amalungelo agodliwe
all the time	sonke isikhathi
annual financial statement	isitatimende sonyaka wezimali
annual general meeting	umhlangano ojwayelekile wonyaka
annual report	umbiko yonyaka
appoint the cabinet	ukuqoka isigungu songqongqoshe
appropriate technology	ubuchwepheshe obufanele
area of interest	indawo ethandwayo
area of jurisdiction	indawo okusebenza kuyo amagunya ngokomthetho
area of land	indawo yomhlaba
area of responsibility	indawo yokusebenza
armed struggle	umzabalazo wezikhali
arts and crafts	ubuciko nemisebenzi yezandla
arts and crafts market	imakethe yobuciko nemisebenzi yezandla
arts and culture	ubuciko namasiko
as amended	njengoba kuchitshiyelwe
as far as possible	ngangokunokwenzeka
as many as	ngobuningi
as soon as possible	ngokushesha ngangokusemandleni
assumption of duty	ukuqala ukusebenza
at a meeting	emhlanganweni
at the age of	esikhathini sa-
attainment of independence	ukuzuza ukuzimela
attend a meeting	hambela umhlangano
basic human rights	amalungelongqangi esintu
basic needs	izidingongqangi
basic rights	amalungelongqangi
bear witness to	bonisa ngokuba khona kwakho ukuthi
bed and breakfast	ukulala nesidlo sasekuseni
bilateral relations	ubudlelwano phakathi kwamazwe amabili
bill of rights	umqulu wamalungelo esintu
black power movement	ukuthuthukiswa kwabamnyama kwezomnotho
board of directors	ibhodi labaqondisi
board of trustees	ibhodi labaphatheli
body of water	ukuqongeleleka kwamanzi phezu komhlaba
border post	umngcele phakathi kwamazwe amabili
bottom line	iphuzu elisemqoka kakhulu
box office returns	okubuyela ehhovisi lamathikithi
branches of government	imikhakha kahulumeni
budget process	uhlelo lwesabelomali
budget vote	usuku uNgqongqoshe ethula ngalo isabelomali
build a part	akha ingxenye
bunch of grapes	isixheke
bus rapid transit	uhlelo lwamabhasi asheshayo olususelwa kolwezitimela
business community	osomabhizinisi
business of parliament	umsebenzi wephalamende
business sector	umkhakha wawosomabhizinisi
by the authorities	ngeziphathimandla
by virtue of	ngegunya la-
by way of	ngendlela ya-
by word of mouth	ngomlomo
call centre operator	okhuluma namakhasimende ebhizinisi ngezingcingo
call for nominations	ukucela abaphakanyiselwa ukuqokwa/ukukhethwa
capacity building	ukwakha amakhono
capital city	inhlokodolobha
central business district	indawo okuqhutshwa kuyo amabhizinisi edolobheni
central government	uhulumeni omkhulu
certify a bill	ukuqinisekiswa kwe-akhawunti
chamber of commerce	inhlangano egqugquzela, ivikele osomabhizinisi bendawo
change of address	ukuguqulwa kwekheli
change of course	ukuguqulwa kwendlela
changes over time	izinguquko ngokuhamba kwesikhathi
changing society	umphakathi oguqukayo
checks and balances	ukulawulana kwemikhakha kahulumeni
chief executive	isikhulu esiphezulu
chief whip	usotswebhu omkhulu
child abuse	ukuhlukunyezwa kwengane
child rearing practices	imikhuba yokukhulisa ingane
children of Africa	izingane zase-Afrika
city centre	inkaba yedolobha
civil rights	amalungelo abantu
civil rights movement	inhlangano yamalungelo omphakathi
civil service	usizo lomphakathi
civil society	imikhakha kahulumeni yezokuphatha
civil war	impi yombango
coat of arms	isifanekisophawu esiyisiphandla sesihlangu
code of conduct	indlela yokuziphatha
code of ethics	imithetho yenkambo elungileyo
collection of data	ukuqoqwa kwemininingwane
collective responsibility	isibopho sokubhekana nezenzo zabanye ngokuhlanganyela
colonial power	amandla ezifikanamthwalo
colonial rule	ukubuswa yizifikanamthwalo
come into force	ukuqala ukusebenza
come to the point	ukusho okubalulekile
committee meeting	umhlangano wekomidi
common interest	okuhlomulisa wonke umuntu
community broadcasting service	isiteshi sokusakaza sendawo
community building	ukwakha umphakathi
community development	intuthuko yomphakathi
community involvement	ukubandakanyeka komphakathi
community participation	ukubamba iqhaza komphakathi
community police forum	uhlaka lomphakathi olusebenzisana namaphoyisa
community service	ukusebenzela umphakathi
conclude an agreement	ukuphothula isivumelwano
conditions of contract	imibandela yenkontileka
conditions of service	izimo zokusebenza
conflict prevention	ukuvimbela ukungqubuzana
conflict resolution	ukuxazululwa kokungqubuzana
constitutional democracy	intando yabantu ngokomthethosisekelo
constitutional mandate	igunya ngokomthethosisekelo
constitutional state	umbuso ngokomthethosisekelo
consumer price index	iqoqo lamanani ezimpahla
contempt of parliament	ukudelela iphalamende
convene a meeting	biza umhlangano
cooperation agreement	isivumelwano sokubambisana
course of action	ukulandelana kwemisebenzi eyinziwayo
cultural change	uguquko ngokwamasiko
cultural community	umphakathi ngokwamasiko
cultural diversity	ukwahlukahlukana ngokwamasiko
cultural goods	izimpahla zezamasiko
cultural heritage	amagugu ezamasiko
cultural revolution	uguquko olusheshayo kwezamasiko
culture of human rights	isiko lamalungelo abantu
current affairs	ezisematheni
customary law	umthetho ophathelene namasiko
customs and excise	intela yempahla ekhiqizwa ezweni neyempahla evela kwamanye amazwe
cutting edge	okusezingeni eliphezulu
data collection	ukuqoqa ulwazi locwaningo
date of birth	usuku lokuzalwa
decent living	ukuphila impilo enhle
deciduous fruit industry	imboni yezithelo eziwohlokayo uma sezivuthiwe
defence force	umbutho wezokuvikela
degree of freedom	izinga lenkululeko
delegated legislation	umthetho obekwe yiziphathimamndla ezigunyaziwe
demand and supply	okufunwa ngabathengi nokuphakelwa yimakethe
democratic culture	isiko lentando yabantu
democratic election	ukhetho lwentando yabantu
democratic political order	uhlelo lwezombusazwe ngokwentando yabantu
democratic principle	umgomo wentando yabantu
democratic society	umphakathi obuswa ngokwentando yabantu
democratic state	izwe elibuswa ngokwentando yabantu
democratic transformation	uguquko ngokwentando yabantu
democratic values	okuyigugu kubantu
deputy minister	isekela likangqongqoshe
deputy president	isekela likamengameli
dereliction of duty	ihlazo lokwahlulwa ngukufeza izibopho
developing country	izwe elisathuthuka
development initiatives	izinhlelo zezentuthuko
development process	uhlelo lwezentuthuko
development programme	uhlelo lwezentuthuko
development strategy	isu lezentuthuko
diplomatic corps	amanxusa amazwe kwelinye izwe
diplomatic relations	ubudlelwano phakathi kwamazwe amabili
direct support	ukwesekela ngqo
director general	umqondisi jikelele
disaster management	ukulawulwa kwenhlekelele
disciplinary action	isinyathelo sokuqondisa izigwegwe
discussion document	incwadi eyisisekelo sezingxoxo
dispossession of land	ukwaphucwa umhlaba
distribution capacity	amandla okwaba
distribution of resources	ukwabiwa kwezinsiza
distribution of wealth	ukwabiwa komnotho
district municipality	umasipala wesifunda
diverse society	umphakathi owahlukene
diversity of people	ukwahlukahlukana kwabantu
divide and rule	inqubo yokulawula abantu ngokugqugquzela ukwahlukana kwabo
domain name authority	amandla egama ngokohlelo i-DNS lwe-inthanethi
down for discussion	okuxoxwa ngakho
draft bill	umthethosivivinywa ohlongozwayo
draft legislation	umthetho ohlongozwayo
early warning	isaziso ngokuzokwenzeka
early warning system	uhlelo lokwexwayisa kusenesikhathi
ease of access	ukutholakala kalula; ukungena kalula
economic empowerment	ukuthuthukiswa ngokomnotho
economic growth	ukukhula komnotho
economic impact	umthelela kwezomnotho
economic relations	ubudlelwano kwezomnotho
economic sector	imboni yezomnotho
economic strength	amandla ezomnotho
effective public service	ukusizwa komphakathi okusebenzayo
election period	isikhathi sokhetho
election process	inqubo yezokhetho
election results	imiphumela yezokhetho
enabling environment	isimo esivumayo
entitled to vote	ogunyazelwe ukuvota
environmental impact	umthelela kwezemvelo
environmental impact assessment	ukulinganisa umthelela kwezemvelo
equal opportunities	amathuba alinganayo
equality before the law	ukulingana phambi komthetho
every three years	njalo eminyakeni emithathu
executive action	isinyathelo seziphathimandla
executive authority	igunya leziphathimandla
executive organs of state	izigaba zeziphathimandla zombuso
explanatory memorandum	imemorandamu echasisisayo
fair election	ukhetho olungenzeleli
fall in love	ukuba nomuzwa wothando
fauna and flora	izilwane nokumilayo
field of study	umkhakha wocwaningo
fill a vacancy	gcwalisa isikhundla
financial year	unyaka wezezimali
first past the post	ukuphumelela ngamavoti amaningi
fiscal discipline	amandla kahulumeni okulawula ukusetshenziswa kwezimali
five hundred and six	amakhulu amahlanu nesithupha
follow up	ukulandelela
food security	ukutholakala kokudla
forced labour	ukusebenza ngokuphoqwa
fore and aft	ngaphambili nangemuva emkhunjini
fore and after	umkhumbi oneseyili bokuntweza
foreign direct investment	ukutshala ngqo imali ngabamazwe angaphandle
foreign exchange	uhlobo lwemali yakwamanye amazwe
foreign policy	inqubomgomo yezwe ngokuphathelene namanye amazwe
free of charge	mahhala
free society	umphakathi okhululekile
freedom fighter	olwela inkululeko
freedom of association	inkululeko yokuzimbandakanya
freedom of conscience	ilungelo lokukholelwa kokuphathelene nenkolo nokulunga
freedom of expression	ukukhuluma ngenkululeko
freedom of movement	ilungelo lokuhamba ngokukhululeka
freedom of religion	ilungelo lokuzikhethela inkolo
freedom of scientific research	inkululeko yocwaningo lwezesayensi
freedom of speech	ukukhuluma ngenkululeko
freedom of the press	inkululeko yabamaphephandaba
from the front	ngokusukela ngaphambili
full supply level	indawo yokuphakelwa ngokugcwele
functional area	ithimba elenza umsebenzi ofanayo enhlanganweni
fundamental human rights	amalungelongqangi esintu
fundamental rights	amalungelongqangi
future research	ucwaningo lwesikhathi esizayo
gender equality	ukulingana ngokobulili
gender inequality	ukungalingani ngokobulili
gender violence	udlame ngokobulili
general election	ukhetho jikelele
get away with	ukuphunyuka
give evidence	nika ubufakazi
global development	intuthuko yomhlaba wonke
global economy	umnotho womhlaba wonke
global village	umphakathi womhlaba oxhunyaniswe ngezingcingo
go on for	qhubekela
goods and services	izimpahla nemisebenzi
governing party	inhlangano ebusayo
government action	isinyathelo sikahulumeni
government authority	igunya likahulumeni
government by the people	ukubuswa ngabantu
government department	umnyango kahulumeni
government funding	imali ekhokhwa nguhulumeni
government level	izinga likahulumeni
government of the day	uhulumeni obusayo
government policy	inqubomgomo kahulumeni
government sector	umkhakha kahulumeni
government services	usizo lukahulumeni
governmental organisation	inhlangano kahulumeni
grassroots level	emazingeni aphansi
guard of honour	iqoqo labahlelelwe ukwamukela isihambeli
guilty of contempt	ukuba necala lokwedelela inkantolo
half a million	ingxenye yesigidi
have a vote	vota
head of government	inhloko yombuso
head of office	inhloko yehhovisi
head of state	inhloko yombuso
health care	usizo lwezempilo
hierarchy of authority	amagunya ngokwamazinga enhlangano
historically disadvantaged	ababencishwe amathuba
hold a meeting	ukubamba umhlangano
hold office	ukuba sehhovisi
honorary citizenship	ukuba yisakhamuzi ngokwaziswa
honours and awards	ukuhlonishwa nemiklomelo
host country	izwe elisingethe
host nation	isizwe esisingethe
house of assembly	iphalamende
houses of parliament	izindlu zephalamende
human development	intuthuko yomuntu
human dignity	isithunzi somuntu
human nature	imvelo yomuntu
human race	uhlobo lomuntu
human resource	umuntu emsebenzini
human resource development	ukuthuthukiswa kwabasebenzi
human rights	amalungelo esintu
human rights abuse	ukuphathwa kabi kwamalungelo esintu
human rights activist	isishoshovu samalungelo abantu
human rights violation	ukwephulwa kwamalungelo abantu
human security	ukuvikeleka komuntu
imbalances of the past	ukungalingani kwesikhathi esedlule
immediate past president	umengameli wesikhathi esisanda kwedlula
in accordance with	ngokuhambisana na-
in accordance with the rules	ngokwemithetho
in addition to	ngaphezulu kwa-
in an acting capacity	njengebamba
in any way	nganoma ngabe iyiphi indlela
in case of	uma kwenzeka
in celebration of	ekugubheni umkhosi wa-
in compliance with	ngokuthobela
in consultation with	ngokubonisana
in excess of	ngokweqisa
in favour of	ngokukhetha u-
in favour of	ngokuthanda u-
in favour of	ngokwenzela u-
in good faith	ngobuqotho
in office	ehhovisi
in so far	ngangoba
in spite of	-phezu kokuba
in support of	ngokweseka u-
in terms of	ngokwa-
in the balance	okungabazekayo
in the course of	ngesikhathi
in the evening	kusihlwa
in the event of	uma kwenzeka okuthile
in the field of	emkhakheni wa-
in the gap	esikhaleni
in the interim	okwamanje
in the lead	okuholayo
in the long term	esikhathini eside
in the majority	ngeningi
in the morning	ekuseni
in the name of	egameni lika-
in the picture	esithombeni; emfanekisweni
in the region of	esifundeni sase-
in the white	kokumhlophe
inaugural address	inkulumo yokuvula
inaugural meeting	umhlangano wokuvula
income tax	intela yeholo
indigenous culture	isiko lendabuko
indigenous language	ulimi lwendabuko
indigenous people	abantu bendabuko
industrial society	umphakathi osebenzisa ubuchwepheshe
infant mortality rate	izinga lokufa kwezingane
information retrieval	ukubuyisa ulwazi
information retrieval system	uhlelo lokubuyisa ulwazi
inner city	iphakathi nedolobha
inspector of mines	umhloli wezimayini
intellectual property rights	amalungelo obunikazi bolwazi
intergovernmental relations	ubudlelwano phakathi kohulumeni
interim constitution	umthethosisekelo wesikhashana
international affairs	ezamazwe omhlaba
international community	umphakathi wamazwe omhlaba
international humanitarian law	umthetho womhawu kubantu bonke emhlabeni
international relations	ubudlelwano bamazwe ngamazwe
interrupt the proceedings	ukuphazamisa okuqhubekayo
investment of capital	utshalomali lwengqalasizinda
job creation	ukudalwa kwamathuba omsebenzi
joint committee	ikomidi lamalungu ezinhlangano ezahlukene
joint meeting	umhlangano wezinhlangano ezahlukene
joint responsibility	isibopho sezinhlangano ezahlukene
joint rules committee	ikomidi lamalungu ezindlu ezahlukene
joint sitting	umhlangano wamaqoqo ahlukene athattha izinqumo
judicial authority	amandla ejaji
keep in mind	khumbula
keep up to date	ukunika ulwazi olusha
key performance area	umsebenzi osemqoka owenziwayo
labour force	abasebenzi
labour intensive	umsebenzi odinga kakhulu abasebenzi
labour market	indawo abasebenzi abaxhumana kuyo
lack of energy	ukungabibikho kukagesi
land ownership	ubunikazi bomhlaba
land reform	izinguquko kwezomhlaba
land restitution	ukubuyiselwa umhlaba
land rights	amalungelo omhlaba
language policy	inqubomgomo yolimi
language practice	imisebenzi yolimi
language rights	amalungelo olimi
law enforcement	ukuqiniswa komthetho
lay a charge	beka icala
leader of the opposition	umholi weqembu eliphikisayo
learning process	ukufunda
least of all	phansi kwakho konke
legacy of apartheid	okushiywe yinqubo yobandlululo
legal deposit library	umtapo wokushicilelwe kwagcinwa kuwo ngokomthetho
legislative authority	igunya lokwenza imithetho
legislative function	umsebenzi wokwenza imithetho
legislative power	amandla okwenza imithetho
legislative powers	amandla okwenza imithetho
legislative process	ukwenza imithetho
level of government	isigaba sikahulumeni
level of service	izinga losizo/lesidingo
levels of development	amazinga entuthuko
liberation movement	inhlangano elwela inkululeko
liberation struggle	umzabalazo wenkululeko
limited access	ukuvunyelwa okunemingcele
lingua franca	ulimi okuxhunyanwa ngalo
list of members	uhla lwamalungu
local government	uhulumeni wendawo
local government level	izinga likahulumeni wendawo
local government sector	umkhakha kahulumeni wendawo
local municipality	umasipala wendawo
local sphere of government	isigaba sikahulumeni wendawo
mainstream economy	isimo somnotho esivamile
majority of votes	iningi lamavoti
majority party	iqembu elivotelwa kakhulu kunamanye
make a mark	beka uphawu
make a statement	enza isitatimende
make an effort	enza umzamo
management review	ukubukezwa kwabaphathi
manner of speaking	indlela yokukhuluma
marine living resources	ingcebo yokuphilayo olwandle
market economy	umnotho olawulwa yizimakethe
mass mobilisation	ukugqugquzelwa kwabantu
master of ceremonies	umphathi wohlelo
matter of public importance	udaba olusemqoka emphakathini
matter of urgency	udaba oluphuthumayo
means of communication	indlela yokuxhumana
means of transport	izindlela zokuthwala
member of parliament	ilungu lephalamende
member of the council	ilungu lomkhandlu
member states of the UN	amazwe angamalungu eNhlangano Yezizwe
memorandum of understanding	isivumelwano esisemthethweni phakathi kwezinhlangothi ezimbili noma ngaphezu kwalokho
metropolitan area	ingxenye yedolobha elikhulu egcwele abantu
middle class	abantu abaholo labo liphakathi nendawo
minority domination	amandla abayingcosana
minority party	iqembu labayingcosana
minutes of proceedings	amaminithi omhlangano
mode of operation	indlela yokusebenza
moment in time	ngaleso sikhathi
money laundering	ukushushumbiswa kwemali
months of the year	izinyanga onyakeni
mortality rate	izinga lokufa kwabantu
mother tongue	ulimi lwebele
multicultural society	umphakathi omasikomaningi
music rights organisation	inhlangano yamalungelo omculo
mutual understanding	ukuvumelana
mutually exclusive	izimo ezikhona ezingahlobene
national affairs	ezezwe lonke
national anthem	ihubo lesizwe
national asset	impahla yesizwe
national budget	isabelomali sezwe
national coat of arms	imendlela yempi
national conference	ingqungquthela kazwelonke
national department	umnyango kazwelonke
national development	intuthuko kazwelonke
national economy	umnotho kazwelonke
national education	ezemfundo kuzwelonke
national executive	iziphathimandla zikazwelonke
national executive authority	igunya leziphathimandla kuzwelonke
national executive committee	ikomidi leziphathimandla kuzwelonke
national flag	ifulegi likazwelonke
national government	uhulumeni kazwelonke; uhulumeni omkhulu
national identity	ukuba nguye  kuzwelonke; ukuba yikho kuzwelonke
national interest	okuthandwayo kuzwelonke
national leader	umholi ezingeni likazwelonke
national level	izinga likazwelonke
national level of government	isigaba sikahulumeni kuzwelonke
national policy	inqubomgomo kuzwelonke
national pride	ukuziqhenya ezingeni likazwelonke
national reconciliation	ukubuyisana ezingeni likazwelonke
national security	ukuvikeleka ezingeni likazwelonke
national sphere of government	isigaba sikazwelonke sikahulumeni
national strategy	isu likazwelonke
national symbols	izimpawu zikazwelonke
national unity	ubumbano ezingeni likazwelonke
natural justice	umthetho olwa nokwenzelela
natural resources	izinsiza zemvelo
need to know	isidingo sokwazi
new dispensation	isikhathi esisha sombuso
not later than	singakashayi sedlula isikhathi
notice of motion	isaziso ngesiphakamiso
number of children	inani labantwana
number of deaths	inani labashonile
oath of office	isifundo sokwamukela umsebenzi
of paramount importance	okusemqoka kakhulu
office bearer	umuntu osesikhundleni
official language	ulimi olusemthethweni
official residence	indawo esemthethweni okuhlalwa kuyo
on the defence	kwabaziphendulelayo
on the market	okusemakethe
on the run	okugijimayo
on the second	ngokuphazima kweso
on the wing	okusophikweni
open society	umphakathi ovulelekile
opening address	inkulumo yokuvula
order of merit	ukulandelana ngokwedlulana
order of preference	ukuhlela ngokukhethwayo
order of the day	okudingekayo noma okuvamile esikhathini esithile
ordinary session	umhlangano owejwayelekile
organs of state	izigaba zombuso
orphans and vulnerable children	izintandane nezingane ezisengcupheni yokuhlukumezeka
out of control	okungalawuleki
out of date	okuphelelwe yisikhathi
out of order	ukuphaphalaza
out of print	incwadi esiphelile; engaphrintiwe okwamanje 
out of service	okungasebenzi okwamanje
out of stock	okuphele isitoko sakho
outbreak of war	ukuqubuka kwempi
ownership of land	ubunikazi bomhlaba
paradigm shift	uguquko olusemqoka endleleni okubukwa ngayo izinto
parliament is in session	isikhathi sephalamende
parliamentary committee	ikomidi lasephalamende
parliamentary correspondent	obhalela iphalamende
parliamentary democracy	intando yabantu ephalamende
parliamentary process	inqubo yephalamende
participate in the debate	bamba iqhaza kuyo inkulumompendulwano
participatory democracy	inqubo egcizelela ukubamba iqhaza kwezombusazwe
party discipline	ukwesekwa kwemigomo yeqembu ngamalungu alo
party system	uhlelo lweqembu
pass laws	imithetho yesikhathi sobandlululo
pave the way	lungisela
peaceful coexistence	ukuhlalisana ngokuthula
peaceful demonstration	ukubhikisha ngokuthula
peaceful transition	uguquko olunokuthula
per capita	komuntu emunye
performing arts council	umkhandlu wamaciko asebenzisa amazwi nokunyakazisa umzimba
permanent residence permit	imvume yokuhlala unomphela
pillar of strength	insika yamandla
pilot project	umklamo wokuhlola
place of safety	indawo yokuphephela
platinum group metals	okusansimbi kweqoqo leplathinamu
play the lead	yiba ngoholayo
playing field	inkundla yokudlala
point of contact	umxhumanisi wolwazi oluphathelene nomsebenzi noma wohlelo
point of order	ukukhalima ophaphalazayo
point of view	umbono
police service	usizo lwamaphoyisa
policy development	ukwenziwa kwenqubomgomo
policy environment	isimo senqubomgomo
policy formulation	ukwenziwa kwenqubomgomo
policy framework	uhlaka lwenqubomgomo
policy implementation	ukusetshenziswa kwenqubomgomo
policy making	ukwenziwa kwenqubomgomo
policy statement	isitatimende senqubomgomo
political context	isimo senqubomgomo
political control	ukulawula ngokwezombusazwe
political development	intuthuko yezombusazwe
political dispensation	isimo sokubusa ngokwezombusazwe
political environment	isimo sezombusazwe
political instability	ukungazinzi ngokwezombusazwe
political leadership	abaholi bezombusazwe
political order	uhlelo lwezombusazwe
political party	iqembu lezombusazwe
political process	inqubo yezombusazwe
political rights	amalungelo ezombusazwe
political system	uhlelo lwezombusazwe
political tradition	ukuziphatha kwabantu ngokwezombusazwe
poor living conditions	izimo ezimbi zokuphila
poorest of the poor	abampofu kakhulu
popular culture	isiko labantu ngokwezombusazwe
popular participation	ukubamba iqhaza kweningi labantu ekuthathweni kwezinqumo
popular sovereignty	igunya likahulumeni ngokuvunyelwa ngabantu
population register	ukubhaliswa kwabantu
population size	ubuningi babantu
portfolio committee	ikomidi lenhlanganiselamisebenzi
powers and functions	amandla nemisebenzi
powers that be	iziphathimandla
practical reality	isimo njengoba sinjalo
praise singer	imbongi
precincts of parliament	izakhiwo zephalamende
presiding officer	isikhulu esengamele
press freedom	inkululeko yabamaphephandaba
primary health care	ukunakekelwa ngokwempilo
private sector	imboni yabazimele
professional ethics	inkambo elungileyo ngokomsebenzi
professional organisation	inhlangano yemisebenzi efundelwe
prophets of doom	umuntu olindela okubi njalo
proportional representation	ukumeleleka kwamaqembu ngangokuvotelwa kwawo
provincial administration	ukuphathwa kwesifundazwe
provincial budget	isabelomali sesifundazwe
provincial government	uhulumeni wesifundazwe
provincial legislature	isishayamthetho sesifundazwe
provincial level	izinga lesifundazwe
provincial sphere of government	isigaba sesifundazwe sikahulumeni
provision of services	ukunikwa usizo/izidingo
public administration	ukuphathwa komphakathi
public domain	indawo ebuswayo yomphakathi
public expenditure	imali esetshenziselwa izidingo zomphakathi
public funds	imali yomphakathi
public health	ezempilo yomphakathi
public hearing	izigcawu zomphakathi
public interest	okuhlomulisa umphakathi
public meeting	umhlangano womphakathi
public money	imali yomphakathi
public office	ihhovisi lomphakathi
public opinion	izimvo zomphakathi
public participation	ukubamba iqhaza komphakathi
public policy	inqubomgomo yomphakathi
public relations officer	oxhumanisa inhlangano nomphakathi
public sector	umkhakha kahulumeni
public service	usizo lomphakathi
public services	usizo lomphakathi
public transport system	uhlelo lokuthuthwa komphakathi
public works	imisebenzi yomphakathi
public works programme	uhlelo lukaxoshindlala
pumped storage scheme	indlela yokusebenzisa amandla ukuphehla ugesi ngamanzi
put a motion	hambisa
put in writing	bhala
quality of life	impilo esezingeni elihle
question paper	iphepha lemibuzo
quota system	uhlelo lokumeleleka kwabayingcosana
race relations	ubudlelwano phakathi kwezinhlanga ezehlukene
racial equality	ukulingana ngokobuhlanga
racial segregation	ukwahlukaniswa ngokobuhlanga
rainbow nation	isizwe esinhlangaziningi
range of vision	ukukwazi ukubona ngamehlo
rapid transit system	uhlelo lwamabhasi asheshayo olususelwa kolwezitimela
redistribution of land	ukwabiwa kabusha komhlaba
reference book	incwadi kamazisi
regional integration	ukuhlanganiswa ngokupheleleyo esifundeni
register of members	ukubhalisa kwamalungu
removal from office	ukukhishwa ehhovisi
remuneration package	isamba sesinxephezelo ngomsebenzi owenziwayo
required to carry	okudingelwa ukuthwala
reside in	hlala e-
residence permit	imvume yokuhlala
resistance movement	inhlangano yomzabalazo
resistance to change	ukungavumeli uguquko
resolution of conflict	isixazululo sokungqubuzana
resource base	isisekelo senzisakusebenza
responsible for	okubhekele
restitution of land	ukubuyiswa komhlaba
restitution of land rights	ukubuyiswa kwamalungelo omhlaba
return on investment	inzuzo yotshalomali
right of access	ilungelo lokusebenzisa; ilungelo lokuthola okuthile; ilungelo lokungena
right to assemble	ilungelo lokubuthana
right to human dignity	ilungelo lesithunzi somuntu
right to life	ilungelo lempilo
right to privacy	ilungelo lokungaphazanyiswa
right to strike	ilungelo lokuteleka
right to vote	ilungelo lokuvota
rights and privileges	amalungelo emvelo nanikwa abantu abathile
rise and fall	ukuvuka nokuwa
rite of passage	umcimbi wokungeniswa kwesinye isigaba empilweni yomuntu
road network	uhleloxhumano lwemigwaqo
road show	uchungechunge lwemicimbi yokwaziswa
rule of law	umthetho obekiwe
rules and orders	imithetho nemiyalelo
rules of debate	imithetho yenkulumompikiswano
rules of natural justice	imithetho yokungabandlululwa nobulungiswa ekuqulweni kwecala
rules of procedure	imithetho yenqubo
ruling party	iqembu elibusayo
rural development	intuthuko yezindawo zasemakhaya
school library service	usizo lomtapo wezincwadi esikoleni
school nutrition programme	uhlelo lwasesikoleni lokunikezwa kwezingane ukudla
science and technology	isayensi nobuchwepheshe
search and rescue	ukucinga nohlengwa
seat of government	ikomkhulu lezwe
security clearance	ukugunyazelwa ukuthola ulwazi
security forces	amaphoyisa noma amasosha abhekele ukuvikeleka
sending and receiving	ukuthumela nokwamukela
sense of responsibility	ukuzazi izibopho zakho
sense of touch	umuzwa wokuthinta
separate but equal	okwahlukene nakuba kulingana
separate development	ukuthuthukiswa ngokwahlukana
separation of powers	ukwahlukaniswa kwamandla
services industry	imboni yokwenza imisebenzi
services rendered	imisebenzi eyenziwe
set in motion	ukunyakazisa okuthile; ukuhambisa okuthile
shortage of skills	ukuntuleka kwamakhono
sitting of parliament	ukuhlala kwephalamende
small town	idolobha elincane
social benefits	imihlomulo yomphakathi
social capital	ukuxhumana phakathi kwabantu nezikhungo, okusiza umphakathi
social change	uguquko emphakathini
social contract	isivumelwano phakathi kwamalungu omphakathi
social control	ukulawulwa komphakathi
social development	ukuthuthukiswa komphakathi
social interaction	ukuxoxisana nokusebenzisana kwabantu emphakathini
social justice	ubulungiswa ngokomnotho, nangokunikwa amathuba, nangokwamalungelo emphakathini
social movement	iqoqo labantu eligxile kwezombusazwe noma kwezenhlalakahle
social security	isibonelelo
social services	usizo lomphakathi
social system	ubudlelwano phakathi kwabantu, namaqoqo abo, nezikhungo
social upliftment	ukufukulwa komphakathi
social welfare	inhlalakahle yomphakathi
socio-economic development	ukuthuthukiswa ngokomnotho nangokwenhlalakahle
source of income	umthombo wemali engenayo
source of information	umthombo wolwazi
source of water	isisuko samanzi
sovereign democratic state	izwe elizibusayo ngokwentando yabantu
sovereign state	uzibuse
sphere of government	umkhakha kahulumeni
standard of living	izinga lokuphila
state assets	izimpahla zezwe
state emblem	uphawu lwezwe
state institutions	izikhungo zikahulumeni
state money	imali yezwe
state of emergency	umthetho wewashi
state of mind	isimo senqondo
state of the nation address	inkulumo ebhekiswe esizweni
state revenue	imali kahulumeni engenayo
status of women	isimo sabesifazane
status quo	isimo esikhona njengamanje
statute book	incwadi yezimiso
strategic management	amaqhinga okuphatha
structural violence	ukulinyazwa kwabantu yizinhlaka zomphakathi
struggle for liberation	ukuzabalazela inkululeko
subject for discussion	isihloko okuxoxwa ngaso
subject to the provisions of	ngaphansi kwemibandela ya-
substantive motion	isiphakamiso esisemqoka esizimele
supply and demand	okukhona nokudingekayo
supreme law	umthetho omkhulu
sustainable development	intuthuko esimeme
sustainable economic growth	ukukhula komnotho osimeme
sworn in	fungiswa
system of government	uhlelo lukahulumeni
systems approach	indlela yokubuka into njengengxenye yokupheleleyo
table of contents	okuqukethwe
take account of	cabanga nga-
take advantage of	sebenzisa
take an oath	funga
take cognisance of	qonda
take into consideration	naka
take off	ethula; susa
task team	ithimba eliqokelwe ukwenza umsebenzi wesikhashana
tax revenue	imali yentela engenile
technical services department	umnyango wemisebenzi yezobuchwepheshe
term budget	imali ezongena nezosetshenziswa yesikhathi esithile
term of office	isikhathi sokuphatha isikhundla
terms and conditions	imigomo nemibandela
terms of reference	okubhekwayo
terms of trade	imigomo yohwebo
the Cold War	ukucuphuluzana kwezizwe ngamazwi
the East	amazwe aseMpumalanga
the West	amazwe aseNshonalanga
the common good	okuhlomulisa wonke umuntu
the disadvantaged	abantulayo
the historically disadvantaged	ababencishwe amathuba
the masses	uquqaba
the powers that be	iziphathimandla
the right	ilungelo
the services	usizo; izidingo
the struggle	umzabalazo
the voiceless	abangenazwi
thousand and one	inkulungwane nanye
time of arrival	isikhathi sokufika
time of departure	isikhathi sokusuka
title deed	itayiteli
to and fro	kuya emuva kuye phambili
to bear fruit	ukuqhakaza isithelo
to the effect that	okusho ukuthi
top management	abaphathi abakhulu
top secret	imfihlo enkulu
total onslaught	ukuhlasela okupheleleyo ngolaka
track record	okuzuziwe esikhathini esedlule
trade relations	ubudlelwano kwezohwebo
trade union	inyunyana yabasebenzi
trading partner	okusetshenziswana naye kwezohwebo
traditional leadership	ubuholi bendabuko
traffic control	ukulawulwa kwezithuthi
training facilities	izindawo zokuqeqeshwa
training institution	isikhungo sokuqeqeshwa
transition to democracy	ukuguqukela entandweni yabantu
translation of the Bible	ukuhunyushwa kweBhayibheli
tree of knowledge	umuthi wokwazi okuhle nokubi
tree of life	umuthi wokuphila
umbrella body	inhlangano emele ezinye ezincane
unanimous concurrence	okwenzeka ngasikhathi sinye ngokuvumelana
under the auspices of	ngokwesekwa nokuvikelwa ngu-
under the authority of	ngokuphathelene na-
unemployment rate	izinga lokungaqasheki
unfair discrimination	ukubandlulula okwenzelelayo
unique people	abantu abehlukile
united nations organisation	inhlangano yezizwe
university of technology	inyuvesi yezobuchwepheshe
unreserved postal service	usizo lwaseposini olungagodliwe
up to standard	okugculisayo
upper middle class	ikilasi labantu eliphezulu ngokuphakathi nendawo
urban area	indawo yasedolobheni
urban centre	inkaba yedolobha
urban development	ukuthuthukiswa kwedolobha
urban renewal	ukuvuselelwa  kwedolobha
value system	uhlelo lobugugu
violation of human rights	ukwaphulwa kwamalungelo abantu
voice of the people	izwi labantu
vote in favour	votela
vote of thanks	izwi lokubonga
waste management	ukulawulwa kwemfucuza
ways and means	izindlela namasu
welfare state	uhlelo lukahulumeni lokuvikela impilo nenhlalakahle yazakhamizi
winds of change	ithonya noma isijwayezi esingenakuvinjelwa
winter rainfall region	indawo enemvula ebusika
with effect from	kusukela
with the sun	ngelanga
with the wind	ngomoya
within a radius of	ibanga ukusuka enkabeni
within the limits	ngokungeqile
word of welcome	amazwi okwamukela
working group	iqoqo labasebenzayo
world community	umphakathi womhlaba wonke
you are here	ulapha