AG	AG;  Molekodipharephare wa dipuku tša ditšhelete; 
APRIL	APRELE;  MORANANG; 
AU	AU;  Mokgatlo wa Selekane sa Afrika; 
Africa	Afrika; 
Africa's	ya Afrika; 
African-American	MoAfrika wa MoAmerika; 
Africans	MaAfrika; 
America	Amerika; 
American	MoAmerika; 
Apr	 Moranang; Aprele; 
April	 Moranang; Aprele; 
Arab	Moarabia; 
Asia	Ešia; 
Asian	MoEšia; 
Audios	 tša mantšu; Medumo;  tša medumo; 
Auditor	Molekodi wa dipuku tša ditšhelete; 
Ave	Abenyu; Lefelo; 
Baba	Tate; 
Bantu	Batho; 
Bay	Lebopo; 
Beginner's	Ya Bathomi; 
Boer	Leburu; 
Brazil	Brazili; 
Britain	Prithani; 
British	ya Prithani; 
CEOs	Bahlankedibagolophethiši; 
CHAN	CHAN;  Sebjana sa Kgele ya Maoto sa Afrika; 
CPT	Cape Town; 
Canada	Kanada; 
Cannes	Mahlakanoka; 
Caribbean	ya Kharibea; 
Carnegie	Kanetše; 
Castle	Ntlokgolo; 
Chairman	Modulasetulo; 
Chinese	Motšhaena; 
Christian	Sekriste;  Mokriste; 
Christmas	Krisemose; 
Clerks	 Bomapalane; Bangwaledi; 
Commissioner	Mokhomišenare; 
Confederations	Dikhonfetereišene; Mekgatlo; 
Counsellor	Mokhanselara; 
DBE	Kgoro ya Thuto ya Motheo; 
DECEMBER	DESEMERE;  MANTHOLE; 
DG	Molaodipharephare; 
Dec	Desemere;  Manthole; 
December	Desemere; 
Deregister	Ngwadišolla; Phumola; 
Dome	Toumo; Thulelokgokolo; 
Dominican	MoTominikhene; 
Dr	Ngaka; 
Dutch	Seholanere; 
England	Engelane; 
English	Sekgowa; 
Europe	 Europa; Yuropa; 
European	Lekgowa; 
Excellency	Mohlomphegi; 
FRIDAY	LABOHLANO; 
Feb	Hlakola;  Feberware; 
February	 Hlakola; Feberware; 
Federal	Feterale; Bofeterale; 
Filter	sefa; 
Fort	Sebo; 
French	Sefora; Mofora; 
Friday	Labohlano; 
Fridays	BoLabohlano; MaLabohlano; 
GDP	 Palomoka ya Letseno la ka Nageng; GDP; 
Gazette	Kuranta; 
German	Mojeremane; 
Germany	Jeremane; 
Glossary	Mananeontšu; 
God	Modimo; 
Guardian	Mohlokomedi; 
HIV-positive	HIV phosethifi;  wa go ba le HIV; 
Handbook	 Puku ye nnyane; pukwana; 
Hawks	Dipekwa; 
Hon	Mohlomphegi; 
I'm	ke; 
ICT	Theknolotši ya Kgokagano ya Tshedimošo; 
Indian	MoIndia; 
Infecting	fetetša; 
Inga	Inga ; 
Interjections	malahlelwa; 
Islam	tumelo ya Boislamo;  Seselamose; 
Islamic	MoIslamo; Islamo; SeIslamo; 
JANUARY	PHEREKGONG;  JANEWARE; 
JULY	JULAE;  PHUPU; 
JUNE	 JUNE; NGWATOBOŠEGO; 
Jan	 Pherekgong; Janeware; 
January	Janaware; 
Japan	Japane; 
Jewish	Sejuta; Mojuta; 
Jul	Julae;  Phupu; 
July	Julae; 
Jun	Mosegamanye;  June; 
Keyword	lentšu le bohlokwa; 
Lotteries	Dillotho; 
Lotto	Llotho; 
MONDAY	MOŠUPOLOGO; 
MP	Leloko la Palamente; 
MPs	Maloko a Palamente; 
MR	MNA; 
Madam	Mme;  Mohumagadi; 
Mama	Mme;  Mma; 
Mandela's	ya Mandela; 
Mar	Matšhe; 
Mayor	Meyara; Ratoropo; 
Meanwhile	Le ge go le bjale; 
Methodist	wa Methodist; 
Monday	Mošupologo; 
Moses	Moše; 
Mourns	llela;  Hloboga; 
Mr	Mna; 
Mrs	Mohumagadi; 
NCR	Molaodi wa Dikoloto wa Bosetšhaba; 
NOVEMBER	DIBATSELA;  NOFEMERE; 
Natal	Natala; 
Ndebele	Setebele; 
Nigerian	Modudi wa Nigeria; 
Nobel	Tlhompho; 
Nov	Nofemere; Dibatsela; 
November	Nofemere; 
OCTOBER	DIPHALANA; OKTOBORO; 
Oct	Diphalana; Oktoboro; 
October	Oktoboro;  Oktobere; 
Offender's	Ya mosenyi; 
Oliphant	Lepelle; 
Olympic	Olimphiki; 
Olympics	Diolimphiki; 
PACs	bo-PAC; 
PC	Khomphutha; 
Palestine	Palestina; 
Pan	Ka moka; 
Parliament's	ba Palamente;  ya Palamente; 
Paul	Poulo; 
Postpones	Fega; 
Presidency	Kantoro ya Mopresidente; 
President's	ya Mopresidente; 
Prince	Morwa wa kgoši; 
Prof	Moprofesara; 
Protector	Mošireletši; 
RSVP	Beeletša madulo; 
Registrar	Mongwadiši; 
Rejoice	thaba;  Thakgala; 
Riverside	 Khwiting; Lebopong; 
Russia	Russia ; 
Russian	Mo-Rašia; 
SA	Afrika Borwa; 
SAPS	Tirelo ya Maphodisa ya Afrika Borwa; 
SCOPA	Komiti ya Nakwana ya Diakhaonte tša Setšhaba; 
SEPTEMBER	SETEMERE;  LEWEDI; 
San	Masane; 
Saturday	Mokibelo; 
Secretariat	Bongwaledi; 
Secretaries	Bangwaledi; 
Secretaries-General	Bangwaledipharephare; 
Self-Governance	Boipušo bja Naga;  Boipušo; 
Senate	senate; 
Sep	Lewedi;  Setemere; 
September	Setemere; 
Skip	 Tshela; feta; 
Surname	Sefane; 
Swaziland	Swatseng; 
Switchboard	Lefelokamogelomegala; 
TUESDAY	LABOBEDI; 
TV	Thelebišene; 
Tata	Tate; 
Thursday	Labone; 
Transvaal	Transefala; 
Tuesday	Labobedi; 
UNESCO	UNESCO;  Dithuto, Mahlale le Setšo tša Mokgatlo wa Dinagakopano ; 
Unsubscribe	Ngwadišolla; phumola; 
Venda	Sevenda; 
Venice	Benise; 
WEDNESDAY	LABORARO; 
Wednesday	Laboraro; 
Xhosa	Sethosa; 
York	mothobe; 
Zimbabwean	Modudi wa Zimbabwe; 
Zulu	Mozulu; 
ability	bokgoni;  go kgona; 
able	kgona; 
about	ka ga;  mabapi le; 
above	ka godimo; 
above-mentioned	 tše filwego ka godimo; tše boletšwego ka godimo; 
abroad	moše wa mawatle; 
absence	 go se be gona; tlhokego; 
absent	hlokega;  hlokegago; 
absolute	noši; 
abuse	 tlaiša; tlhorišo;  diriša gampe; 
abused	hlorišitšwe; dirišitšwe gampe;  tlaišitšwe; 
academia	dirutegi; 
academic	(ya) thuto; 
academics	diserutegi; diakatemiki; ya thuto; 
academies	dikolo;  dihlongwa tša thuto; 
academy	sekolo;  sehlongwa sa thuto; 
accelerate	akgofiša; 
accelerated	akgofiša; 
accelerating	akgofiša; 
accept	amogela; 
acceptable	amogelega; 
acceptance	kamogelo; 
accepted	amogetše; 
accepting	amogela; 
access	 tseno; humana; 
accessed	humane; tsene;  fihleletše; 
accessibility	 khwetšagalo; phihlelelo; 
accessible	fihlelelega; 
accession	thotogelo; namela; 
accident	kotsi; 
accidents	dikotsi; 
acclaim	tsebega;  reta; 
acclaimed	retile;  tsebegile; 
accommodate	 fa madulo; amogela; 
accommodation	bodulo;  potielo; 
accompanied	bapetše;  kibetše;  felegeditše; 
accompany	bapa;  kibela;  felegetša; 
accomplish	phetha; 
accomplished	phethile; 
accord	 hlompha;  bea; fa; 
accordance	tumelelano; 
accorded	file;  hlomphile;  beile; 
according	mabapi le; 
accordingly	ka fao; 
account	tšhupaletlotlo;  tšhupamolato; 
accountability	boikarabelo; 
accountable	wa boikarabelo; 
accountants	bašomibašhupatlotlo; 
accounted	tšhupamolato; arabetše matlotlong; 
accounting	sešupatlotlo; 
accounts	ditšhupamolato; ditšhupaletlotlo; 
accreditation	dumelela;  ngwadiša; 
accredited	dumeletše;  ngwadišitše; 
accruals	ditšhelete tše amogelwago; 
accrue	-diragatša; 
accrued	hweditše; itemogetše; 
accumulate	kgobela; 
accumulated	kgobetše; 
accuracy	nepagalo;  go nepa; 
accurate	 nepagetšego; nepegilego; 
achieve	fihlelela; 
achieved	fihleletše; 
achievement	phihlelelo; 
achievements	diphihlelelo; 
achieving	fihlelela; 
acknowledge	dumela; 
acknowledged	dumetše; 
acknowledges	dumela; 
acquire	hwetša; 
acquired	hweditše; 
acquisition	kgopelo;  go nyaka;  khwetšo; 
across	putlaganya; 
act	molao;  diragatša;  tiro;  tema (tiragatšo); 
acted	 dirišitšwe;  ralokile tema;  diragaditšwe;  kgathile tema (tiragatšo); dirilwe; 
acting	swarelago; 
action	tiro; 
actions	ditiro; 
active	tiro;  mafolofolo; 
actively	ka mafolofolo; 
activism	lesolo la mafolofolo;  ntwa ka mafolofolo; 
activist	mohlohleletši; 
activists	mohlohleletši; 
activities	 mešomo; ditiro;  mediro; 
activity	 mošomo; tiro; 
actor	sebapadi;  modiragatši; 
actors	baraloki;  dibapadi;  badiragatši; 
actress	modiragatši wa mosadi; 
acts	 dirišitšwe;  diragaditšwe; dirilwe;  tema (tiragatšo); 
actual	kgokgo; 
actually	gabotse; 
ad	papatšo; 
ad-hoc	ya nakwana; 
adaptation	kamantšho; 
add	hlakanya;  oketša; 
added	 hlakantše; okeditše;  tsentše; 
adding	yaoketša; ya hlakanya; 
addition	go hlakantšha; 
additional	oketšago; 
address	atrese; 
addressed	rometšwe; 
addresses	diatrese; 
addressing	botša;  bolediša; 
adds	hlakanya;  oketša; 
adequate	lekanego; 
adequately	ka mo go swanetšego;  ka maleba; 
adhere	obamela; 
adherence	kobamelo; 
adjourned	tswalela;  phatlalatša; 
adjudication	 ahlola;  sekaseka; lekola; 
adjust	lefa;  lokiša; 
adjusted	 lokišitše; lefile; 
adjustment	pušetšomadulong;  tokišo; 
adjustments	ditokišo; dipušetšosekeng; dipušetšomadulong; 
administer	 buša; laola; 
administered	laotše;  bušitše; 
administering	 buša; laola; 
administration	taolo;  tiragatšo; 
administrations	 ditshepedišo;  ditiragatšo; ditaolo; 
administrative	ya tshepedišo;  ya taolo; 
administrator	 mmušakarolo (wa profense); modiragatši; 
administrators	babušakarolo (ba profense); 
admissible	wa go dumela; 
admission	 tumelo;  ipona molato; kamogelo; 
admit	dumelela; 
admitted	dumeletše; 
adopt	 godiša ngwana; godiša; 
adopted	godišitše ngwana;  amogetše; 
adopting	 godišitše; godišitše ngwana; 
adoption	 kgodišo ya ngwana;  tirišo; amogela; 
adoptive	wa go amogela' wa go godiša ngwana; 
adopts	 godiša ngwana; godiša; 
adult	mogolo; 
adults	bagolo; 
advance	 tšwelopele; tšwela pele; 
advanced	phagameng; 
advancement	tšwelopele; 
advances	ditšwetšopele;  tšwela pele; 
advancing	 tšwelopele; tšwela pele; 
advantage	mohola; 
advantages	mehola; 
advent	go fihla;  go goroga;  go tšwelela;  go tsena; 
adverse	 ya tšhitišo; ya lepheko;  ya go se nyakege;  ya thibelo; 
adversely	 ka thibelo; ka tšhitišo; 
adversity	maemo a boima; 
advertise	kwalakwatša; 
advertised	kwalakwaditšwe; bapaditšwe; 
advertisement	papatšo;  tsebiši; 
advertising	go kwalakwatša; 
advice	keletšo; 
advise	 loma tsebe;  keletšo; eletša; 
advised	hlahlile;  eleditše;  lomile tsebe; 
adviser	 molomatsebe;  moeletši; mohlahli; 
advisers	 baeletši;  balomatsebe; bahlahli; 
advisor	moeletši; 
advisories	dikeletšo; 
advisors	 baeletši;  balomatsebe; bahlahli; 
advisory	keletšo; 
advocacy	boemedi; 
advocate	 mmoleledi; bolelela; 
advocates	 baboleledi; bolelela; 
affairs	 merero; ditaba; 
affect	 huetša; ama; 
affected	angwa; 
affecting	 huetša; ama; 
affects	 huetša; ama; 
affidavit	afidabiti/afidaviti; 
affirm	 tiišetša; tiiša; 
affirmation	kgonthišo; 
affirming	 tiišetša; tiiša; 
afford	kgona; 
affordable	ya go kgonega; 
afforded	kgonne; 
aforementioned	 tše filwego ka godimo; tše boletšwego ka godimo; 
aforesaid	tše boletšwego ka godimo; 
after	morago; 
afternoon	thapama; 
again	gape; 
against	kgahlanong le;  go bapela le; 
age	 mehla; ngwaga;  mengwaga;  gola; 
aged	gotše;  tšofetše;  wa mengwaga ye; 
agencies	dihlongwa;  ditheo; dietšentshi; 
agency	etšentshi; setheo; sehlongwa; 
agent	 sedirišwa; sediri;  mmaditsela;  morekišetši; 
agents	 didiri;  bommaditsela; dikatišani;  barekišetši; difetoši; badiredi;  didirišwa; 
ages	 mehleng; mengwaga;  gola; 
aggregate	palogare; 
aggrieved	kgopišegilego; 
ago	kgale;  kgalekgale; 
agree	kwana ka kgopolo; 
agreed	kwane ka kgopolo; 
agreement	 tumelelano; kwano; 
agreements	 ditumelelano; dikwano; 
agrees	kwana ka kgopolo; 
agricultural	bolemi; 
agriculture	bolemi; 
ahead	 godimo;  pejana; pele; 
aid	thuša;  thušo; 
aids	thuša;  dithušo; 
aim	 maikemišetšo; tebanyo;  nepa; 
aimed	nepile;  lebantše;  nepišitše;  ikemišeditše; 
aims	 maikemišetšo;  nepa; ditebanyo; 
air	 anega; moya;  leratadi; 
aircraft	sefofane; 
airport	boemafofane; 
airports	maemafofane; 
al	ka ga;  mabapi le; 
albeit	le ge go le bjale;  ka fao; 
alcohol	 setagi; tagi; 
alert	phafogilego;  phafogileng; 
alia	ka ga;  mabapi le; 
aligned	tsepantše; 
alike	swana;  go swana le;  go swana; 
alive	 phetše; phela; 
all	 ka moka; bohle; 
allegation	naganelo; pharomolato; kgopolelo; 
allegations	dipharomolato; dikgopolelo; dinaganelo; 
alleged	naganela;  naganetše; 
allegedly	go naganelwa gore; 
alleviate	kaonafatša; 
alleviation	 fediša; tloša; 
alliance	kgwerano; 
allocate	aba; 
allocated	 abetše; abile; 
allocation	kabo; 
allocations	dikabo; 
allow	dumelela;  ngwadiša; 
allowance	putseletšo; 
allowances	diputseletšo; 
allowed	file tumelelo;  dumeletše; 
allowing	dumelela; 
allows	dumelela; 
almost	 nyakile;  kgauswinyana; kgauswi; 
alone	noši; 
along	go sepelelana le;  gotee le; 
alongside	mmogo le;  gotee le;  go bapela le; 
already	šetše; 
also	gape; 
alter	fetola;  fetoša; 
alternate	hlatlolanago;  hlatlolana; 
alternative	 ya boikgethelo; kgetho; 
although	le ge go le bjale;  ka fao; 
always	dula;  ka mehla; 
am	mesong; 
ambassador	motseta; 
ambassadors	batseta; 
ambient	ampiente; 
ambit	lehwafa; 
amend	fetoša; 
amended	fetošitše; 
amending	fetoša; 
amendment	phetošo; 
amendments	diphetošo; 
amends	fetoša; 
ammunition	dikolo; 
amnesty	 tshwarelo ya basenyi; tokollo; 
among	 magareng ga;  gareng ga; gare; 
amongst	magareng ga;  gareng ga; 
amount	fihla;  bokaalo; 
amounted	 fihlile go; fihletše; 
amounting	fihla;  fihlile go; 
amounts	fihla;  fihlile; dikgoboko; 
an	ya;  wa; 
analogue	manakana; 
analyse	sekaseka;  lokolla; 
analysed	lokollotše; sekasekile; 
analysing	sekaseka;  lokolla; 
analysis	molokollo; 
ancestor	badimo;  mogologolo; 
ancestors	 bagologolo; badimo; 
ancient	bogologolo; 
and	le;  gomme; 
animal	sebata;  phoofolo; 
animals	diphoofolo; 
animation	kekišo;  go ekiša; 
annex	thopa; 
annexure	koketšo; 
anniversary	segopotšo sa ngwana; 
announce	bega; 
announced	begile; 
announcement	pego; 
announcements	dipego; 
announces	bega; 
annual	ka ngwaga;  sa ngwaga; 
annually	 ngwaga o mongwe le o mongwe; ka ngwaga; 
annum	ngwaga; 
another	-nngwe; 
answer	karabo; 
answers	dikarabo; 
antenatal	pele ga pelego;  ya pele ga pelego; 
anthem	koša ya setšhaba; 
anti-corruption	twantšho ya bomenetša; twantšhoboradia; twantšhobofora; twantšhobomenetša; 
anti-pass	kgahlanong le dipasa;  kganetšo ya go putla; 
anticipated	letile;  emetše; 
any	efe goba efe;  efe le efe; 
anyone	 motho ofe goba ofe;  ofe le ofe;  ofe goba ofe; motho ofe le ofe; 
anything	sefe goba sefe;  selo sefe le sefe;  sefe le sefe;  selo sefe goba sefe; 
apart	thoko; 
apartheid	kgethollo; 
apparent	bonagala; 
appeal	ipiletša;  boipiletšo;  boipelaetšo; 
appealed	ipelaeditše; ipileditše; 
appeals	ipiletša;  boipiletšo;  boipelaetšo; 
appear	bonagala;  tšwelela; 
appearance	ponagalo;  iponagatša;  tebelelego; 
appeared	 bonagetše; tšweletšwe; 
appearing	bonagala;  tšwelela; 
appears	bonagala;  tšwelela; 
appendix	lelana;  mametletšo; 
applaud	 tebogišo; go reta;  phaphatha diatla; 
applause	phaphathela diatla; reta;  lebogiša; 
applicable	swanelago; 
applicant	mokgopedi; 
applicants	bakgopedi; 
application	 tiragatšo;  tirišo; kgopelo; 
applications	mananeotirišo; dikgopelo;  ditiragatšo;  ditirišo; 
applied	lediredi;  dirišitšwego; 
applies	dira kgopelo; 
apply	kgopela; 
applying	kgopela; 
appoint	bea; 
appointed	beile; 
appointing	bea; 
appointment	peo;  peano; 
appointments	bao ba thwetšwego;  bao ba thwalwago; 
appoints	bea;  thwala; 
appreciate	leboga;  thabela; 
appreciated	lebogile;  thabetše; 
appreciates	leboga;  thabela; 
approach	hlaka;  lebanya;  tebanyo; 
approached	lebantše; 
approaches	 ditebanyo; hlaka;  lebanya; 
appropriate	lebaneng; 
appropriated	lebantšhitšwego; 
appropriately	ka mo go swanetšego;  ka maleba; 
appropriation	tekanyetšo; 
appropriations	ditekanyetšo; 
approval	 tumelo; tumelelo; 
approve	dumelela; 
approved	dumeletše; 
approximately	 (ka) tekanyetšo; kabago; 
arbitration	bolamodi; 
arbitrator	molamodi; 
architect	raboagi; 
architects	bathaladipolane; moatšhiteke; 
architectural	ya bothalapolane; ya bothadi; 
architecture	thutaboagi; 
archival	ya go bolokwa; 
archive	boloka; sebolokwa; 
area	 seripa sa sekgoba; tikologo;  sekgoba; 
areas	mafelo;  diripa tša sekgoba;  dikgoba;  ditikologo; 
arena	bohlabanelo; 
argue	poledišano; 
argued	boledišane; 
argument	ngangišano; 
arguments	dingangišano; 
arise	feletša ka;  tšwelela; 
arises	feletša ka;  tšwelela; 
arising	feletša ka;  tšwelela; 
arm	letsogo; 
armed	itlhamile; 
arms	dibetša; 
arose	 bakilwe;  feleditše ka; tšweletše; 
around	go dikologa; 
arrange	beakanya; 
arranged	beakantšwe; 
arrangement	peakanyo; 
arrangements	dipeakanyo; 
array	tokologanyo; 
arrest	swara; 
arrested	sware; 
arrival	kgorogo; 
arrive	fihla;  goroga; 
arrived	 gorogile; fihlile; 
art	bokgabo; 
artefacts	bokgabo; 
article	selo;  sengwalwa;  temana; 
articles	 dingwalwa;  ditemana; dilo; 
articulate	bolela; 
articulated	boletše; 
artist	sekgabiši; 
artistic	 -botaki; kgabišago; 
artists	bakgabiši;  dikgabiši; bakgabi; 
arts	bokgabo; 
artwork	mošomo wa botaki;  mošomo wa bokgabo; 
artworks	mešomo ya botaki;  mešomo ya bokgabo; 
as	go swana le;  bjalo ka; 
ascertain	 netefatša; kgonthiša; 
aside	ka thoko; 
ask	botšiša; 
asked	botšišitše; 
asking	botšiša; 
asks	botšiša; 
aspect	lehlakore; 
aspects	mahlakore; 
aspirations	diputšwetšo; 
assault	go gobatša; 
assembly	lekgotla;  kgobokano;  phuthego; 
assented	nameletše;  nametše; 
assert	bolela;  gatelela; 
assess	 lekanyetša; lekanya; 
assessed	lekantše;  lekanyeditše; 
assesses	 lekanyetša;  lekanya; sekaseka; 
assessing	 lekanyetša;  lekanya; sekaseka; 
assessment	tekanyo; 
assessments	ditekanyo; 
assessor	moahlodiši; 
assessors	basekaseki; 
asset	thoto; 
assets	letlotlo; 
assign	fa;  romela; 
assigned	file;  rometše; 
assignment	mošomo; 
assist	thuša; 
assistance	thušo; 
assistant	mothuši; 
assisted	thušitše; 
assisting	thuša; 
assists	thuša; 
associate	tswalanya;  swantšha; 
associated	tswalantše; swantšhitše; amantše; 
association	lekgotla;  mokgatlo; 
associations	 makgotla; mekgatlo; 
assume	 thomiša; nagana;  tšea gore; 
assumed	naganne;  tšere gore;  thomišitše; 
assumptions	dikgopolelo; dinaganelo; 
assurance	 netefatšo; tiišetšo; 
assure	 netefatša; kgonthiša; 
assured	kgonthišišitše; netefaditše; 
astronomy	thutadinaledi; 
at	 ka; go; 
athletics	 atletiki; diatletiki; 
atmosphere	lefaufau; 
atmospheric	 ya lefaufau; ya atmosfere; 
attach	 kgomagantšha; thopa; 
attached	kgomagantšhitše; thopile; 
attachment	mametletšo; 
attack	gatelela;  hlasela;  tlhaselo; 
attacks	 ditlhaselo; gatelela;  hlasela; 
attain	hwetša; 
attained	hweditše; 
attainment	phihlelelo;  khwetšo; 
attempt	 teko; leka; 
attempted	iteketše; lekile; 
attempts	 diteko; leka; 
attend	tsena; 
attendance	tseno; 
attended	tsene; 
attending	tsena; 
attention	 šedi; tlhokomelo; 
attitude	 moya; mokgwa; 
attitudes	mekgwa; meboya; 
attorney	ramolao; 
attorney-general	ratshekišo; 
attorneys	boramolao; 
attract	gogela; 
attracted	gogetše; 
attribute	sehlaodi;  bohlaodi; 
attributed	hlaoletše;  hlaotše; 
au	mokgatlo wa selekane sa afrika; 
auction	fantisi; 
audience	batheeletši; 
audiences	batheeletši; batheetši; 
audio	 ya medumo;  ya mantšu; medumo; 
audio-visual	ya go kwewa le go bonwa;  go kwewa le go bonwa; 
audiovisual	ya medumo ya go bonwa; 
audit	hlakiša; 
audited	hlakišitše; hlakišitšwe; 
auditing	 tlhakišo; hlakiša; 
auditor	mohlakiši; 
auditor-general	Molekodipharephare wa dipuku tša ditšhelete; 
auditors	bahlakiši; 
audits	 tlhakišo; hlakiša; 
august	phato; agostose; 
auspices	 dithušo; dithekgo; 
authentic	ya makhonthe;  ya kgonthe; ya mannete; 
author	mongwadi; 
authorisation	tumelelo; 
authorise	dumelela; 
authorised	dumeletšwego; 
authorities	maatla;  ditsebi;  mebušo;  balaodi;  bolaodi; bataolo; 
authority	 setsebitsebi;  mmušo; maatla;  molaodi;  bolaodi; 
authorization	tumelelo; 
authorize	dumelela; 
authorized	dumeletše; 
authors	bangwadi; 
automated	itiriša; ya maitirišo; itirišitše; 
automatic	itirišago;  go itiriša; 
automatically	ka go itiriša; 
availability	go hwetšagala;  go ba gona; 
available	hwetšegago; 
avenue	mokgothana; 
avenues	mekgothana; 
average	palogare;  (a) palogare; 
aviation	bofofane; 
avoid	phema; 
avoidance	go efoga; 
awaiting	letile;  emetše; 
award	sefoka; 
awarded	abile sefoka; 
awarding	aba difoka; 
awards	difoka; 
aware	tseba; 
awareness	 temošo; temogo; 
away	kgole;  tlogile;  sepetše; 
babies	masea; 
baby	lesea; 
back	 ka ntle ga seatla;  magetla;  ka morago ga molala;  kutu ya leleme; morago; 
backdrop	poelomorago;  boela morago; 
background	bokamorago; 
backgrounds	botšo; bokamorago; 
backlog	šalela morago; tšhalelomorago; 
backlogs	ditšhalelomorago; 
bad	 šoro; mpe; 
bag	mokotla; 
bail	peile; 
bake	paka; 
baking	paka; 
balance	tekatekano;  tekatekanyo;  papetšo;  tekanyetšo;  tšhelete ye e šetšeng;  bapetša;  sekala; 
balanced	 lekanetše; itekanetše; 
balances	 ditekanyetšo; ditekatekano; dikala;  ditšhelete tše šetšeng; ditekatekanyo; dipapetšo; 
ball	kgato;  nkgokolo; 
band	 sehlopha sa mmino; lepanta;  sehlopha sa baletši; 
bank	panka;  leriba; 
banking	kgotšo; 
banks	 mariba; dipanka; 
baobab	seboi; 
bar	 para; lepheko;  para ya mmino; 
bargain	thekofase; 
bargaining	rerišanela thekofase; 
barrier	lepheko; 
barriers	mapheko; 
base	 letlase la khutlotharo;  sematlafatšwa; motheo; 
based	 letlase la khutlotharo; peise; theilwe;  sematlafatšwa; motheopalo; 
baseline	motheo; 
basic	theo; 
basics	metheo; 
basis	theo; 
basket	seroto; 
battle	ntwa;  tlhabano; 
bay	kou; 
be	ba; 
beaches	dikhwitiwatle; 
bear	bera;  bere; 
bearer	morwadi;  mohlagiši; 
bearers	bahlagiši; barwadi; 
bears	 dibere; dibera; 
beautiful	 kgahliša;  botsana; bose; 
beauty	botse; 
became	go ba; 
because	gobane;  ka lebaka la; 
become	go ba; 
becomes	go ba; 
becoming	go ba; 
bed	malao; 
beds	 mepete; malao; 
been	bile; 
beer	piri; 
before	pele ga; 
began	thomile;  thomišitše; 
begin	 thomiša; thoma; 
beginning	mathomong; 
begins	 thomiša; thoma; 
begun	thomile;  thomišitše; 
behalf	legatong; 
behaviour	maitshwaro;  boitshwaro; 
behind	morago ga; 
being	ba;  go ba; 
beings	batho;  diphedi; 
belief	tumelo; 
beliefs	ditumelo; 
believe	dumela; 
believed	dumetše; 
believes	dumela; 
believing	dumela;  go dumela; 
belong	wa;  wela ka; 
belonging	wa;  wela ka; 
belongs	wa;  wela ka; 
beloved	yo a rategago; 
below	ka fase; 
benchmark	motheo; 
beneficial	 ya moholegi; ya kholego; 
beneficiaries	baholegi; 
beneficiary	moholegi; 
benefit	mohola;  hola; 
benefited	holegile; 
benefits	mehola;  hola; 
best	kaone kudu; 
better	kaone;  bokaone; 
between	 magareng; gare; 
beyond	ka morago ga;  go putla;  go feta; 
bid	phenkgišano; 
bidder	mophenkgišani; 
bidders	baphenkgišani; 
bids	diphenkgišano; 
biennale	Moletlo wa gabedi ka ngwaga; 
big	kgolo; 
bigger	kgolwane; 
biggest	kgolokgolo; 
bilateral	ya dihlongwa tše pedi;  ya bobedi;  ya dinaga tše pedi; 
bill	 molaokakanywa; romela;  tšhupamolato; 
billion	bilione; 
bills	 melaokakanywa;  ditšhupamolato; romela;  melomo ya nonyana; 
bind	ruma;  swaraganya; 
binding	mophetho; 
bingo	pinko; 
biological	ya tswalo; ya tlhago; 
bird	nonyana; 
birds	dinonyana; 
birth	pelego; 
birthday	tšatši la matswalo; 
black	boso; 
blacks	boso; 
blind	 foufala;  foufatša; sefofu;  foufetšego; 
block	ploko; 
blood	madi;  tshepelo ya madi; 
blue	 polousela; talalerata; 
board	lekgotla;  phaphathi;  papetla; 
boards	diboto;  dipapetla; makgotla; 
boasts	diketswana; 
bodies	mebele; 
bodily	ya mmele;  ya mmeleng; 
body	 teteano ya sopo; mmele; 
bold	thata;  tia;  ntsho;  tiile; 
bond	pofo; 
bonds	dipofo; 
book	puku; 
books	dipuku; 
boom	katlego; 
boost	thekga;  ikgantšha; 
border	mollwane;  leši;  ruma; 
borders	maši; mellwane;  ruma; 
born	belegwe; 
borne	etše hloko;  gopotše; 
borrow	adima; 
borrowing	adima; 
botanical	ya serapa;  ya dimela; 
both	bobedi; 
bottom	 botlase; fase; 
bought	rekile; 
bound	 swaragantše; rumile; 
boundaries	mellwane; 
boundary	mollwane; 
box	lepokisi;  tia ka letswele; 
boy	mošemanyana;  mošemane; 
boys	 bašemanyana; bašemane; 
brackets	mašakana; 
braille	mongwalo wa difofu; 
branch	 thabe;  aroga; lekala;  arogana;  motšwana; 
branches	 metšwana;  dithabe;  aroga; makala;  arogana; 
brand	 leswao la kgwebo; seka sa kgwebo; 
brave	bogale;  wa go se tšhoge;  wa go se boife; 
bravery	go ba le sebete; 
breach	 leporogo; tshela; pšhatla;  phatlola; 
breadth	bophara; 
break	 roba;  kotofalo ya lentšu; kgaola; 
breakdown	tshenyego;  thobego; 
breakfast	difihlolo;  sefihlolo;  phihlolo; 
breaking	ngwatha senkgwa; 
breakthrough	 kutollo; utolla;  tšwelela; 
bridge	moratho; 
bridging	dira moratho; 
brief	lemoša; 
briefed	lemošitše; 
briefing	go lemoša; 
briefly	ka bokopana; 
briefs	lemoša; 
bring	tliša; 
bringing	 wa tliša; tliša; 
brings	tliša; 
broad	ya phaphathi; 
broad-based	ye akaretšago mang le mang; ye akarešago bohle; 
broadband	protepente; 
broadcast	kgašo;  gaša; 
broadcaster	mogaši; 
broadcasters	bagaši; 
broadcasting	kgašo; 
broaden	 dira mphara;  dira pepetla;  dira phaphathi;  oketša; katološa; 
broadening	 oketša; katološa; 
broader	ya phaphathi; 
broadly	ka pepetla;  ka bophara; 
brochure	pukwana; 
brochures	dipukwana; diporoutšha; 
bronze	pronse; 
brother	morwarra; 
brothers	barwarra; 
brought	 tlišitše; tlišitšwe; 
brutal	sehlogo; 
brutality	sehlogo;  bošoro; 
budget	 go lekanyetša; dikakanyo;  tekanyetšo; 
budgetary	 ya ditekanyetšo; ya go lekanyetšwa; 
budgeted	 lekanyeditše; akanyeditše; 
budgeting	go lekanyetša;  lekanyetša; 
budgets	 go lekanyetša; dikakanyo;  ditekanyetšo; 
buffalo	nare; 
build	aga; 
build-up	 kokotlela; kago;  oketšega; 
building	moago; 
buildings	meago; 
built	agile; 
bulk	 sehlophana; sehlopha; 
burden	morwalo; 
buried	bolokile; 
burning	 tukago;  tuka; swa;  tšhumago; 
bursaries	dipasari; 
bursary	pasari; 
bury	boloka; 
bus	pese; 
business	kgwebo; 
businesses	dikgwebo; 
bust	sebetlwa sa hlogo le magetla a motho; 
busy	šomago; 
but	 efela; empa;  eupša; 
buy	reka; 
by	 ke; ka; 
cabinet	kabinete; 
calculate	bala;  šoma; 
calculated	badile;  šomile;  hlakantše; 
calculating	 badile; omile; 
calculation	palelo; 
calendar	tšhupamabaka; 
call	 bitša;  letša; mogala; 
called	letšeditše; biditše; 
calling	pitšo; 
calls	 bitša; megala; 
came	tlile; 
camp	kampa; 
campaign	lesolo;  kwalakwatšo ya dikgetho; 
campaigns	 dikwalakwatšo tša dikgetho; masolo; 
camps	dikampa; 
campus	khamphase; 
campuses	dikhamphase; 
can	khena; 
can't	e ka se;  a ka se; 
cancel	bolaya;  khansela; 
cancellation	go phumola; 
cancelled	khansetše; bolaile; 
cancer	kankere; 
candidate	 mohlahlobiwa;  nkgetheng; molekwa; 
candidates	balekwa;  bonkgetheng; bahlahlobja; 
cannot	e ka se;  a ka se; 
cant	e ka se;  a ka se; 
cap	tlhompho ya kgathotema papading ya bosetšhaba;  mmese; 
capabilities	bokgoni;  mabokgoni; 
capability	bokgoni;  tsebo; 
capable	kgona; 
capacities	maatla;  boteng; methamo; 
capacity	maatla;  boteng;  mothamo; 
capacity-building	kabo ya bokgoni; 
cape	kapa; 
capita	ka motho; 
capital	 mošate; letlotlo; 
caps	dimmese; ditlhompho tša kgathotema papading ya bosetšhaba; 
capture	thopa; 
captured	 thopilwe, thopša; thopile; 
captures	thopa; 
car	koloi; 
carbon	khapone; 
card	karata; 
cards	dikarata; 
care	 hlokomela; tlhokomelo; 
career	 boiphedišo; modiro; 
careers	 mešomo; mediro; 
careful	ka tlhokomelo; 
carefully	 ka tlhokomelo; ka šedi; 
cargo	morwalo; 
caring	hlokomela;  go hlokomela; 
carpet	legogwa;  mmete;  tapeiti; 
carried	rwele;  tšerwe;  nameditšwe; 
carries	 rwele; rwala; 
carry	rwala; 
carrying	phetišetšo ya dipalo; 
case	molato; 
cases	melato; 
cash	tšhelete; 
cast	mohlala; 
catalogue	kataloko; 
catch	 tšea; swara;  tanya; 
categories	 magoro; dikgoro; 
category	kgoro;  legoro; 
cater	fepa;  hlokomela; fepa ka dijo;  akaretša; 
catering	fepa ka dijo; 
cattle	dikgomo; 
cause	 sebakwa; lebaka; 
caused	bakilwe; 
causes	 dibakwa; dibaki; 
causing	 se bakago; sebakwa; 
cave	lewa; 
caves	lewa; 
cc	 khaponekhopi; cc; 
cease	 emiša; homola;  fediša; 
ceases	 emiša; homola;  fediša; 
cedar	mosetere; 
celebrate	keteka; 
celebrated	ketekile; 
celebrates	keteka; 
celebrating	keteka; 
celebrations	meketeko; 
cell	sele; 
cells	 disele tša peteri; disele; 
cellular	sellathekeng; ya sele; 
census	 dipalo tša batho; palo; 
censuses	dipalo;  dipalo tša batho; 
cent	sente; 
centenary	ya ngwagakglo; 
center	 bogareng;  senthara; gare; 
central	ya gare; 
centre	 senthara;  bogare; gare; 
centres	 senthara;  bogare; gare; 
centuries	 mengwagakgolo; makgolo; 
century	kgolo;  ngwagakgolo; 
ceremonial	ya keteko; ya moletlo; 
ceremonies	meletlo; 
ceremony	moletlo; 
certain	 na le bonnete; na le kgonthe; 
certainly	 ka kgonthe; ka bonnete; 
certainty	 kgonthe; bonnete;  bokgonthe; 
certificate	setifikeiti;  lengwalobohlatse setifikeiti; 
certificates	disetifikeiti; mangwalobohlatse; 
certification	 fa setifikeiti; dumelela; 
certified	dumeletšwel amogetšwe; tiišeditšwe; 
cession	kemišo; 
chain	tšhaene; 
chair	setulo; 
chaired	etile pele; 
chairman	modulasetulo; 
chairperson	modulasetulo; 
chairpersons	badulasetulo; 
challenge	 tlhotlo;  hlohla;  phenkgišana; tlhohlo;  phenkgišano; 
challenged	hlotlilwe; phenkgišitše;  hlotlile;  phenkgišane; 
challenges	ditlhohlo;  hlohla;  ditlhotlo;  phenkgišane; diphenkgišano; 
challenging	 tlhotlo;  hlohla;  phenkgišana; tlhohlo;  phenkgišano; 
chamber	phapoši; 
chambers	diphapošikgolo; 
champions	phinere; 
championship	bonkgwete; 
championships	bonkgwete; 
chance	sebaka;  monyetla;  sekgoba; 
change	 phetogo;  tšhentšhi; fetola;  tšhentšha; 
changed	tšhentšhitše;  fetotše; fetošitše; 
changes	 tšhentšha; diphetogo;  ditšhentšhi;  diphetošo; 
changing	 phetogo;  tšhentšhi; fetola;  tšhentšha; 
channel	 tšhanele;  iša; kanale; 
channels	ditšhanele;  iša; dikanale; 
chapter	kgaolo; 
chapters	dikgaolo; 
character	semelo;  moanegwa; 
characterised	pharile dipataka; 
characteristic	 semelo;  sa phapantšho;  phapantšho; mokgwa; 
characteristics	mekgwa;  dimelo;  phapantšho;  tša phapantšho; 
characterize	phara dipataka; 
characterized	pharile dipataka; 
characters	 dimelo; baanegwa; 
charge	tefo;  latofatša;  tatofatšo; 
charges	 ditefišo;  ditatofatšo; tšhatša; latofatša; 
charter	lengwalo la tumelelo; 
chartered	sebalamatlotlo; 
check	phetleko;  fetleka; 
checked	fetlekile;  lekotše; 
chemical	 sa khemise;  sekhemise; khemikhale; 
cheque	tšheke; 
chief	kgoši; 
child	ngwana; 
children	bana; 
children's	ya bana; 
china	setsopa; 
choice	kgetho; 
choices	dikgetho; 
choir	khwaere; 
choose	kgetha; 
choral	-khwaere; 
chose	kgethile; 
chosen	kgethile; 
chronic	 motho wa go se fole; bja go se fole;  ya go se fole; 
church	kereke; 
churches	dikereke; 
cinemas	dipaesekopo; 
circumstances	mabaka; 
cite	tagafara; 
cited	tagafarile; 
cities	metsemogolo; 
citizen	modudi;  moagi; 
citizenry	 bodudi; badudi; 
citizens	badudi;  baagi; 
citizenship	 tokelo ya bodudi; boagi;  thutobogae; 
city	motsemogolo; 
civic	ha motse; 
civil	ya segae; 
civilian	mogae; 
claim	 kleime; baka; 
claimed	kleimile;  kgopetše; bakile; 
claims	tleleima; baka;  dikleime; dipako; 
clarification	tlhathollo; 
clarify	hlaloša; 
clarity	tlhathollo; 
class	 legoro; sehlopha;  mphato; 
classes	 magoro; dihlopha;  mephato; 
classic	klasiki; 
classical	- ya bogologolo; 
classics	diklasiki; 
classification	tlhopho; 
classified	hlopšha; 
classroom	phaphoši ya borutelo; 
clause	 thabe; temana; 
clauses	 dithabe; ditemana; 
clean	hlwekilego; 
cleaning	hlwekilego; 
clear	 bonagatšago;  hlwekile;  go hlaka ga maru; phumula; 
clearance	tokollo; 
clearing	lokolla; 
clearly	 go bolela nnete; go ba molaleng;  ntle le mathata; 
clerk	 mapalanekgotla; mapalane; 
click	tobetša;  thathapa;  modumo wa go thulantšha diletšo tše pedi; 
client	modirelwa;  morekedi; 
clients	 barekedi; badirelwa; 
climate	 klimate; klaemete; 
clinic	kliniki;  kliniki ya tša maphelo; 
clinical	ya kalafi;  ya kalafo; 
clinics	dikliniki;  kliniki; 
close	 hupelanago; kgauswi; 
closed	tswalegile; 
closely	 ka bokgauswi; kgauswi; 
closer	 hupelanago; kgauswinyana; 
closing	 hupelanago; kgauswi; 
closure	tswalelelo; 
closures	ditswalelelo; 
clothing	diaparo; 
club	sehlopha; 
clubs	dihlopha; 
cluster	sehlopha; 
co	mmogo; 
co-operation	koporasi;  tlemagano; 
co-operative	dirišanago; 
co-ordinate	kopanya; 
co-ordination	kopanyo; 
co-production	tšweletšommogo; 
coach	 mothobolliši; mohlahli; 
coal	malahla; 
coast	lebopo; 
coastal	 ya lebopo; ya lebopong; 
coat	 tšhatšha; boya; 
code	 tsela; molao;  khoute; 
codes	 ditsela; dikhoutu;  dikhoute; melao; 
coherent	 ya tirišano; ya tswalano;  ya kamano; 
cohesion	kamano;  tirišano; 
cohesive	 ya nyalelano; ya tirišano; 
cold	 go tonya;  botšididi; tonya;  tonyago;  mpshikela; 
collaborate	 thušana; dirišana; 
collaboration	 thušano; kamano;  tirišano; 
collaborative	ya thušano;  ya tirišano;  ya kamano; 
collapse	-wa;  burama; 
colleagues	bašomimmogo; 
collect	 kgoboketša; kgobokanya; 
collected	bokantše; kgobokeditše; 
collecting	 kgoboketša; kgobokanya; bokanya; 
collection	kgobokanyo; 
collections	dikgobokanyo; 
collective	 seboka;  ka seboka; sehlopha;  ya seboka; 
collectively	mmogo;  ka seboka; 
college	kholetšhe; 
colleges	dikholetšhe; 
colloquium	seminara; 
colonialism	bokoloniale; 
colonies	diphedimmogotshwani; dikoloni; 
colour	mmala; 
coloured	ya mebalabala; 
colourful	mebalabala; 
colours	mmalafatša; mebala;  mebala; 
column	 leru;  kholomo;  kokwane; sengwalwa; 
combat	lwantšha; 
combating	lwantšha; 
combination	 kopanyo ya dipalo; kopanyo; 
combined	kopantšweng; 
come	etla; 
comedy	metlae; 
comes	 o a tla; etla; 
coming	o e tla; 
command	taolo;  laela;  taelo; 
commas	dikhoma; difegelwana; 
commemorate	 dira segopotšo;  keteka; gopola; 
commemorating	 dira segopotšo;  keteka; gopola; 
commemoration	segopotšo; 
commemorative	ya keteko; ya segopotšo; 
commence	 thomiša; thoma; 
commenced	thomile;  thomišitše; 
commencement	 thomišo; go thoma;  go thomiša; 
commencing	 ba thoma; ba thomiša; 
commend	reta;  lebogiša; 
commendable	retega; 
commensurate	 ya go thoma;  ya thomiša; ya mathomo; 
comment	swayaswaya; 
commercial	 ya bogwebi;  ya kgwebo; papatšo; 
commission	khomišene; 
commissioned	khomišenne; tshwaeditšwe; 
commissioner	moeniši;  komišinare; 
commissioners	dikomišinare; baeniši; 
commissions	dikhomišene; ditshwaetšo; 
commit	tshephiša;  ikemišetša; ikgafa; 
commitment	 maikemišetšo; tshephišo; boikgafo; 
commitments	 maikemišetšo; tshephišo; boikgafo; 
commits	tshephiša;  ikemišetša; ikgafa; 
committed	gare ka mošomo; ikgafile;  ikgafile;  hloka nako;  ikemišeditše; 
committee	komiti; 
committee's	ya komiti; 
committees	dikomiti; 
committing	tshephiša; aba; 
commodities	diphahlo;  ditšweletšwa; 
commodity	phahlo; 
common	ya ka mehla; 
commonly	ye tlwaelegilego; 
commonwealth	setšhaba; 
communal	kopanelo; 
communicate	 kgokagana; neelana; 
communicated	 boditše; neelana; kgokagantše; 
communication	 tsebišano; kgokagano; 
communication-related	ya go amana le dikgokagano; ye amanego le poledišanao; 
communications	dipoledišano; dikgokgagano; 
communities	ditšhaba; 
community	setšhaba; 
community-based	 ye lego setšhabeng; ye theilwego setšhabeng; 
companies	 dikhamphani; mekgatlo; 
company	 khamphani; mokgatlo; 
comparability	go bapetšega;  go bapetšwa; 
comparable	ya go bapetšega; 
comparative	ya papetšo; 
compare	bapiša;  bapetša; 
compared	bapeditše; bapišitše; 
comparison	papišo; 
compassion	lešoko; 
compatriot	mogageno; 
compatriots	bagageno; 
compelled	gapeletšegile; 
compelling	ya go gapeletšega;  gapeletšega; 
compensate	 lefa; lefela; 
compensation	tefelo; 
compete	phadišana; 
competence	 botsebi; bokgoni;  tsebo; 
competencies	mabokgoni; 
competency	bokgoni; 
competent	 wa botsebi; yo a tsebago;  yo a kgonago; 
competition	phadišano; 
competitive	wa tsebo; 
competitiveness	 go phadišana; bokgoni;  tsebo;  phadišano; 
compilation	 go ngwala; go hlama; 
compile	kgoboketša; 
compiled	kgobokeditše; 
complainant	mmelaedi; 
complaint	ngongorego; 
complaints	dingongorego; 
complement	tlaleletša; 
complementary	ya tlaleletšo; 
complete	feletše;  fetša; 
completed	feditše; 
completely	 ka botlotla; ka botlalo; 
completing	feletše;  fetša; 
completion	phetšo; 
complex	raranego; 
complexity	tharano; 
compliance	 go latela;  go obamela; kobamelo; 
complied	 obametše; latetše; 
complies	ngwala; 
comply	 obamela; latela; 
complying	ya go obamela;  ya go latela; 
component	setho; 
components	dikarolowana; ditho; 
composed	 hlamilwe; bopilwe; 
composition	 taodišo;  tlhamo ya dikoša; tlhamo;  tlhamego; 
comprehensive	ya kakaretšo;  ya go kwešišega;  ya botlalo; 
comprehensively	 ka botlalo; ka kwešišego;  ka kakaretšo; 
comprise	 hlama; bopa; 
comprises	 hlama; bopa; 
comprising	 hlama; bopa; 
compromise	 kwana; kwano; 
compromised	itetše; šitetše; 
compulsory	gapeletšago; 
computer	khomphutha; 
computers	dikhomphutha; dikhumphyutha; 
comrades	makhomreite; 
conceive	ima;  ithwala; 
conceived	 ithwele; imile; 
concentration	tlhokomedišišo; 
concept	kgopolo; 
concepts	dikgopolo; 
concern	ngongorego;  pelaelo; 
concerned	belaela;  ngongorega;  yo a amegago; 
concerning	ka ga;  ya go belaetša;  mabapi le; 
concerns	dipelaelo; dingongorego; 
concert	khonsata; 
conciliation	kagišo; 
conclude	 fetša; phetha; 
concluded	 feditše; phethile; 
concludes	 fetša; phetha; 
conclusion	sephetho; mafetšo; 
concrete	 sa popego; khonkhoriti; 
concurrence	direga ka nako e tee;  direga mmogo;  hlaka ka nako e tee; 
concurrent	sammaletee; 
condemned	kgadile;  kgalemile;  nyaditše; 
condemns	 kgala;  nyatša; kgalema; 
condition	 boemo;  peelano; maemo; 
conditional	ya seemo;  ya maemo;  ka lebaka; 
conditions	maemo; 
condolences	matshedišo; 
condom	khondomo;  khontomo; 
condoms	dikhontomo;  dikhondomo; 
conducive	 ye loketšego; ya go lokela;  ye kaone;  ya bokaone; 
conduct	 boitshwaro; hlahla;  itshwara;  sepetša; 
conducted	 itshwere;  boitshwaro; hlahla;  sepetša; 
conducting	 boitshwaro; hlahla;  itshwara;  sepetša; 
conducts	 hlahla; maitshwaro;  itshwara;  sepetša; 
confer	aba; 
conference	khonferense; 
conferences	dikhonferense; 
conferred	abetše; 
confidence	tshepo; 
confidential	ya sephiri; 
confidentiality	sephiri; 
confirm	 tiišo;  netefatša; tiiša; 
confirmation	tlhomamišo;  tiišetšo; 
confirmed	tiišeditše; 
confirms	ditiišo;  netefatša; tiiša; 
confiscation	thopelo; 
conflict	 kgohlano; thulano; 
conflicts	 dikgohlano;  dithulano; diphapano; 
confront	itebanya; 
congratulate	lebogiša; 
congratulates	lebogiša; 
congratulating	lebogiša; 
congratulations	ditebogišo; 
congress	khonkrese; 
conjunction	lekopanyi; 
connect	bofaganya;  kopantšha; 
connected	 kgokagantšwe; amana; 
connection	kopantšho; 
conscience	letswalo; 
conscious	lemogago; 
consciousness	temogo; 
consecutive	hlatlamanago; 
consensus	 tumelelano; kwano; 
consent	 dumelela; tumelelo; 
consequence	ditlamorago;  pheletšo; 
consequences	 dipheletšo; ditlamorago; 
consequential	 ya mafelelong; ye bakwago ke;  ya moragorago; 
consequently	mafelelong; 
conservation	 pabalelo; poloko; 
conserve	boloka;  babalela;  poloko;  šireletša; 
consider	akanya; 
considerable	 ye e lemogwago; ye e šetšwago; 
considerably	 ka tlhokomelo; ka šedi; 
consideration	 keletšo; tefo; 
considerations	 dikeletšo; ditemogo; 
considered	ye hlokometšwego; 
considering	akanya; 
considers	akanya; 
consist	bopilwe ka; 
consistency	phegelelo; 
consistent	 ka go swana;  ya go swana; ya go sepelelana; 
consistently	 ka go amana; ka go swana; 
consisting	bopilwe ka; 
consists	bopilwe ka; 
consolidate	tiiša; 
consolidated	tiišitšwego; 
consolidation	teefatšo; 
constant	sa fetogego; 
constantly	kgafetšakgafetša; 
constituency	karolokgetho; 
constitute	hloma; 
constituted	hlomile; 
constitutes	hloma; 
constitution	molaotheo; 
constitutional	ya molaotheo; 
constitutions	melaotheo; 
constraint	lepheko; 
constraints	mapheko; 
construct	aga; 
constructed	agile; 
construction	kago; 
constructive	ya go kwagala; 
construe	hlaloša; 
construed	hlalošitše; 
consult	somiša; 
consultant	setsebi; 
consultants	ditsebi; 
consultation	therišano; 
consultations	ditherišano; 
consultative	ka poledišano;  ka go rerišana;  ya therišano; 
consulted	rerišane;  šomišitše; 
consulting	somiša;  rerišana; 
consumables	tše dirišwago; 
consumer	modiriši;  moji; 
consumers	baji;  badiriši; 
consumption	tšhomišo; 
contact	kamano; 
contacts	dikamano; 
contain	na le; 
contained	bile le; 
containers	 diswari; ditšhelo; 
containing	na le; 
contains	na le; 
contemplate	akanya; 
contemplated	akantše; 
contemporary	tša sebjalebjale; 
contempt	 nyatša; lenyatšo; 
content	dikagare; 
contents	mateng;  mothamo; 
context	 kwešišo; kamano; 
continent	 kontinente; lefase; 
continental	ya khonthinente; 
continents	mafase;  dikontinente; 
contingency	ye e tlago; 
contingent	ye e ka latelago; 
continuation	tšwelopele; 
continue	tšwela pele; 
continued	tšweleditšwego; 
continues	tšwela pele; 
continuing	tšwela pele; 
continuity	tšwelopele; 
continuous	 e sa kgaotšego; lebakatšweledi; 
continuously	ka tšwelopele; 
contract	hunyela;  setlemo;  swarwa ke bolwetši;  hunyetša;  tumelelano; 
contracted	dumelelane;  hunyetše;  swerwe ke bolwetši;  tlemile; 
contracting	dumelela;  swarwa ke bolwetši;  tlema;  hunyetša; 
contractor	rakonteraka; mokonteraki; 
contractors	bakonteraki; borakonteraka; 
contracts	 hunyela;  ditumelelano; ditlamo;  swarwa ke bolwetši;  hunyetša;  ditlemo; 
contractual	ya konteraka; 
contrary	kgahlanong;  ka go se kwane le;  ya go thulana le; 
contrast	pharologanyo;  pharologanya;  phapantšho; 
contravenes	tshela;  go se hlomphe; tshola; 
contravention	tlolo; go tshela; 
contribute	go ba le seabe;  tsenya letsogo; 
contributed	tsentše letsogo;  bile le seabe; 
contributes	go ba le seabe;  tsenya letsogo; 
contributing	go ba le seabe;  tsenya letsogo; 
contribution	seabe; tsenyoletsogo; 
contributions	diabe; ditsenyoletsogo; 
contributor	motsenyaletsogo; moabi; 
contributors	batsenyaletsogo; baabi; 
control	taolo;  laola; 
controlled	laotše; 
controlling	laola; 
controls	disepetši; 
convene	 bitša kopano; kopanya; 
convened	 kopantše; biditše kopano; 
convention	tlwaelo;  kgwerano; 
conventional	ya setlwaedi;  ya tlwaelo; 
conventions	ditlwaelo;  dikgwerano; 
convergence	 kgobokano; kopano; 
conversation	poledišano; 
conversations	dipoledišano; 
conversion	 tshokologo; phetogo; 
convert	 mosokologi; fetola;  fetoša;  sokolla; 
converted	 fetošitše;  fetotše; sokologile; 
convey	 šupa; tšweletša; 
convict	mogolegwa; 
convicted	golegilwe; 
conviction	 go bonwa molato; molawana; 
convinced	go tshepha;  go netefaletšwa; go kgolwa; 
cookie	khuki; 
cooperation	setlengwa; mokgatlotlengwa; khamphani ya mohlakanelwa; 
cooperative	dirišanago; 
cooperatives	dirišanago; 
coordinate	kgokaganya; 
coordinated	kopantšwe; 
coordinating	kopanya; 
coordination	kgohlaganyo; 
cope	 kgona go phela; holofela; 
copies	 dikopi; ngwalolla;  ekiša; dikhophi;  go kopolla; 
copy	ngwalolla;  kopi;  ekiša;  go kopolla; 
copyright	tokelo ya ngwalollo; 
core	pelwana; 
corner	sekhutlo;  huku; 
cornerstone	motheo; 
corporate	tlemanego; 
corporation	koporasi; 
corporations	dikoporase; 
corps	badiredi; 
correct	 phošolla;  nepiša;  nepagetšego; nepilego; 
correction	phošollo;  nepišo; 
correctional	ya tshwaollo; ya phošollo;  ya tshokollo; 
corrections	diphošollo; dinepišo; 
corrective	phošollago; 
correctly	ka nepo; 
corresponding	swanago; 
corrupt	tshenyo; 
corruption	seatlakobong;  bomenetša; 
cost	 tshenyegelo; theko;  bokae; 
cost-effective	ya go sekentša mašeleng; ya go seketša tšhelete; 
costs	 bokae;  ditheko; ditshenyegelo; 
council	khansele; 
councillor	mokhansele; 
councillors	makhanselara; bakhanselara; 
councils	dikhansele; 
counsel	moeletši; 
counselling	kgakollo; 
count	bala; 
countdown	go balela fase; 
counter	 borwanakatološi; mmadi; 
counterclaim	kgopelo ya kgahlanong; 
counterpart	mogwera;  molekane; 
counterparts	bagwera;  balekane; 
countries	dinaga; 
country	naga; 
country's	ya naga; 
countrywide	naga ka bophara; 
couple	 swaraganya; bobedi; 
coupled	swaraganya;  bobeding; 
coupon	setlankana;  khupone; 
courage	bogale; 
course	 sesola; dithuto; 
courses	dithuto;  disola; 
court	kgoro;  loša; 
court's	ya kgorotsheko; 
courtesy	tlhompho; 
courts	 loša; dikgoro; 
cover	akaretša; 
coverage	kgašo;  kakaretšo; 
covered	akareditše; 
covering	sekhurumelo;  khupetšo; 
covers	akaretša; 
covet	duma; 
coveted	dumile; 
cradle	thari; 
craft	tiroatla; 
crafters	babetli; dibetli; 
crafts	ditiroatla; 
crater	 sebetli; mmetli; 
create	hlola; 
created	hlotše; 
creates	hlola; 
creating	hlola; 
creation	tlhamo;  go hlama; 
creative	bokgoni bja go ithomela; 
creativity	bokgoni bja go ithomela; 
creator	mmopi; 
creators	bahlami;  babopi;  bahlodi; 
credibility	 seriti; maemo; 
credible	 ya maemo; ya seriti; 
credit	sekoloto; 
creditor	moabi; 
creditors	baabi; 
credits	dikhretiti; dikoloto; 
creed	bojato; 
cricket	mamokgadi; 
crime	bosenyi; 
crimes	bosenyi; 
criminal	mosenyi; 
criminals	basenyi; 
crisis	 moseneke; kgakanego; 
criteria	mekgwatiro; 
critical	ye bohlokwa; 
critically	go bakwa le badimo; 
crop	 sebjalwa;  sejelo; puno; 
crops	dijelo;  dipuno; dibjalo; dibjalwa; 
cross	swaya;  koba;  sefapano; 
cross-border	ya go putla mellwane; 
crucial	ye bohlokwa; 
culminate	ye e feletšago;  ye e fihlelago; 
culmination	phihlelo;  pheletšo; 
cultural	tša setšo; 
culture	setho;  setšo; 
cultures	ditho;  ditšo; 
cup	komiki; 
curate	 beakanya; kgetha; 
curator	mohlokomedi wa ditšweletšwa tša bokgabo; 
curators	dikuratoro; bahlokomedi ba ditšweletšwa tša bokgabo; 
currency	tšhelete; 
currently	gabjale;  mo lebakeng le; 
curriculum	lenanethuto; 
curve	 kgopamo; modikelela; 
custodian	moswari; 
custodians	baswari; 
custody	 go golegwa; tlhokomelo; 
custom	 setlwaedi; mokgwa; 
customary	ya setlwaedi;  ya setšo; 
customer	moreki; 
customers	bareki; 
customs	mekgwa;  ditlwaedi; 
cut	 ntho;  go šwahla;  mosego; seripana; 
cutting	lehloma;  thupana; 
cycle	 leboo; sediko; 
daily	ya letšatši le lengwe le le lengwe;  ya ka mehla; 
dam	letamo;  tama; 
damage	 senya; tshenyo; 
damages	 ditshenyo; senya; 
dance	 gobela; bina; 
dancer	motantshi; 
dancers	batantshi; 
dances	 gobela; metantsho; bina; tantsha; 
danger	kotsi; 
dangerous	-kotsi; 
dark	 go fifala; leswiswi; 
data	 tshedimošo; difiwa; 
databases	ditshedimošohlopša; 
date	 tšatšikgwedi; tšatšikgwedifatša; 
dated	 ye filwego letšatšikgwedi la; ya letšatšikgwedi la; 
dawn	masa; 
days	matšatši; 
de	ya; 
dead	mohu; 
deadline	letšatši la mafelelo; 
deaf	sefoa; 
deal	 kgwebišano; kwano; 
dealer	mogwebi; 
dealers	bagwebi; 
dealing	gwebišana;  go gweba; 
deals	dikgwebišano; 
dealt	šomile ka; 
dear	 morategi; yo a rategago; 
death	lehu; 
deaths	mahu; 
debate	kgang;  ngangišano; 
debated	kgang;  ngangišane; 
debates	 dingangišano; kgang; 
debt	 sekoloto; molato; 
debtor	mokoloti; 
debtor's	ya mokoloti; 
debts	melato;  dikoloto; 
decade	ngwagasome; 
decades	mengwagasome; 
deceased	mohu;  yo a hlokofetšego; 
decent	 ya go kgahliša; ya maemo; 
decide	phetha; 
decided	tšere sephetho; 
decides	phetha; 
deciding	tšea sephetho; 
decision	sephetho;  phetho; 
decision-making	tšeosephetho; 
decisions	diphetho; 
declaration	pego;  tsebagatšo; 
declare	tsebiša; 
declared	 tsebagaditšwe; goeleditšwe; tsebišitšwe; 
declares	tsebiša; 
decline	gana; 
declined	ganne; 
declines	gana; 
declining	gana; 
decrease	fokotša; 
decreased	fokoditše; 
decryption	 go fihla; phihlo; 
dedicate	abela; 
dedicated	abetše; 
dedication	boikgafo; 
deduct	 ntšha; fokotša; 
deducted	fokoditše;  ntšhitše; 
deduction	go ntšha;  phokotšo; 
deductions	diphokotšo; go ntšha; 
deed	tokomane ya semolao; 
deeds	 ditokomane tša semolao; mangwalo a bong; 
deem	bona;  tšerwe;  bonwa; 
deemed	bonwa;  tšerwe; 
deems	 tšea; bona; 
deep	iša fase; 
deepen	sobeletša fase; 
deeper	fasana; 
deeply	fase kudu; 
default	ka go direlwa; ka tirelwa; 
defect	phošo; 
defence	 tšhireletšo; tlhabanelo; 
defend	šireletša; 
defendant	moiphemedi; 
defiance	 lenyatšo; nyatšo; 
deficiencies	bogole;  diphošo; 
deficit	tlhaelelo; 
deficits	ditlhaelelo; 
define	hlatholla;  hlaloša; 
defined	hlatholla;  hlalošitše; 
defines	hlatholla;  hlaloša; 
defining	hlatholla;  hlaloša; 
definition	tlhathollo;  tlhalošo; 
definitions	ditlhalošo; 
degree	kgato;  tikrii; 
degrees	dikgato;  ditikrii; 
delay	ditela; 
delayed	ditetšwe; 
delays	dititelego;  dititelo; ditela; 
delegate	 moromelwa; romela;  fa maatla; 
delegated	 rometše; file maatla;  rometšwe; 
delegates	romela;  baromelwa;  fa maatla; 
delegation	boromiwa; 
delegations	boromiwa; 
delete	phumola; 
deleted	phumotše; 
deletion	go phumola;  go tloša; 
deliberate	 ka maikemišetšo; 
deliberately	ka maikemišetšo; 
deliberations	ditherišano; 
delighted	thabile;  thakgetše; 
deliver	 iša; belega; 
delivered	 išitše; belege; 
delivering	 iša; belega; 
delivers	 iša; belega; 
delivery	go belega; 
demand	 senyakwa;  nyako; nyaka; 
demands	 dinyakwa; nyaka; 
demarcation	tshego ya mellwane; 
democracy	temokrasi; 
democratic	ya temokrasi; 
democratically	ka temokrasi;  ya temokrasi; 
demographic	ya dipalopalo; 
demonstrate	 šupetša;  laetša; gwaba; 
demonstrated	gwabile;  laeditše; šupeditše; 
demonstrates	 šupetša;  laetša; gwaba; 
demonstration	 taetšo; tšhupetšo; 
denied	 latotše; ganne; 
dental	ya meno; 
deny	 latola; gana; 
department	kgoro;  kgorwana; 
department's	ya lefapha;  ya kgoro; 
departmental	ya kgoro; 
departments	 dikgorwana; dikgoro; 
departure	go tloga;  go sepela; 
depend	laolwa; 
dependants	bafepša; 
dependence	go tshepha; go bota; 
dependency	naga ya go bušwa ke naga ye ngwe; 
dependent	 mmoti; botshephi; 
depending	go eya ka; 
depends	laolwa; 
deploy	romela; 
deployed	rometšwe; 
deployment	 go thwala; thomelo; 
deposit	 dipositi; mogogolwa; 
deposited	depositilwe; gogotšwe; tepositi; 
depository	bobeelo; 
deposits	megogolwa; ditepositi; 
depreciation	phokotšegotheko; 
depth	botebo; 
deputies	batlatši; 
deputy	motlatši; 
der	ka; 
derive	 tšwa go; tšweletša; 
derived	tšwele go; 
descent	ya go kgahliša; 
describe	 laodiša; thala;  hlaloša; 
described	 hlalošitše; thadile;  laodišitše; 
description	tlhalošo; 
desert	 leganata; ngwega; 
design	 tlhamo;  akanyetša; hlama;  moakanyetšo; 
designate	aba; 
designated	abetše; 
designation	 go fa maemo ao a itšego; maemo; 
designed	 ditlhamo;  akanyeditše;  hlamilwe; meakanyetšo; hlama; 
designer	mohlami; 
designers	bahlami; 
designs	ditlhamo; meakanyetšo;  akanyetša; 
desirable	ya go nyakega;  ya go ratega; 
desire	 duma; nyaka; 
desired	 dumega; nyakega; 
despite	go sa lebelelwe;  go sa balwe;  ka ntle le; 
destination	lefelo le go iwago go lona; 
destiny	boyo; leeto; 
destroy	senya; 
destroyed	sentše; 
destruction	tshenyo; 
detail	 ka botlalo;  -botlalo; botlalo; 
detailed	 ka botlalo;  -botlalo; botlalo; 
details	 ka botlalo;  -botlalo; botlalo; 
detain	golega; 
detained	golegile; 
detainees	bagolegwa;  baswarwa; 
detection	go hwetša;  go utolla; 
detention	go tswalelela; 
determination	 maikemišetšo; mafolofolo;  boikgafo; 
determine	laetša; 
determined	phegeletše; 
determines	laetša; 
determining	laetša; 
develop	 godiša; gola; 
developed	godišitše; 
developing	 godiša; gola; 
development	kgolo;  kgodišo; 
developmental	ya tlhabollogo; 
developments	 dikgodišo; dikgolo; 
develops	 godiša; gola; 
device	sedirišwa;  loga maano;  setlabelo; 
devices	ditlabelo;  loga maano;  didirišwa; 
devolution	kgafelomošomo; 
diagnosis	 phekolo; temogo; 
dialogue	poledišano; 
dialogues	dipoledišano; 
diamond	 setaamane; taamane; 
diamonds	ditaamane; 
diaspora	tšhwalalano; 
dictionary	pukuntšu; 
did	dirile; 
didn't	ga se a; 
die	 hlokafala; hlokofala; 
died	hlokafetše;  hlokofetše; 
dies	 hlokafala;  mataese; hlokofala; 
differ	fapana; 
difference	phapano;  phetano; 
differences	 dipharologano;  dithulano; diphapano; 
different	 ya go fapana; fapanego; 
differently	 ka phapano; ka go fapana; 
difficult	thata; 
difficulties	mathata; 
difficulty	bothata; 
digital	tshedimošo ka sebopego sa dipalo; 
dignified	 ka seriti; ya seriti; 
dignitaries	bahlomphegi; 
dignitary	mohlomphegi; 
dignity	seriti; 
dimension	bogolo;  tekanyo; 
dimensions	 mathoko; bogolo; 
dinner	matena;  letena; 
diploma	tiploma; 
direct	lebanego go ela; 
directed	lebanego go ela; 
directing	lebanego go ela; 
direction	 pontšho;  thokong;  tebanyo; thoko; 
directions	 ditebanyo; thokong;  dipontšho;  mathoko; 
directive	lediredi; 
directives	madiredi; 
directly	thwii;  ka go se dikadike; 
director	 mohlahli; molaodi; 
director-general	molaodipharephare; 
directorate	lefapha; 
directors	 bahlahli; balaodi; 
directory	tšhupamegala;  tšhupamegala le bodulo; 
directs	lebanego go ela; 
disabilities	magole; 
disability	bogole; 
disabled	digole;  golofetše; 
disadvantage	tlalelo;  poelamorago; 
disadvantaged	dipoelamorago; tlaletšwe; 
disaster	kotsi;  masetlapelo; 
disasters	 masetlapelo; dikotsi; 
discharge	megokgo;  khunollo;  ntšha;  kelelo ya diela tšeo di itšego tša mmele;  fela maatla; 
discharged	 khunollo; tšhollotše megokgo;  fedile maatla; lahlile;  ntšhitše; 
disciplinary	ya maitshwaro;  ya kgalemo; 
discipline	maitshwaro;  rupiša;  boitišo; 
disciplines	 maitišo; maitshwaro;  rupiša; 
disclaimer	 keletšo;  temošo; kgalemo; 
disclose	 tsebagatša; utolla; 
disclosed	tsebagaditše; utollotše; 
disclosure	go tsebagatša;  go utolla; 
discourse	 poledišano; ngangišano; 
discover	 hwetša; ribolla; 
discovered	 hweditše; ribolla; 
discovery	khumano; 
discretion	tlhokomelo; 
discretionary	ya boithatelo;  ya go itšeela sephetho; 
discrimination	kgethologanyo; 
discuss	laodiša; 
discussed	laodišitše; 
discussing	laodiša; 
discussion	poledišano; 
discussions	dipoledišano; 
disease	ditwatši;  bolwetši; 
diseases	malwetši; 
dismissal	go ntšha; 
disparities	go se lekalekanele; 
display	bontšha;  pontšho; 
displayed	bontšhitše;  pontšho; 
displaying	bontšha;  pontšho; 
disposal	tahlo;  ntšha; 
dispose	lahla; 
disposed	lahlile; 
dispossession	go amoga;  go tšeela; 
dispute	 kganetšano; ganetšana; 
disputes	 kganetšano; ganetšana; 
disqualified	ntšhitšwe;  phumotšwe; 
dissatisfied	go se kgotsofale;  go belaela; 
dissemination	phatlalatšo; 
dissolution	 fediša; phumola; 
dissolve	 nyaoga;  phatlalatša;  nyaoša; tologa; 
dissolved	 phatlalatša; nyaogile; nyaošitše; tologile; 
distance	sebaka;  bokgole; 
distant	kgole; 
distinct	 felelago; kgethegilego; 
distinction	pharologanyo; 
distinctions	dipharologanyo; 
distinctive	bonagala; 
distinguished	hlomphegilego; hlomphegago; 
distribute	aba; 
distributed	abile; 
distribution	kabo;  kabelo; 
district	selete;  setereke; 
districts	dilete; 
distrust	gononwa; 
diverse	 fapanago; fapanego; 
diversion	karogo;  phapošo;  go fapoša; 
diversity	phapano; 
diverted	fapošitše; arošitše; 
divide	arola; 
divided	arotše; efa dipalokarolwa; 
dividend	karolo; 
dividends	dikarolo; dipalokarolwa; dikarolwa; 
division	karolo;  kgaogano;  karogano; 
divisions	dikarolo;  dikarogano;  dikgaogano; dintšhopoeletšo; 
divorce	tlhalo; 
do	dira; 
doctor	 doktoro; ngaka; 
doctorate	bongaka; 
doctors	dingaka; 
document	lengwalo;  tokumente; 
documentation	dingwalwa; 
documented	 ngwadilwe; ditokumente; 
documenting	lengwalo;  tokumente; 
documents	mangwalo;  ditokumente; 
does	dira; 
doesn't	ga a; 
doing	dira; 
dollar	tolara; 
domain	lekala;  lefapha; tomeine; 
domains	ditomeine;  mafapha; makala; 
dominant	koketšwa; 
domination	kgatelelo;  fetiša ka palo; 
don	apara; 
don't	o se ke; 
donation	moneelo; 
donations	meneelo; 
done	 phethile; dirile;  feditše; 
donor	moabi; 
donors	baabi; 
door	lebati; 
doors	mabati; 
double	 pedifatša; bobedi; 
doubt	pelaelo; 
down	fase;  mafofaletane; 
downtown	toropong ya fasana; 
downturn	go phuhlama ga ekonomi; go wa ga ekonomi; 
draft	dikakanyo; 
drafted	dikakanyo; 
drafting	dikakanyo; 
drama	 tiragatšo; terama; 
dramatic	ya go makatša;  ya semaka; 
draw	 lekalekana; thala;  palelano;  tšhentšha;  ntšha tšhelete; 
drawing	thala;  sethalwa; 
drawn	 gogilwe; gogwa; 
dream	toro; 
dreams	ditoro; 
drew	lekalekana; tšhentšhitše;  thadile;  palelano;  ntšhitše tšhelete; 
drink	 seno; nwa; 
drinking	go nwa; 
drive	mokgothana; 
driver	mootledi; 
driver's	ya mootledi; 
drivers	baotledi; 
drop	rotha;  lerothi; 
drug	sehlare;  seokobatši; 
drugs	dihlare;  diokobatši; 
drum	moropa;  konka;  meropa; 
dry	 omilego;  omiša; oma;  omile; 
due	kolotwago; 
duly	ka fao go nyakegago; 
duplicate	 pedifatša; kopi; 
duplication	pedifatšo; 
duration	 paka; lebaka; 
during	nakong ya; 
duties	 ditshwanelo;  metšhelo;  mešomo; mediro; 
duty	tshwanelo;  mošomo;  motšhelo;  modiro; 
dynamic	 ya go fetoga; ya go gola; 
dynamics	diphetogo; 
e-mail	emeile; emeila; romela molaetša ka elekhtroniki; melaetša ka elekthroniki; 
each	nngwe le nngwe; 
earlier	 ya peleng; ya pejana; 
earliest	ya pelengpeleng; 
early	ka pela; 
earmarked	beetšwego; 
earn	go lebogišwa; 
earned	lebogišitšwe; 
earning	putsa; 
earnings	ditseno;  matseno; 
earth	lefase;  mabu; 
ease	bonolo; 
easier	bonojana;  bonojana; boletšiana; 
easily	gabonolo; 
east	 -bohlabela; bohlabela; 
eastern	ya bohlabela; 
easy	 boleta; bonolo; 
economic	boiphedišo; 
economically	ya ekonomi; 
economies	maiphedišo; diikonomi; 
economists	boraekonomi; 
economy	boiphedišo; 
ecosystems	diphedišano tša diphedi; 
edge	morumo;  leši la letlakala; 
editing	go rulaganya; 
edition	kgatišo; 
editor	morulaganyi; 
editors	barulaganyi; 
educate	ruta; 
educated	rutile; 
educating	ruta; 
education	thuto;  go ruta; 
educational	(ya) thuto;  ya thuto; 
educator	morutiši; 
educators	barutiši; 
effect	 kamego; sephetho;  phetha; 
effected	 phethagaditše;  amegile; phethile; 
effective	kgontšhago; 
effectively	 ka maleba; gabotse; 
effectiveness	ka maleba; 
effects	diabe;  dikamego; diphetho;  phetha; 
efficacy	go kgona; 
efficiency	bokgoni; 
efficient	kgonago;  ya bokgoni; 
efficiently	ka bokgoni; 
effort	teko; 
efforts	 maiteko; diteko; 
eight	seswai; 
either	 e kaba; goba; 
elderly	motšofadi; 
elders	batšofadi; 
elect	kgetha; 
elected	kgethile; 
election	 kgetho; dikgetho; 
elections	dikgetho; 
electoral	 ya dikgetho; bakgethi; 
electrical	ya mohlagase; 
electricity	mohlagase; 
electrification	go tsenya mohlagase; 
electronically	ka mohlagase; 
elects	kgetha; 
element	 seripa;  elemente; setho; 
elements	kokwane; 
elevate	phagamiša; 
eleven	lesometee; 
eligible	 go ba maleba; go ba le maloka; 
eliminate	 tloša; ntšha; 
eliminated	 tlošitše; ntšhitše tšhelete; 
elimination	tlošo; 
eloquently	ka bothakga; 
else	go gongwe;  yo mongwe;  se sengwe; 
elsewhere	go gongwe; 
emanating	ye e bakwago;  ye e tšwago; 
emancipation	tokollo; 
embark	 thomiša; swara; 
embarked	swere;  thomišitše; 
embarking	 thomiša; swara; 
embassies	 dikantoro tša botseta; botseta; 
embassy	 kantoro ya botseta; botseta; 
embed	sobeletša; 
embedded	sobeleditše; 
emblem	 leswao; seka; 
embodiment	setheka; motheo; 
embrace	gokara;  akaretša; 
embraced	gokere;  akareditše; 
embraces	gokara;  akaretša; 
emerge	tšwelela; 
emerged	tšweletše; 
emergence	go tšwelela; 
emergency	 tšhoganetšo; tšhoganyetšo; 
emergent	setšweledi; 
emerging	tšwelela; 
eminent	molaleng; 
emission	go ntšha muši;  muši; 
emissions	go ntšha meši;  muši; 
emoluments	moputso;  ditefo; 
emotion	maikutlo;  khuduego; 
emotional	ya maikutlo; 
emotions	maikutlo;  dikhuduego; 
emphasis	kgatelelo; 
emphasise	gatelela; 
emphasised	gateletše; 
emphasises	gatelela; 
employ	thwala;  thapa; 
employed	thapile;  thwetše; 
employee	mošomi; 
employees	bašomi; 
employer	mothwadi; 
employers	 bengmešomo; bathwadi; 
employing	thwala;  thapa; 
employment	 mošomo; thapo; 
employs	thwala;  thapa; 
empower	maatlafatša; 
empowered	maatlafaditšwe; maatlafaditše; 
empowering	maatlafatša; 
empowerment	matlafatšo; 
empty	kgothola;  senago selo; 
emulate	ekiša; 
en	lebati; 
enable	kgontšha; 
enabled	kgontšhitše; 
enables	kgontšha; 
enabling	kgontšha; 
enact	bea molao; 
enacted	beile melao; 
enacting	bea molao; 
enactment	taelo; 
enactments	 phethagatša, tsenya tirišong; laela; 
encourage	kgothaletša;  hlohleletša; 
encouraged	hlohleletša;  kgonthišitše; 
encourages	kgothaletša;  hlohleletša; 
encouraging	kgothaletša;  hlohleletša; 
end	bofelo;  phetho; 
endangered	tlaletšwe; 
endeavor	leka; 
endeavour	leka; 
endeavours	leka; 
ended	 fedile maatla; phethile; 
ending	bofelo; 
endorse	saena; 
endorsed	saenetše ; 
endorsement	thekgo; 
ends	mafelo;  diphetho; 
enduring	 hlaka; sokola; kgotlelela; 
energy	maatla;  mafolofolo; 
enforce	tiiša; 
enforced	tiišeditše; 
enforcement	maatlafatšo; 
engage	boledišana;  rerišana; 
engaged	rerišane;  boledišane; 
engagement	 poledišano; nyalano;  therišano; 
engagements	 ditherišano; dipoledišano; dinyalano; 
engaging	rerišana; 
engender	 feletša; baka;  hlola; 
engendering	 feletša; baka;  hlola; 
engine	entšene; 
engineer	šušumetša; 
engineering	boentšeneere; šušumetša; 
engineers	baentšeneere; šušumetša; 
enhance	oketša; 
enhanced	okeditše; 
enhancement	maatlafatšo; 
enhancing	oketša; 
enjoy	ipshina; 
enjoyed	ipshinne; 
enormous	kgolo;  ntši; 
enough	lekane; 
enquiries	dinyakišišo; 
enquiry	nyakišišo; 
enrich	humiša; 
enrol	ngwadiša; 
enrolled	ngwadišitše; 
enshrined	beilwego; 
ensue	latela; 
ensuing	latela; 
ensure	kgonthiša; 
ensured	kgonthišitše; 
ensures	kgonthiša; 
ensuring	kgonthiša; 
entail	hlola; 
entails	hlola; 
entered	tsentšwe; 
entering	tsenya; 
enterprise	bogwebi; 
enterprises	dikgwebo; 
enters	wa tsenya; 
entertainment	boithabišo; 
entire	 ka moka; boreledi; 
entirely	ka botlalo; 
entities	dihlongwa;  ditheo; 
entitled	lebane; 
entity	setheo; sehlongwa; 
entrance	 botseno; matseno; 
entrepreneur	setsebakgwebo; 
entrepreneurial	 ya kgwebo; ya bogwebi; 
entrepreneurs	batsebakgwebo; 
entrepreneurship	bogwebi; bothomi bja kgwebo; 
entries	ditlhabelelo;  ditsenyo; 
entrusted	filwe maatla; 
entry	tlhabelelo; 
envelope	enfelopo; 
environment	tikologo; 
environmental	ya tikologo; 
environments	ditikologo; 
envisage	ukama; 
envisaged	ukangwe; 
envisages	ukama; 
epidemic	leuba; 
equal	lekana;  lekanago; 
equality	tekatekano; 
equally	ka go lekana; 
equals	e lekana le; 
equipment	ditlhamo;  didirišwa; 
equipped	maatlafaditšwe; hlamile; 
equitable	ya tekatekano; 
equity	tekatekano; 
equivalent	lekanego;  tekano; 
era	 lebaka;  sebaka; nako; 
eradicate	 fediša; tloša; 
eradicating	 fediša; tloša; 
eradication	phedišo; 
error	phošo; 
errors	diphošo; 
escape	tšhaba; 
escapes	tšhaba; 
especially	gagolo; 
essence	bokgonthe bja tirelo;  senatefiši; 
essential	nyakegago;  sehlokwa; 
essentially	 ye bohlokwa; ka bohlokwa; 
establish	hloma; 
established	hlomile; 
establishes	hloma; 
establishing	hloma; 
establishment	 sehlongwa; setheo; motheo; 
establishments	dihlongwa;  metheo;  ditheo; 
estate	bohwa; 
estates	bohwa; 
esteemed	 ba ba hlomphegago; yo a hlomphegago; 
estimate	 lekanyetša; akanya;  tekanyetšo; 
estimated	 lekanyeditše;  lekantšwe; akantše; 
estimates	 ditekanyetšo;  lekanyetša; akanya; 
et	ka; 
ethical	ya maitshwaro; 
ethics	 melawana ya boitshwaro; setho; 
ethnic	 serafe; morafe; 
ethnicity	 bohlobo; morafe; 
ethos	mekgwa;  maitshwaro; 
evaluate	lekola; 
evaluated	lekotše; 
evaluating	lekola; 
evaluation	tekolo; 
eve	bošegong; 
even	 lekanetšego; lekana; 
evening	 mantšiboa; mathapama;  bošego; 
event	karolwana;  tiragalo; 
events	ditiragalo;  dikarolwana; 
eventually	mafelelong; 
ever	le gatee; 
every	ye nngwe le ye nngwe;  o mongwe le o mongwe;  se sengwe le se sengwe; 
everybody	yo mongwe le yo mongwe; 
everyone	yo mongwe le yo mongwe; 
everything	se sengwe le se sengwe; 
evidence	bohlatse; 
evident	 phatlalatša;  pepeneneng; molaleng; 
evolve	gola; 
evolved	gotše;  akareditše; 
evolving	gola; 
ex	 ya peleng; fetilego; 
exactly	thwii; 
examination	tlhahlobo; 
examinations	ditlhahlobo; 
examine	hlahloba;  lekodišiša; 
examined	hlahlobile; lekodišišitše; 
example	mohlala; 
examples	mehlala; 
exams	ditlhahlobo; 
exceed	feta; 
exceeded	fetile; 
exceeding	fetago; 
exceeds	feta; 
excelled	fetišištše; kgonne;  phadile; 
excellence	 go tseba; bokgoni;  ka bokgoni; 
excellent	 botse ka go fetiša; phalago; 
except	tlogela; 
exception	learogi; 
exceptional	ya moswananoši; 
excessive	ya go fetišiša; 
exchange	 phetošetšo;  tšhentšhišo; neelana;  papatšo; 
exchanges	ananya; ditšhentšhišo; neelana; diphetošetšo;  dipapatšo; 
excise	 tšhomo;  mošomo; tiro; 
excitement	khuduego; 
exciting	e huduago; 
exclude	tlogela; 
excluded	tlogetše; 
excludes	tlogela; 
excluding	tlogela; 
exclusion	go se akaretše; 
exclusions	go se akaretše; 
exclusive	ye sa akaretšeg; ya bonoši; 
exclusively	 ka go se akaretše; ka bonoši; 
execute	 phethagatša; diragatša; 
executed	diragaditše; phahagaditše; 
executing	 phethagatša; diragatša; 
execution	phethagatšo; 
executor	moabalefa; 
exempt	lokolla; 
exempted	lokollotše; 
exemption	tokollo; 
exemptions	ditokollo; 
exercise	 thutišo;  hlabolla;  thapolla;  kotlollo; tlhabollo;  boitšhidullo;  itšhidulla; 
exercised	thapollotše;  hlahlobile; otlollotše; hlabollotše; itšhidullotše; rutile; 
exercises	 mešomo; mediro; 
exercising	 thutišo;  hlabolla;  thapolla;  dikotlollo; tlhabollo;  boitšhidullo;  itšhidulla; 
exhibit	sebontšhwa; 
exhibition	pontšho; 
exhibitions	dipontšho; 
exile	 molahlwa; raka;  tahlo; 
exist	 go ba goba; go ba gona; 
existed	bile gona; 
existence	go ba gona; 
existing	kgahliša; 
exists	 go ba goba; go ba gona; 
exit	botšo; mojako;  etšwa; 
expand	 katološa; katologa; 
expanded	katološitšwe; 
expanding	 katološa; katologa; 
expansion	katologo;  katološo; 
expect	letela; 
expectation	tebelelo;  tetelo; 
expectations	ditetelo;  ditebelelo; 
expected	 emetše; letela; 
expedient	ya go direga; 
expenditure	tshenyegelo; 
expense	tshenyegelo; 
expenses	ditshenyegelo; 
expensive	tura; 
experience	boitemogelo;  itemogela; 
experienced	itemogetše; 
experiences	maitemogelo; 
experiencing	boitemogelo;  itemogela; 
expert	setsebi; 
expertise	 botsebi; tsebo; 
experts	ditsebi; 
expiration	khemelontle; 
expired	feletšwe ke nako; 
expiry	go felelwa ga nako; 
explain	hlaloša; 
explained	hlalošitše; 
explains	hlaloša; 
explanation	tlhathollo;  tlhalošo; 
explicit	ya phatlalatša; ya molaleng; 
exploitation	go šomiša bošaedi; 
explore	utolla; 
explored	utullotše; utollotše; 
explores	utolla; 
exploring	utolla; 
expo	pontšho; 
export	kišontle;  gwebela; 
exports	diyantle; 
expose	pepentšha; 
exposed	pepentšhitše; 
exposure	kutollo; 
express	hlagiša;  mafofonyane; 
expressed	fofišitšwe; hlagišitše; 
expression	tlhagišo; 
expressions	ditlhagišo; 
expressly	ka taetšo; 
extend	katološa; 
extended	katološitšwe; 
extending	katološa; 
extends	katološa; 
extension	koketšo;  katološo; 
extensive	katološo; 
extent	 go fihla; bogolo; 
external	ntle;  (sa/ya) ka ntle;  ya ka ntle; 
extra	koketšo;  ka godimo ga; 
extract	 ntšha; setsopolwa;  kgola; 
extraordinary	ya go se tlwaelege; 
extreme	kudukudu; 
extremely	kudukudu; 
eye	leihlo;  lešoba la nalete; 
eyes	mahlo; 
face	 bokapele bja lešela;  selebaneng; lehlakore;  sefahlogo;  sefahlego; 
faces	 difahlego; mahlakore;  bokapele bja lešela; dilebaneng; 
facie	ya sefahlego; 
facilitate	letefatša;  sepediša; 
facilitated	letefaditše; nolofaditše; sepedišitše; 
facilitates	letefaditše; sepediša; 
facilitating	letefatša;  sepediša; 
facilitation	thuša;  nolofatša; 
facilities	dinolofatši; 
facility	sedirišwa; 
facing	lebeletše; 
facsimile	fekese; 
fact	ntlha; 
factor	lebaka; 
factors	dikatišani; mabaka;  dihlodi; 
factory	fapriki; 
facts	dintlha; 
fail	go šitwa;  go palelwa; 
failed	 paletšwe; padile; 
failing	go šitwa;  go palelwa; 
fails	go šitwa;  go palelwa; 
failure	palelo; 
failures	dipalelo; 
fair	lokilego; 
fairly	ka potego; 
fairness	 go hloka bošaedi; potego; 
faith	tumelo; 
fall	wa; 
fallen	wele; 
falling	theoga; 
falls	wa; 
familiar	tsebegago; 
families	maloko;  malapa; 
family	 lapa; leloko; 
famous	tsebegago; 
fan	morati; 
far	kgole; 
farewell	taelo;  taelano; 
farm	 polase; lema; 
farmer	 rapolase; molemi; 
farmers	 borapolase; balemi; 
farming	bolemi; 
farms	 dipolase; lema; 
fashion	sebjalebjale; 
fast	ikona; 
father	tate;  rra; 
fathers	borra;  botate; 
fault	go laetša phošo;  phošo; 
favorite	mmamoratwa; 
favorites	bommamoratwa; 
favour	mogau; 
favourable	ya mamoratwa; ya go ratwa; 
favourite	mmamoratwa; 
fax	fekse; 
faxed	fekesitše; 
fear	poifo; 
fears	boifa; 
feasibility	kgonagalo; 
feature	 ponego;  taodišwana; seka; 
featured	 bontšhitšwe; sekile; laodišitšwe; 
features	 diponego;  ditaodišwana; dika; 
featuring	laodiša; 
federal	bofeterale; feterale; 
federation	tshwaragano; 
fee	tefelo;  tefo; 
feed	fepa; 
feedback	pego ya mohlagase; 
feeds	fepa; 
feel	maikutlo;  kwa; 
fees	ditefelo;  ditefo; 
fell	wele;  wetše; 
fellow	mogwera;  mogagešo; 
felt	kwele; 
female	 botshadi; mosadi;  tshadi; 
females	basadi;  ditshadi; 
festival	monyanya; 
festivals	difesetibale;  menyanya; meletlo; 
festive	ya monyana;  ya monyanya; 
fever	phišo ya mmele;  phišo; 
few	nene;  e sego kae; 
fewer	nnyane;  mmalwa; 
field	karolo;  kampa;  tšhemo; 
fields	dikarolo;  dikampa;  mašemo; 
fifth	ya bohlano; 
fifty	masomehlano; 
fight	ntwa; 
fighter	molwi; 
fighters	balwi; 
fighting	lwa; 
figure	palo;  sethalwa; 
figures	dipalo;  dithalwa;  dikapolelo; 
file	faele;  feila; 
filed	feitše; gohlile; faetše; 
files	 difeila; digohli; difaele; 
filing	gohla; faela;  feila; 
fill	tlatša; 
filled	tletše;  tladitše; 
film	filimi; 
filmmakers	badiradifilimi; 
filmmaking	go dira difilimi; 
films	matlalwanasese; difilimi; 
filter	filthara; 
final	makgaolakgang; 
finalisation	go phetha;  go fetša; 
finalise	 fediša; go phetha; 
finalised	feditše; 
finalising	fetša; 
finally	mafelelong; 
finance	go fa tšhelete;  tšhelete; 
financed	thušitše ka mašeleng; 
finances	ditšhelete; 
financial	(ya) matlotlo; 
financially	 ka ditšhelete;  ya ditšhelete; ditšheleteng; 
financing	go thuša ka mašeleng; 
find	hwetša; 
finding	kutollo;  khwetšo; 
findings	dikutollo;  dikhwetšo; 
finds	hwetša; 
fine	 lefiša;  tefo;  go hlakile;  tefišo; mafelelo;  thelela; 
fines	 otla;  ditefišo; dikotlo;  lefiša; 
finest	thelela kudu;  go hlakile kudu; 
fingerprints	dikgatišo tša menwana; 
fire	mollo; 
firearm	sethunya; 
firearms	dithunya; 
firm	tiilego;  ye e tiilego; 
firmly	ka tiišetšo; 
firms	tše tiilego; 
first	(ya) mathomo; 
firstly	 la mathomo; mathomong;  sa mathomo; 
fiscal	ya ditšhelete tša mmušo; 
fish	hlapi; 
fisheries	maruahlapi; 
fishery	boruahlapi; 
fishing	go rea dihlapi; 
fit	itekanela;  go swanela; 
fitting	tsenago;  lekanago; 
five	hlano; 
five-year	mengwaga ye mehlano; 
fixed	lokišitšwe; 
flag	 folaga; sefoka; 
flags	difoka;  difolaga; 
flagship	motheo;  se bohlokwa; 
flame	kgabo; 
flood	meetsefula; 
floods	mafula;  meetsefula; 
floor	lebato; 
flora	 dimedi; dimela; 
floral	la matšobana; 
flow	kelelo; 
flower	letšoba; 
flows	ela; 
fly	 ntšhi; fofa;  ntši; 
flying	fofa; 
focus	lebanya; 
focused	lebantše; 
focuses	lebanya; 
focusing	lebanya; 
follow	 latela; thekga; 
followed	thekgile;  latetše; 
following	latelago; 
follows	 latela; thekga; 
food	dijo; 
foot	kgato;  leoto;  lenao;  nao; 
football	bolo; 
footsteps	 dikgato tša maoto; dikgato;  mehlala; 
for	ya;  sa; 
force	maatla;  gapeletša; 
forced	gapeleditšwe;  gapeleditše; 
forces	maatla;  gapeletša; 
forebears	badimo; 
forefront	 ka pele; pele; 
foreign	-šele; 
foreigner	motšwantle; 
foreigners	batšwantle; 
forensic	tlhahloboditopo; forensiki; 
forest	 sekgwa; sethokgwa; 
forests	dithokgwa;  dikgwa; 
forever	sa ruri; 
forfeited	gafetše;  lahlegetšwe; 
forfeiture	tahlegelo; 
forge	 bothulelo; rula; 
forged	rutše; ekišitšwe; 
forget	lebala; 
form	 hlama; sebopego;  bopa;  fomo;  panka; 
formal	ka molao; 
formally	ka semmušo;  ka tlwaelo; 
format	 sebopego; fomete; mokgwa; 
formation	 popego;  peakanyo ya babapadi ka lepatlelong; tlhamo;  sehlopha sa babini; 
formations	ditlhamo;  dipopego;  dihlopha sa babini;  dipeakanyo tša babapadi ka lepatlelong; 
formed	 bopile; fomile;  bopegile; hlamile; 
former	(wa) pele; 
formerly	 ya mathomong;  ye fetilego; peleng; 
forms	 hlama; bopa;  dibopego;  fomo; 
formula	fomula;  kaelo; 
formulation	 tlhamo; peakanyo; 
forth	pele; 
forthcoming	 ye e latelago; ye e tlago; 
forthwith	semeetseng;  ka potlako;  ka pela; 
forums	diforamo; 
forward	pele; 
forwarded	išitšwe; 
fossil	fosili; 
foster	godiša; 
fostering	godišitše; 
fought	lwele; 
found	go hlama; 
foundation	motheo; 
foundations	metheo; 
founded	hlamile; 
founder	mothei; 
founding	go hlama; 
four	nne; 
fourth	bonneng;  ya bonne; 
frame	 freime; motheo; 
framework	tlhako; 
frameworks	ditlhako; 
franchise	lengwalo la thekišo;  maloka a go bouta; 
fraternity	lefapha;  legoro; 
fraud	boradia;  bomenetša;  tsogolekobong; 
fraudulent	 ya boradia;  ya bomenetša; ya tsogolekobong; 
free	 mahala; lokolla; 
freed	lokollotšwe; 
freedom	 go sepela ka tokologo; tokologo; 
freedoms	ditokologo; 
freely	ka tokologo; 
freight	morwalo;  tefamorwalo; 
frequency	boipoeletšo; 
frequently	gantši; 
fresh	lebese; 
friend	mogwera; 
friendly	ka segwera; 
friends	bagwera; 
friendship	bogwera; 
from	go tšwa go; 
front	pele; 
fruit	seenywa; 
fruitful	 ya mohola; ya thušo; 
fuel	sebešwa; 
fuels	dibešeletši; dibešwa; 
fulfil	phethagatša; 
fulfill	phethagatša; 
fulfilling	phethagatša; 
full	tletše; 
full-time	dinako ka moka; 
fully	ka botlalo; 
function	mohola;  tirišo;  tiro;  šoma;  moletlo; 
functional	ya mošomo;  ya go šoma; 
functionality	tšhomo; 
functioning	 tirišo; dira;  šoma; 
functions	 šoma;  mehola;  ditirišo; ditiro;  meletlo; 
fund	matlotlo; 
fundamental	theo; 
fundamentally	ye bohlokwa;  ya motheo; 
funded	thušitše ka matlotlo; 
funding	matlotlo; 
funds	ditšhelete;  mašeleng; 
funeral	poloko; 
furnish	efa; 
furnished	file; 
furniture	fenitšhara; 
further	go tšwela pele; 
furthermore	go ya pele;  go tšwela pele; 
future	 letlagokgauswi;  letlagokgole; bokamoso; 
gain	 boelwa; poelo; 
gained	 boetšwe; hweditše; 
gains	 boelwa; dipoelo; 
gala	moletlo; 
galleries	dikalari; mafelo a go laetša bokgabo; 
gallery	lefelo la go laetša bokgabo; 
gamble	-go leka mahlatse;  tekomahlatse; 
gambling	 tekomahlatse; go leka mahlatse; 
game	 diphoofolo tša lešoka; diphoofolo;  papadi; 
games	dipapadi; 
gap	sekgoba; 
gaps	dikgoba; 
garden	serapa; 
gardens	dirapa; 
garnishee	mokgopelatšhelete; 
gas	kgase; 
gateway	sefata; 
gather	kgobokanya; 
gathered	kgobokantše; 
gathering	kopano;  seboka; 
gave	file; 
gazette	kuranta ya mmušo; 
gear	kere; 
geared	lebile; 
gender	bong; 
gender-based	ye theilwego go bong; 
general	 akaretšago; molaodi; 
generally	ka kakaretšo; 
generate	tšweletša; 
generated	tšweleditše; 
generating	tšweletša; 
generation	 tšweletšo; moloko;  dithaka; 
generations	 ditšweletšo; meloko;  dithaka; 
genre	mohuta wa botaki; 
genres	mehuta ya botaki; 
gentlemen	lesogana;  mohlomphegi; 
geographic	ya boikalo bja lefase; 
geographical	ya thutafase; 
geography	thutafase; 
get	hwetša; 
gets	hwetša; 
getting	hwetša; 
giant	mogale;  senatla; 
gift	mpho;  neo; 
girl	ngwanenyana; 
girls	 banenyana; basetsana; 
give	 efa; fa; 
given	file; 
gives	 efa; fa; 
giving	 efa; fa; 
glad	thabile;  thakgetše; 
glass	galase; 
global	ya lefase; 
globally	lefase ka bophara; 
globe	lefase;  nkgokolofase;  nkgokolo; 
glory	tumišo; 
glossary	mantšu; 
go	ya; 
goal	 nepo; maleba;  kgolego;  tebanyo; 
goals	 ditebanyo; maleba; dinno;  dinepo; 
goes	ya; 
going	ya; 
gold	gauta; 
golden	ya gauta; 
gone	 sepetše; ile; 
good	 botse; gabotse; 
goods	dithoto;  phahla; 
got	humane; hweditše; 
govern	 -buša; buša; 
governance	pušo; 
governed	-bušitše;  bušitše; 
governing	buša; 
government	mmušo; 
government's	ya mmušo; 
governments	mebušo; 
governor	mmušiši; 
governors	babušiši; 
grace	lešoko; 
grade	 hlopha; sehlopha;  mphato; 
grades	dihlopha;  hlopha;  mephato; 
grading	hlaola; 
graduate	aloga;  sealoga; 
graduates	dialoga; 
grand	 ye kgolo; kgolo; 
grant	 thušo; mphiwafela; 
granted	filwe fela;  dithušo; 
granting	 thuša; fa; 
grants	 dithušo; mphiwafela; 
graphic	ya go thalwa; sethalwaa; 
grass	bjang; 
grassroots	botšo;  motheo; fase; 
grateful	leboga;  lebogile; 
gratitude	tebogo;  malebo; 
grave	lebitla; 
graves	mabitla; 
great	 thakgetše; gabotse;  kgolo; 
greater	kgolwane; 
greatest	kgolokgolo; 
greatly	kudu;  kgolo;  gagolo; 
green	talamorogo; 
greetings	madume; 
grew	 metše; gotše;  bjetše; 
grind	šila; 
gross	palomoka; 
ground	šitše; 
ground-breaking	ya boithomelo;  ya boitlhamelo; 
groundbreaking	ya boithomelo;  ya boitlhamelo; 
grounds	 mabato; mafase; 
group	 go hlopha; sehlopha; 
groups	dihlopha;  go hlopha; 
grow	bjala;  mela;  gola; 
growing	bjala;  mela;  gola; 
grown	 metše; gotše;  bjetše; 
growth	kgolo; 
guarantee	karanta;  tiišetša; 
guaranteed	 tiišeleditše; tiišeditše; netefaleditše; 
guarantees	tiišetša; 
guard	mohlokomedi; 
guardian	 motlametli;  mofepi; mohlokomedi; 
guest	moeti; 
guests	baeti; 
guidance	tataišo; 
guide	 mohlahli; hlahla; 
guided	hlahlilwe;  hlahlile; 
guideline	tlhahli; 
guidelines	ditlhahli; 
guides	ditlhahli; bahlahli;  hlahlile; 
guiding	hlahla; 
guilt	molato; 
guilty	molato; 
gun	sethunya; 
had	bile; 
hail	sefako; 
hailed	nele ka sefako; 
hails	difako; 
half	seripagare; 
hall	holo; 
hand	seatla;  lenakana; 
handed	ya seatla;  ya lenakana; 
handing	seatla;  lenakana; 
handle	mokgoko; 
handled	ya mekgoko; 
handling	rarolla;  tshwaro; 
handover	kgafelo; 
hands	 manakana; diatla; 
happen	 diragala;  hlaga; direga; 
happened	 hlagile; diragetše; diregile; 
happening	 diragala;  hlaga; direga; 
happens	 diragala;  hlaga; direga; 
happy	legae la kagišano;  thakgetše; 
harassment	kgobošo;  tlaiša;  komanyo;  go omanywa; 
hard	gaboima; 
hare	mmutla; 
harm	kweša bohloko; 
harmful	 ya kotsi; senyago; 
harmony	kwano; 
has	 na le; o; 
hatred	lehloyo; 
have	bile le; 
having	 na le; o; 
hazardous	ye kotsi; 
he	yena; 
head	hlogo; 
headed	ya hlogo; 
heading	 sehlogo; hlogo; 
headline	dintlha tša ditaba; 
headlines	dintlha tša ditaba;  dihlogo tša ditaba; 
heads	dihlogo; 
heal	fodiša; 
healing	 fodiša;  okobala; fola; 
health	maphelo;  bophelo;  go phela gabotse;  maphelo,; 
healthcare	tlhokomelo ya maphelo; 
healthy	phedilego gabotse;  go phela gabotse; 
hear	kwa;  theeletša; 
heard	kwele; 
hearing	go kwa; 
hearings	go kwa; 
hears	kwa;  theeletša; 
heart	pelo;  garegare; 
heavy	boima;  ya boima; 
hectare	hektare; 
hectares	dihekthara; 
height	bogodimo;  bogodimo bja mmoto; 
heights	bogodimo;  bogodimo bja mmoto; 
held	swere; 
help	thuša;  thušo; 
helped	thušitše; 
helping	sesola; 
helps	thuša; 
hence	ka lebaka leo; 
her	yena; 
heraldry	tlhathollo ya difoka; 
here	mo; 
hereby	 fa; mo; 
hereinafter	ka morago ga fa;  ka morago ga mo; 
heritage	bohwa; 
hero	mogale; 
heroes	bagale; 
heroine	mogale; 
heroines	mogale; 
herself	yena;  ka boyena; 
hi	 thobela; dumela; 
hidden	fihlilwe; 
hide	mokgopa; 
hierarchies	ditatelano; 
high	godimo; 
high-level	maemo a godimo; 
higher	godingwana; 
highest	godimodimo; 
highlight	haelaeta; lemoša; 
highlighted	lemošitše; haelaetile; 
highlights	ditemošo; dihaelaete; 
highly	godimo;  ka tlhompho; 
hill	mmoto; 
hills	meboto; 
him	yena; 
himself	yena;  ka boyena; 
his	ya gagwe; 
historian	mohistori; 
historians	bahistori; 
historic	 ya go se lebalwe; ya histori; 
historical	(tša) histori; 
historically	 ya go se lebalwe; ya histori; 
histories	ditiragalo;  dihistori; 
history	ditiragalo;  histori; 
hit	betha;  koša ye bose; 
hoc	nakwana; 
hold	swara;  lephako; 
holder	mong; 
holders	 diswaro; beng; 
holding	 yo a swerego; ye e laolago; 
holdings	setlamo;  setlemo; 
holds	swara; 
holiday	makhutšo; 
holidays	makhutšo; 
holistic	ya kakaretšo;  ka kakaretšo; 
homage	 go gopola; gopola; 
home	legae; 
homelessness	go hloka legae; 
homepage	letlakala la gae; 
homes	magae; 
hominid	sekamotho; 
honorary	honorari; 
honour	hlompha; 
honourable	mohlomphegi; 
honoured	 ba ba hlomphegago; yo a hlomphegago; 
honouring	go hlompha; 
honours	hlompha;  ditlhompho; onase; 
hope	tshepo;  tshepo/kholofelo; 
hoped	tshepile;  tshepile/holofetše; 
hopefully	ka kholofelo; 
hopes	ditshepo/dikholofelo; ditshepo; 
hospital	 bookelo;  sepetlela; sepetlele; 
hospitality	kabomadulo; kamogelo; 
hospitals	dipetlelea; dipetlele;  maokelo; 
host	monggae; 
hosted	bile monggae; 
hosting	ba monggae; 
hosts	benggae; 
hotel	hotele; 
hotels	dihotele; 
hour	iri; 
hours	diiri; 
house	 ngwako; ntlo; 
housed	 ngwako; ntlo; mmino wa haose; 
household	 ntlo; lapa; 
households	 malapa; dintlo; 
houses	 mengwako; dintlo; 
housing	 kago ya dintlo; dintlo; 
how	bjang; 
however	le ge go le bjale; 
hub	bogare;  pinagare; 
huge	kgolo;  -golo; 
human	 ya botho;  (ya) setho;  ya motho; motho; 
humane	 ya setho; ya botho; 
humanities	dithutobomotho; 
humanity	 ntho;  bomotho; botho; 
humankind	batho;  mohuta wa batho; 
humans	 ya botho; batho;  ya motho; 
humble	ikokobetša; 
humbled	ikokobeditše; 
humility	boikokobetšo; 
hundred	lekgolo; 
hundreds	makgolo; 
husband	babalela; 
icon	aekhone; 
iconic	ya go hlomphega; 
icons	diaekhone;  maswao; 
id	boitšhupo; 
idea	kgopolo; 
ideal	maikemišetšo; 
ideals	maikemišetšo; 
ideas	dikgopolo; 
identical	swanago; 
identification	boitšhupo; 
identified	file;  šupilwe; 
identifies	 šupa; efa; 
identify	 šupa; efa; 
identifying	 šupa; efa; 
identities	boitsebišo; 
identity	boitsebišo; 
if	ge; 
ill	babja; 
illegal	go se be molaong; 
illiteracy	go se tsebe go bala le go ngwala;  go se kgone go bala le go ngwala; 
illness	bolwetši; 
illustrate	 laetša;  tiiša ka mehlala; šupetša; 
illustrated	 tiišitše ka mehlala;  laetša;  bontšhitše; šupeditše; 
image	seswantšho; 
images	diswantšho; 
imagination	kakanyo; 
imbalances	tlhokego ya tekatekano; go se lekalekanele; 
immediate	kgauswane; 
immediately	semeetseng;  ka potlako;  ka pela; 
immensely	 kgolo kudu; kgolo go fetišiša; 
immigration	phalalelo; 
imminent	 molaleng; kgauswi; 
immovable	ya go se šuthe; 
immunisation	 mokgwa wa tshontišo; tlhabelo;  tshoutišo; 
impact	seabe; 
impacts	diabe; 
impaired	golofetše; 
impediments	mapheko;  ditšhitišo; 
imperative	modirišotaelo; 
imperatives	medirišotaelo; 
implement	sedirišwa;  diragatša; 
implementation	tiro;  phethagatšo; 
implemented	 dirišitšwe; diragaditšwe; 
implementing	 diriša; diragatša; 
implements	megoma;  diragatša;  didirišwa; 
implications	diabe; 
implies	ra gore; 
import	 reka ntle;  kgwebišo; ditšwantle; 
importance	 mohola; bohlokwa; 
important	bohlokwa;  e bohlokwa; 
importantly	 tše bohlokwa; se bohlokwa; 
imported	rekile ntle;  tsentše nageng; 
importer	morekantle; 
imports	 reka ntle; ditšwantle; 
impose	tsenyeletša; gapeletša; 
imposed	tsenyeleditše; gapeleditše; 
imposing	tsenyeletša; gapeletša; 
imposition	kgapeletšo; tsenyeletšo; 
impossible	go se kgonagale; 
impressed	kgahlegile; 
impressive	kgahliša;  ya go kgahliša; 
imprison	 go lahlelwa kgolegong; golega; 
imprisoned	 lahletšwe kgolegong; golegile; 
imprisonment	golegwa;  kgolego; 
improper	ka mo e sego maleba;  ye sego maleba; 
improve	lokiša;  kaonafatša; 
improved	 kaonafaditše; lokišitše; 
improvement	tokišo; 
improvements	ditokišo; 
improving	lokiša;  kaonafatša; 
in	gare; 
inability	go palelwa; 
inadequate	sa lekanego; 
inappropriate	sego maleba; 
inaugural	 ya mathomo; ya tlhomo; 
inauguration	hloma semmušo;  tlhomamišo; 
incapable	go se kgone; 
incapacity	go se kgone;  go palelwa; 
incarceration	go golegwa;  go ba kgolegong; 
incentive	 tšhušumetšo; šušumetšago; 
incentives	ditšhušumetšo; 
inception	go thomiša;  go hloma;  go bea; 
incidence	koketšego ya batho bao ba fetšwego ke bolwetši bjoo bo itšego nakong yeo e itšego; 
incident	tiragalo; 
incidental	ka sewelo; 
incidents	ditiragalo; 
include	tsenya;  akaretša; 
included	 tsentšwe; akareditšwe;  tsentše; 
includes	tsenya;  akaretša; 
including	gotee le; 
inclusion	tsenyo; 
inclusive	ya kakaretšo;  ya mang le mang; 
inclusivity	kakaretšo; 
income	ditseno;  puno; 
incomes	ditseno;  dipuno; 
incomplete	ya gos e felele; ya go se phethagale; 
inconsistent	se sepelelane; 
incorporate	tsenya; 
incorporated	tsentšwe; 
incorporates	tsenya; 
incorporation	 go kopanya;  go hloma; sehlongwa; 
incorrect	fošagetše; 
increase	oketša; 
increased	 okeditšwe; okeditše; 
increases	oketša; 
increasing	oketša; 
increasingly	 oketšega; kudu;  go fetišiša; 
inculcate	hlohleletša; 
incurred	hweditše; 
indeed	ka nnete; 
independence	boipušo; 
independent	ipušago; 
independently	ka boikemo;  ya boikemo; 
index	tšhupaboteng; 
indicate	 šupa; laetša; 
indicated	 šupile; laeditše; 
indicates	 šupa; laetša; 
indicating	 šupa; laetša; 
indication	taetšo; 
indications	ditaetšo; 
indicative	taetšo;  ya go laetša; 
indicator	sešupo; 
indicators	dilaetši; dišupo; 
indices	dikoketšo;  tšhupaboteng; dieksponente; 
indigenous	-setala;  ya setlogo; 
indirect	sa lebanyago; 
indirectly	 ka le lengwe;  ka go le lengwe; ka go dikadika; 
individual	mongwe;  (wa) bonoši; 
individually	ka noši; 
individuals	bangwe; 
industrial	sa diatla; 
industries	diintasteri; diintastri; 
industry	intasteri; 
inequalities	tlhokego ya tekatekano; go se lekalekanele; 
inequality	tlhokego ya tekatekano; go se lekalekanele; 
infected	feteditšwe; 
infection	 phetetšo; phetelo; 
infections	diphetetšo; diphetelo; 
inferior	-nyatšegago; 
inflation	infleišene; 
inflows	ditseno;  dikelo; 
influence	tutuetšo; 
influenced	tutueditše; hueditše; 
info	tshedimošo; 
inform	tsebiša; 
informal	lengwalo la segwera;  e sego ka tlwaelo; 
information	 tshedimošo; tsebo; 
informed	ka tsebo;  ya tsebo; 
informing	tsebiša; 
infrastructure	motheo; 
inherent	ya semelo;  ya bohwa; 
inherit	 go ja lefa; abelwa bohwa; 
inherited	ja lefa;  abetšwe bohwa; 
initial	 tlhakapele;  saenatlhakapele; pele; 
initially	 mathomong; peleng; 
initiate	 thomiša;  tsebiša; tlwaetša; 
initiated	thomišitše; 
initiative	boithomedi; 
initiatives	boitšhimolliši; boithomedi; 
initiator	mothomiši; 
injuries	dikgobalo; 
injury	kgobalo; 
injustice	tlhokatoka; 
injustices	ditlhokatoka; 
inmates	badulammogo; bagolegwa; 
inner	sedikogare; 
innovation	boithomelo; 
innovative	go ithomela; 
inputs	ditsenywa;  tsenya tshedimošo khomphutheng;  tshedimošo ka khomphutheng; 
inquest	nyakišišosemolao; 
inquiry	nyakišišo; 
inscribed	ngwadilwe; 
insert	tsenya;  tsentšha; 
inserted	tsentše nageng;  tsentšhitše; 
insertion	tsenyo; 
inserts	tsenya;  tsentšha; 
inside	bokagare; 
insight	 tshedimošo; tsebo; 
insights	ditsebo;  tshedimošo; 
insolvency	 go wa; go phuhlama; 
insolvent	welego; 
inspect	hlahloba; 
inspection	tlhahlobo; 
inspections	ditlhahlobo; 
inspector	mohlahlobi; 
inspectorate	lekala la tekodišišo;  lekala la tlhahlobo; 
inspectors	bahlahlobi; 
inspiration	go fa mafolofolo; 
inspire	hlohleletša; 
inspired	hlohleleditše; 
inspiring	hlohleletša; 
install	hloma;  beakanya; 
installation	go beakanya; 
installed	 beakantše; hlomile; 
instalments	dikompetšo; direfelo tša kgwedi; 
instance	mohlala; 
instances	mehlala; 
instead	sebakeng seo; 
institute	sehlongwa; 
instituted	hlomilwe; 
institution	kago; 
institutional	ya setheo; ya sehlongwa; 
institutions	dihlongwa;  dikago; 
instruction	thuto;  taelo; 
instructional	 sa taelo; ya taelo; 
instructions	ditaelo; 
instrument	 sedirišwa; seletšo; 
instruments	diletšo;  didirišwa; 
insurance	inšorense; 
insurer	monginšorentshe; 
intangible	ya go se kgomiwe; 
integral	(ya) botlalo; 
integrate	 loganya; tsentšha; 
integrated	 tsentšhitše; logantše; 
integration	kopanyo; 
integrity	seriti; 
intellectual	 motho yo bohlale; bohlale; 
intellectuals	batho ba bohlale; 
intelligence	 bohlodi; bohlale; 
intend	ikemišetša; 
intended	ikemišeditše; 
intends	ikemišetša; 
intensify	 godiša;  tiiša; maatlafatša; 
intent	 maikemišetšo; ikemišetša; 
intention	maikemišetšo; 
intentionally	ka maikimišetšo; 
inter	magareng; 
interact	tsenelana; 
interacting	tsenelana; 
interaction	tsenelelano; 
interactive	kgokagano; 
interception	tšhitišo; 
interdepartmental	 ya magareng ga dikgoro; ya magareng ga mafapha; 
interest	kgahlego;  kgahla;  dikgahlegelo;  tswalo;  tswala; 
interested	 ba le kgahlego; kgahlegile; 
interesting	natefelago; 
interests	 kgahla;  dikgahlegelo; ditswala; ditswalo; dikgahlego; 
interfaith	 ditumelo tše di fapanego; ditumelo tša mehutahuta; 
interfere	 šitiša; tsenatsena; 
interference	tsenatseno; 
intergenerational	ya metswalo ye e fapanego; 
intergovernmental	ya mebušo ye e fapanego; 
interim	 (ya) sebakana; sebakana; 
intermediaries	ba magareng; 
intermediary	wa magareng; 
intermediate	wa magareng; 
intern	motlwaetšwakalafo; 
internal	ya ka gare;  ka gare; 
international	boditšhabatšhaba; 
internationally	ya boditšhabašhaba; 
internet	inthanete; 
interns	batlwaetšwamešomo; 
internship	 go ithutela mošomo; thutelamošomo; 
interpret	hlatholla;  toloka; 
interpretation	tlhathollo; 
interpreted	hlathollotše; tolokile; 
interrogate	botšiša;  botšišiša; 
interval	paka;  kgala; 
intervals	dikgala; dinakokgaotšo; dipaka; 
intervene	tsena gare; 
intervention	tsenogare; 
interventions	ditsenogare; 
interview	 teko; morero; 
interviews	 diteko; merero; dipotšološišo; 
intestate	mohlokawili; wa go hloka wili; 
into	 ka go; go; 
introduce	tsebiša; 
introduced	tsebišitše; 
introducing	tsebiša; 
introduction	 tlhagišo ya molaokakanywa; matseno; 
invalid	ya go se šome;  ye sa šomego; 
invaluable	sa bohlokwa; 
inventory	lenaneong; 
invest	boloka;  go beeletša; 
invested	 beeleditše; bolokile; 
investigate	nyakišiša;  go nyakišiša; 
investigated	nyakišišitše; 
investigating	nyakišiša;  go nyakišiša; 
investigation	nyakišišo; 
investigations	dinyakišišo; 
investigative	ya go nyakišišwa;  ya nyakišišo; 
investigator	monyakišišo; mofatišiši; 
investigators	banyakišiši; 
investing	boloka;  go beeletša; 
investment	peeletšo; 
investments	dipeeletšo; 
investor	mmeeletši; 
investors	babeeletši; 
invitation	taletšo; 
invite	laletša; 
invited	laleditše; 
invites	laletša; 
inviting	laletša; 
involve	 kgatha tema; ama;  akaretša; 
involved	akareditše; amile; 
involvement	go ama;  kakaretšo;  go kgatha tema; 
involves	 kgatha tema; ama;  akaretša; 
involving	 akaretšago; amago; 
iron	 aene; tshipi;  šidila;  tšhipi; 
irregular	arogilego; 
irregularities	diphapogo;  go tshela molao;  ditshenyo;  go tšwa taolong; 
irregularity	 phapogo;  tshela molao;  go tšwa taolong; tshenyo; 
irrespective	go sa bale;  go sa akaretšwe; 
irrigation	nošetšo; 
is	ke; 
isiXhosa	Sethosa; 
island	sehlakahlaka; 
issue	tabakgolo;  tlhagišo; 
issued	hlagišitšwe; 
issues	dineelo; 
issuing	 hlagiša; fa; 
it	yona; 
it's	ya yona; 
item	selo;  hlogwana; 
items	 dihlogwana; dilo; 
its	ke; 
itself	ka boyona; 
jewellery	dibenyabje; 
job	mošomo; 
jobs	mešomo; 
join	lomaganya;  hlomaganya; 
joined	lomagantše; hlomagantšwe; 
joining	lomaganya;  hlomaganya; 
joint	 kgomaganyo;  lelokollo; tokollo; 
jointly	mmogo;  ka bobedi;  gotee; 
journalism	bogaši; 
journalist	mmegaditaba; 
journalists	babegaditaba; 
journey	 eta; leeto; 
joy	 mothakgalo; lethabo;  boipshino; 
judge	 ahlola; moahlodi; 
judgement	kahlolo; 
judges	 ahlola; baahlodi; 
judgment	kahlolo; 
judgments	dikahlolo; 
judicial	ya molao;  ya semolao; 
junior	 fasana; nnyane; 
jurisdiction	maatlataolotoka; 
jurisdictions	maatlataolotoka; 
juristic	ya molao;  ya semolao; 
just	fela;  toka; 
justice	toka; 
justified	laeditše toka; 
justify	laetša toka; 
keen	 bogale;  fišega; mafolofolo; 
keep	swara;  ntšha;  tšwela pele; 
keeping	swere;  tšwela pele; 
kept	 tšwetše pele; swere; 
key	 sekgonyollo; khii;  taetši; 
keynote	ye bohlokwa;  se bohlokwa; 
kg	khilokramo; 
kick	 thomiša;  raga; thoma; 
kick-off	go thoma papadi; 
kill	bolaya; 
killed	bolailwe; 
kilometre	kilometara; 
kilometres	dikilometara; 
kind	loka; 
kindly	gaboleta;  ka boikokobetšo; 
king	kgoši; 
kingdom	pušo; 
kings	dikgoši; 
km	khilometara; 
knew	tsebile; 
know	tseba; 
knowing	go tseba; 
knowingly	ka tsebo;  ya tsebo; 
knowledge	tsebo; 
known	ya go tsebja;  ye tsebegago; 
knows	tseba; 
laboratories	dilaporatori; 
laboratory	laporotori; 
labour	dira;  lešoko;  mošomo;  modiro; 
lack	 tlhokego; hloka; 
ladies	basadi;  makgarebe; 
laid	 beetše; beile; 
lake	letsha; 
land	 lefase;  temo;  kotama; naga; 
landfill	sethobolo; 
lands	kadula; dinaga;  tsokama; 
landscape	ponagalo ya naga; 
language	 polelo/leleme; polelo; 
languages	 dipolelo/maleme; dipolelo; 
lapse	 felelwa ke nako; fela; 
large	golo; 
large-scale	kgolo;  bogolo;  ka bophara; 
largely	bogolo;  ka bophara; 
larger	kgolwane; 
largest	kgolokgolo; 
last	bofelo; 
lasting	 ye tšeago nako; ye tšeago lebaka; 
lastly	 sa mafelelo; la mafelelo; 
late	 morago ga nako; yo a hlokofetšego; 
later	moragonyana;  ka moragonyana; 
latest	moragorago;  ya moragorago; 
latter	latelago; 
laughter	ka lešata;  ka kgoeletšo; 
launch	thoma; 
launched	thoma; 
launches	thomišitše; 
launching	thoma; 
laundering	 ebela;  sepela le mebila; sepelasepela; 
laureate	mohlomphegi; moabelwasefoka sa tlhompho; mohlomphiwa; 
laureates	bahlomphegi; baabelwasefioka sa tlhompho; bahlomphiwa; 
law	molao; 
law-making	 ya go dira melao;  ba go dira melao; ba go hlama melao; 
lawful	 ya molao; molaong; 
lawfully	ka molaong; 
laws	melao; 
lawyer	ramolao;  agente; 
lawyers	diagente; boramolao; 
lay	bea;  beela; 
laying	bea;  beela; 
lead	 motato wa morodi; morodi; 
leader	moetapele; 
leaders	baetapele; 
leadership	boetapele; 
leading	etilego pele; 
leads	 metato ya morodi; merodi; 
leaflet	letlakalana; 
leaflets	matlakalana; 
league	setlamo;  liki; 
learn	ithuta; 
learned	ithutile; 
learner	moithuti; 
learners	baithuti; 
learning	go ithuta; 
learnt	ithutile; 
lease	hiriša; 
leased	hirišitše; 
leasehold	madulo a go hirišwa; 
least	nnyane;  bonyane; 
leaves	tloga; 
leaving	tloga; 
lecture	ruta; 
led	etilego pele; 
left	nngele; 
leg	leoto; 
legacies	bohwa; 
legacy	bohwa; 
legal	ya molao; 
legally	ka molao;  ka semolao; 
legend	nonwane; 
legendary	mogale;  wa go tuma; 
legends	dinonwane tša pheteletšannete; dinonwane; 
legislation	bea molao; 
legislative	ya melao; 
legislature	lekgotlatheramelao; 
legislatures	makgotlatheramelao; 
legitimacy	 go ba molaong;  ye e dumeletšwego; ya molaong; 
legitimate	 sa go dumelelwa; wa molaong;  sa molaong; 
lending	go kadula; adima;  go tsokama; 
length	botelele; 
less	nnyane;  ye nyenyane; 
lesser	 fasana; nnyane; 
lesson	thuto; 
lessons	dithuto; 
let	dumelela;  tlogela;  lesa; 
let's	a re; 
letter	lengwalo;  tlhaka;  letere; 
letters	mangwalo;  ditlhaka; 
level	lekalekanya;  tekanetšo;  bogomo;  lekanetša;  lekanetšego;  rapamego; 
levels	 tekanetšo;  lekanetša;  lekalekanya; magomo;  lekanetšego;  rapamego; 
levied	lefišitšwe; 
levies	ditefišo; dillebi; 
levy	llebi; tefišo; 
liabilities	melato; 
liability	boikarabelo;  go ba le maswanedi; 
liable	go ba le boikarabelo;  go ba le maswanedi; 
liaise	 boledišana; kgokagana; 
liaison	 wa poledišano; wa kgokagano; 
liberalisation	tokollo; 
liberation	tokologo; 
librarian	rabokgobapuku;  rabokgobarekoto; 
librarians	borabokgobarekoto; borabokgobapuku; bašomi ba bokgobapuku; 
libraries	makgobarekoto; makgobapuku; 
library	 bokgobarekoto; bokgobapuku; 
licence	laesense; 
licences	dilaesense; 
license	laesense; 
licensed	filwe laesentshe; diretšwe laesentshe; 
licensee	moabelwalaesentshe; mofiwalaesentshe; 
licensees	bafiwalaesentshe; baabelwalaesentshe; 
licensing	go fa laesentshe; go aba laesentshe; 
lie	tsela yeo lesea le robalago ka yona ka popelong; 
lies	ditsela tšeo masea le robalago ka yona ka popelong; 
life	bophelo; 
lifetime	bophelo ka moka;  nakong ya bophelo; 
light	 (ye) bohwefe;  seetša; lesedi;  bofefo;  edilego;  gotetša; 
lighting	lebone; 
like	boka;  go swana le;  bjalo ka; 
likely	 nyakilego; nyakago; 
limit	tekano;  mollwane; 
limitation	kiletšo; 
limitations	dikiletšo; 
limited	kgaoletšwego; 
limiting	tekano;  dira mollwane; 
limits	mellwane;  ditekano; 
line	ala;  mothaladi;  mothalo; 
line'	ala;  mothaladi;  mothalo; 
line-up	beilwe lenaneong;  fotše mothalading; 
lines	mela; 
linguistic	amana le tša maleme; 
link	kgokanyi; 
linkages	dikgokaganyi; 
linked	kopantše; kgopantše; kgokantše; 
linking	kopanya; kgokanya; sekopanya; 
links	dilinki; dikgokagano; 
liquid	seela; 
liquidation	 phedišo; tlhahlamollo; 
liquidator	molikwiteita; 
liquidity	 thekišo; tswalelo; 
liquor	senotagi;  senotagi/bjala; 
list	lenanetheko; 
listed	 beilwe thekong; beile lenaneong; 
listen	theeletša; 
listing	lenaneo;  lenanetheko; 
lists	 bea lenaneong; fa; 
literacy	 bokgoni bja go ngwala le go bala; go tseba ditlhaka; 
literally	 ka boyona;  ka setlogo; ya mathomong; 
literary	ya bongwadi;  ya dipuku; 
literature	 dingwalo; dingwalwa; 
litigation	kgato ya semolao; 
little	nnyane; 
live	phela;  goteditšwego; 
lived	 phetše; goteditšwego; 
livelihoods	maphelo;  mekgwa ya maphelo; 
lives	maphelo; 
livestock	diruiwa; 
living	go phela;  ye phelago; 
load	boima; 
load-shedding	go wa ga mohlagase; 
loan	 kadimo ya tšhelete; kadimo; 
loans	 dikadimo ya tšhelete; dikadimo; 
local	sa gae; 
locally	ya kgauswi;  ya gae; 
locals	tša kgauswi; 
located	yo a dulago;  ye e beilwego;  ye e lego; 
location	lokasi; 
lock-up	ngwakokgolego; 
lodge	 tliša; dula nakwana; 
lodged	 tlišitše; dutše nakwana; 
lodging	 tliša; dula nakwana; 
logistics	lotšistiki; 
long	telele; 
long-term	lebaka le letelele; 
longer	teletšana; 
look	lebelela; 
looked	lebeletše; 
looking	 lebelela; nyaka; 
looks	lebelela; ditebelelego;  dipopo; 
loop	 tharanyo; segole; 
lose	fenywa; 
loss	 phesente ya tahlegelo; tahlegelo; 
losses	ditahlegelo; 
lost	fentšwe; 
lot	ntši; 
lottery	matengwa; 
love	rata; 
loved	ratile; 
lovers	baratani; 
low	fase; 
low-income	letseno la fase; 
lower	fasana;  iša fasana; 
lowest	fasefase; 
ltd	tlemilwego; 
lump	 lekote; sekaku; 
mace	sefoka sa ngwako; 
machine	motšhene; 
machinery	metšhene; 
machines	metšhene; 
macro-economic	ekonomikgolo;  ekonomi e kgolo; 
macroeconomic	ekonomikgolo;  ekonomi e kgolo; 
made	 bopilwe; mohuta;  bopile; 
magazine	kgatišobaka; 
magazines	dikgatišobaka; 
magisterial	ya maseterata; 
magistrate	masetrata; 
magistrate's	ya maseterata; 
magistrates	bomaseterata; 
magnificent	 ye botse kudu; ya go kgahliša kudu; 
magnitude	bogolo; 
mail	 setimela sa batho; poso;  posa; 
main	 ya mohlagase; ye kgolo; 
mainly	kudukudu; 
mainstream	ka tirišong ya kakaretšo;  ka tshepedišong ya kakaretšo; 
mainstreaming	go tsenya tirišong; 
maintain	lota; 
maintained	lotile; 
maintaining	lota; 
maintains	lota; 
maintenance	tlhokomelo;  tirišo (ya molao) le khutšo; 
major	 majoro;  golo; kgolo;  motho yo a ipheditšego; 
majority	bogolo;  bontši; 
make	mohuta;  bopa; 
makers	badiri;  bahlami; 
makes	mehuta;  bopa;  mediro; 
making	mohuta;  bopa; 
malaria	letadi; 
male	tona; 
males	 ditona; banna; 
mall	lefelokgolo la mabenkele; mmolo; 
man	monna; 
manage	kgona; 
managed	kgonne; 
management	taolo; 
manager	molaodi; 
managers	balaodi; 
manages	 laola; kgona; 
managing	kgonne; 
mandate	taolelo;  taelelo; 
mandated	laeletšwe; 
mandates	ditaelelo; ditaolelo; 
mandatory	ya kgapeletšo ya molao;  ya thomela;  ya semolao; 
manifestations	ditaetšo; 
manner	mokgwa; 
manual	 mošupatsela; (wa) diatla; 
manufacture	bopa; 
manufactured	dirile;  bopile; 
manufacturer	mmopi; 
manufacturing	tšweletšo; 
manuscript	sengwalwa; 
manuscripts	dimanusekiripiti; dingwalwa; 
many	ntšhi;  ntši; 
map	 mmapa; mmepe; 
mapping	 go beakanya; rulaganya; 
maps	mebepe; 
march	 ipelaetša; mogwanto;  pina ya mošito; 
marched	gwantile; ipelaesitše; 
margin	mollwane;  morumo; 
marginal	ye kgafetšwego thoko; ye beetšwego thoko;  ya thoko; 
marginalised	ba beetšwego thoko;  yo a beetšwego thoko; 
marginalized	ba beetšwego thoko;  yo a beetšwego thoko; 
marine	lewatle; 
maritime	ya lewatleng; 
mark	moputso;  leswao;  swaya; 
marked	swailwego;  nepišitšwego; 
market	 bapatša; mmaraka;  maraka; 
marketing	thekišo; 
markets	 bapatša; mebaraka;  rekiša; 
marks	 maswao; meputso; 
marriage	lenyalo; 
marriages	manyalo; 
married	 nyetše;  nyalantšwe; nyalane; 
mass	boima;  bokgolokgohla;  bontši; 
massive	ye kgolo; 
master	mong;  setsebi; 
master's	ya mong ya setsebi; 
match	 nyalantšha; papadi;  swantšha;  phegišano; 
matches	mollo; 
material	 sedirišwa; ditlakelo;  setlabelo; 
materially	 ya phahlo; ya thoto; 
materials	ditlabakelo; sditlabelo;  didirišwa; 
maternal	 ya bomme; ya boimana; 
mathematical	 ya dipalo; ya mmetse; 
mathematics	mmetse; 
matric	marematlou; 
matrimonial	 ya lenyalo; lenyalo; 
matter	mmetha;  boselo;  boladu; 
matters	 maselo;  maladu;  mmetha; dilo; 
maturity	bogolong; 
max	godimodimo; 
maximise	oketša; 
maximum	maksimamo; 
may	se ka;  a ka; 
maybe	 ka gongwe; mohlomongwe; 
mayor	ratoropo; 
mayors	botoropo; dimeyara; 
me	nna; 
mean	e hlaloša;  e ra;  tiišitšego; 
meaning	tlhalošo; 
meaningful	ye bohlokwa;  ye kwagalago;  ya mohola; 
meaningfully	ye bohlokwa;  kwagalo;  ya mohola; 
meanings	ditlhalošo; 
means	 e ra;  e hlaloša; maano;  mokgwa wa go iphediša; 
meant	 e hlalošitše; e rile; 
measure	 tekanyabotelele;  tekano;  kala;  ela;  tekanyaima;  tekanyo; kelo;  tekanyanako; 
measured	etšwego; 
measurement	 tekanyo; kelo; 
measures	 dikelo; ela;  kala;  ditekano;  ditekanyo; ditekanyabotelele; ditekanyaima; ditekanyanako; 
measuring	go lekanya; 
mechanical	(ka) tlwaelo; 
mechanism	bomotšhene; 
mechanisms	mekgwa; dimekhanisime; 
media	boraditaba; 
mediation	poelanyo; 
medical	ya bongaka;  -ya bongaka; 
medicine	sehlare; 
medicines	dihlare; 
medium	polelotirišwa; 
medium-term	 lebaka la magareng; nako ya magareng; 
meet	tseba;  kopana; 
meeting	 pitšo; kopano; 
meetings	dikopano;  dipitšo; 
meets	tseba;  kopana; 
mega	kgolo; 
melting	tologa; 
member	leloko; 
member's	ya leloko;  ya maloko; 
members	maloko; 
membership	boleloko; 
memorable	gopolega; 
memorandum	memorantamo; 
memorial	segopotšo; 
memories	dikgopolo;  kelelo; 
memory	 kelelo; kgopolo; 
men	banna; 
mental	ya kgopolo; 
mentally	ka monaganong;  ka mogopolong; 
mention	-go ra; 
mentioned	rile; 
merchant	 morekiši; mogwebi; 
mere	feela; 
merely	ka feela; 
merger	 tswalanyo; kopanyo; 
merit	ya bokgoni;  ya botsebi; 
merits	 botsebi; bokgoni; 
message	molaetša; 
messages	melaetša; 
messenger	morongwa; 
met	 tsebane; kopane; 
metal	metale;  tšhipi; 
metals	 ditšhipi; dimetale; 
method	mokgwa; 
methods	mekgwa; 
metro	toropokgolo;  bogare bja toropo; 
metropolitan	bogare bja toropo; 
mg	milikramo; 
micro	nnyane; 
middle	gare; 
midst	 kgabagareng; gareng; 
might	e ka;  a ka; 
migration	khudugo; 
milestone	go tšwelela bophelong; 
milestones	tšwelelomaphelong; 
military	sešole;  bošole; 
milk	maswi; 
millennium	ngwagakete;  mengwaga ye sekete; 
million	milione; 
millions	dimilione; 
mind	mogopolo; 
mindful	 gopodišiša; hlokomela; 
minds	megopolo; 
mine	epa;  moepo; 
mineral	minerale; 
minerals	diminerale; 
mines	epa;  meepo; 
minimise	fokotša; 
minimum	 minimamo botlalonyane; bonyane; 
mining	epa;  -epa; 
minister	 moruti; tona; 
minister's	ya tona; 
ministerial	-botonakgolo; 
ministers	 baruti; ditona; 
ministry	 kgoro ya tona; boruti; 
minor	monyane;  yo monyane;  -nyane; 
minority	bonyane; 
minutes	metsotso; 
misconduct	bosenyi; 
misleading	 lahletša; timetša; 
missing	tlogetšwego; 
mission	lesolo; 
missions	masolo; 
mitigate	 fediša; fokotša; 
mitigation	phokotša; phedišo; 
mix	hlakanya;  tswaka; 
mixed	hlakanego;  hlakantšwego;  kopantšwego; 
mm	milimetara; 
mobile	 e sepelago; thetha; 
mobilisation	kgokgoetša;  hlohleletša;  fa mafolofolo; 
mobilise	 lokišetša; go goketša; 
mobility	mosepelo;  tšhuto; 
model	 malebela; bopa;  mmotlolo; 
models	 malebela; bopa; dikawa; dikao; mebotlolo; 
moderate	magareng;  e lekanetšego; 
modern	ya lehono;  ya sebjalebjale; 
modernisation	dira ka sebjalebjale; 
modified	fetošitšwe;  fetotšwe; 
modify	fetola;  fetoša; 
moment	motsotso; 
moments	metsotso; 
momentum	 mosepelo; tshepelo; 
monetary	 ya ditšhelete; ya mašeleng; 
money	tšhelete; 
moneys	ditšhelete;  mašeleng; 
monies	ditšhelete;  mašeleng; 
monitor	 bea leihlo; molebeledi; 
monitored	lebeletše;  hlokometše; 
monitoring	 lebelela;  bea leihlo; hlokomela; 
monitors	 bea leihlo; balebeledi; 
month	kgwedi; 
monthly	ka kgwedi; 
months	dikgwedi; 
monument	segopotšo; 
monuments	digopotšo; 
moral	thuto;  (ya) setho;  thutasetho; 
more	go feta; 
moreover	godimo ga fao; 
morning	mesong; 
mortality	 go hlokofala; mahu; 
mortgage	tumelelano ya go adingwa tšhelete pankeng; 
most	bontši; 
mostly	gantši; 
mother	mma; 
mothers	bomma; 
motion	 tšhišinyo; mosepelo;  tšhikinyo; 
motions	mesepelo; ditšhikinyo;  ditšhišinyo; 
motto	moano; 
mountain	thaba; 
mountains	thaba; 
mounted	pharilwe; 
mouth	molomo; 
movable	ya go šutha;  ya go tsamaya;  ya go sepela; 
move	 tšhutišo; šutiša; 
moved	 tšhutišo; šutiša; 
movement	 mosepelo;  tshepelo; mokgatlo; 
movements	 ditshepelo;  mesepelo; mekgatlo; 
moves	 tšhutišo; šutiša; 
movie	filimi; 
moving	sepela;  šutha;  tsamaya; 
much	kudu;  ntši; 
multi-party	ya mekgatlo ye mentši; 
multilateral	ya mahlakorentši;  ya mafapha a mantši; 
multilingual	dipolelontši; bolementši; 
multiple	katišanetšwa; 
municipal	 (ya) mmasepela; masepala; 
municipalities	mebasepala; 
municipality	mmasepala; 
mural	seswantšho; 
murals	diswantšho; 
murder	polao; 
museums	dimuseamo; 
music	mmino;  boopedi; 
musical	tiragatšo ya mmino; 
musician	seopedi; 
musicians	diopedi; 
must	swanetše; 
mutandis	tše fetošwago; 
mutatis	fetogago; 
mutual	mmogo;  gotee; 
mutually	mmogo;  gotee; 
my	ya ka; 
myself	nna; 
name	leina;  rea leina; 
named	file leina;  reile leina; 
namely	maina a tšona ke;  e lego; 
names	 rea maina; maina; 
narrative	kanegelo; 
narrow	sese; 
natal	natala; 
nation	setšhaba; 
nation-building	kago ya setšhaba; 
national	 (ya) setšhaba; ya setšhaba; 
nationality	 bodulo bja nageng; modudi wa nageng; 
nationally	bosetšhaba; 
nationals	ya ditšhaba; 
nationhood	setšhaba; 
nations	setšhaba; 
native	mohlolegi; 
natural	tlhago;  poetšanotong;  ka tlholego; 
nature	tlhago; 
near	kgauswi;  kgauswane; 
nearest	kgauswiuswi; 
nearly	 nyakile; kgauswi; 
necessarily	 go lego maleba; hlokegago; 
necessary	nyakegago; 
need	sehlokwa; 
needed	sehlokwa; 
needs	senyakwa;  sehlokwa; 
negative	kganetšo;  ganetšago; 
negatively	ka mo go sa kgahlešego; gampe; 
neglect	 tlhokomologo; hlokomologa; 
neglected	 hlokomologilwe; hlokomologile; 
negligence	bošaedi; 
negotiate	rerišana; 
negotiated	rerišane; 
negotiating	rerišana; 
negotiation	therišano; 
negotiations	ditherišano; 
neighbouring	boagišane; kgauswi; 
neither	e sego; 
net	 lelokwa; marangrang; 
networking	netweka; 
networks	dinetweke; 
never	le gatee; 
nevertheless	le ge go le bjale; 
new	mpsha; 
newly	ye mpsha; 
news	ditaba; 
newsletter	lengwalo la ditaba; 
newsletters	mangwalo a ditaba; 
newspaper	kuranta; 
newspapers	dikuranta; 
newsroom	phapoši ya ditaba; phapoši ya kgašoditaba; 
next	latelago; 
night	bošego; 
nine	senyane; 
no	aowa; 
noble	maitshwaro a mabotse; 
nominal	ya maina; 
nominate	 hlaola;  ikgethela; kgetha; 
nominated	 kgethilwe; kgethile;  hlaotšwe;  hlaotše; 
nomination	 tšhišinyo; tlhaolo; 
nominations	ditlhaolo; ditšhišinyo; 
non	ye e sego; 
non-compliance	go se obamele;  go se hlomphe;  ya go se obamele; 
non-governmental	ye e sego ya mmušo; 
non-profit	ye e sego ya letseno; ye sa dirego letseno; 
non-racial	 ye e sego ya semorafe; ye e sa kgethologanyego ka merafe; 
non-racialism	go se kgetholle ka mmala; 
non-refundable	ya go se bušetšwe tšhelete; 
non-sexism	ye e sa kgethologanyego ka bong; 
non-sexist	ye e sa kgethologanyego ka bong; 
non-tax	ya go se lefelwe motšhelo; 
none	hlokegago;  ga e gona; 
nor	goba; 
norm	 tlwaelo; kelo; 
normal	tlwaelo; 
normally	ka tlwaelo;  ka mehleng; 
norms	ditlwaelo;  dikelo; 
north	leboa;  ya lebowa;  lebowa; 
northern	ya leboa; 
not	e sego; 
notable	ye e bonagalago;  ye e lemogwago; 
notably	ka temogo;  ye e lemogwago; 
note	 pampiritšhelete;  segalonote;  noto;  lemoga;  lengwalwana; ngwala; 
noted	 ngwadile; lemogile; 
notes	dintlhathuto; 
nothing	ga go selo; 
notice	 tsebišo;  hlokomela; tlhokomelo; 
notices	 ditsebišo; ditlhokomelo; 
notification	tsebišo; 
notified	tsebišitšwe; 
notify	tsebiša; 
noting	 lemoga;  elelwa; ngwala; 
notion	 tumelo; kgopolo; 
notwithstanding	go sa lebelelwe;  ka ntle ga;  go sa šetšwe; 
novel	padi; 
now	 gonabjale;  lebakeng le; bjale; 
nuclear	ya nyutleleara; 
null	ya go se šome;  ya go se balwa; 
number	palo;  nomoro; 
numbers	dinomoro;  dipalo; 
numerous	ntši; 
nurse	 oka; mooki; 
nurses	 oka; baoki; 
nursing	booki; 
nurture	fepa; 
nurturing	fepa; 
nutrition	 phepo ye botse;  kotlo; phepo; 
oath	kano; 
object	 sedirwa; selo; 
objection	kganetšo; 
objections	dikganetšo; 
objective	 maikemišetšo; maleba; 
objectives	 maikemišetšo; maleba;  dinepo; 
objects	dilo;  didirwa; 
obligation	tshwanelo;  tlamego; 
obligations	 ditlamego; ditshwanelo; 
oblige	gapeletša; 
obliged	gapeletšega; 
observatory	lefelothutelanaledi; 
observe	lemoga;  ela hloko; 
observed	lemogile;  etše hloko; 
obsolete	hlobogilweng; 
obtain	hwetša; 
obtainable	hwetšagala; 
obtained	hweditše; 
obtaining	hwetša; 
obvious	molaleng; 
obviously	 go molaleng; pepeneneng; 
occasion	lebaka; 
occasions	mabaka; 
occupation	 go thopa;  mošomo; mediro;  kamogo; 
occupational	 ya mošomong; ya mošomo; 
occupied	thopile; 
occupy	thopa; 
occur	 hlaga; diragala; 
occurred	diragetše; hlagile; 
occurrence	tiragalo; 
occurring	 hlaga; diragala; 
occurs	 hlaga; diragala; 
ocean	lewatle; 
of	ya;  wa; 
off	tloša; 
offence	molato;  tshenyo; 
offences	melato;  ditshenyo; 
offender	mosenyi; modiramolato; 
offenders	basenyi; badiramelato; 
offer	kabo; tshephišo;  aba; 
offered	filwe;  abilwe;  abile; 
offering	sehlabelo; 
offerings	dihlabelo; 
offers	 dikabo; aba; 
office	ofisi; 
office-bearers	bašomi ba kantorong; bengkantoro; 
officer	 mohlankedi tonadira; mohlankedi; 
officers	bahlankedi; bahlankeditona; 
offices	dikantoro;  diofisi; 
official	 (la) mmušo; mohlankedi; 
officially	 ya semmušo; ka semmušo; 
officials	bahlankedi; 
offset	phamogo;  tšwa tseleng; ditlamorago tše mpe; 
offshore	 moše wa mawatle; go putla mawatle; 
often	gantši; 
oil	 makhura; oli; 
old	kgale; 
older	kgajana; 
oldest	kgalekgale; 
omission	tlogelo; 
omissions	ditlogelo; 
on	 goteditšwe; go; 
on-going	ye e tšwelago pele; 
once	gatee; 
once-off	gatee;  ya ga tee; 
one	tee; 
ones	botee; 
ongoing	ye e tšwelago pele; 
online	kgokaganego; 
only	fela; 
onto	 ka gare ga; ka go; 
open	 bulega; bula; 
opened	 butše; bulegile; 
opening	 lešoba; selepe; 
opens	 bulega; bula; 
operate	bua; 
operated	buile; 
operates	bua; 
operating	bua; 
operation	 tirišo; tiro;  tshepedišo; 
operational	 ya tshepedišo;  ya phethagatšo ya mošomo; ya mošomo; 
operations	dikaro; dipuo;  tshepedišo;  ditirišo; ditiro; 
operator	modiriši;  mosepediši; 
operators	 basepediši; badiriši; 
opinion	maikutlo; 
opinions	maikutlo; 
opportunities	dibaka; menyetla; 
opportunity	 monyetla; lebaka; 
opposed	kgahlanong;  go ganana le;  thulana; 
opposite	lebana;  lelatodi; 
opposition	kganetšo; 
oppressed	 gateletšwe; gateletše; 
oppression	kgatelelo; 
oppressive	ya kgatelelo;  tša kgatelelo; 
optimal	 tše kgolo; tše ntši; 
optimism	kholofelo; 
option	kgetho; 
options	dikgetho; 
or	goba; 
oral	(ya) molomo; 
orange	namune; 
orchestra	orkese; 
order	 beakanya;  tatelano;  otara;  thomelelo; taelo; 
ordered	 latelantše; ditaelo; otarile; romeletše; beakantše;  hlophile; 
orders	ditaelo;  diotara; 
ordinance	molawana; 
ordinarily	ka tlwaelo;  ka mehleng; 
ordinary	ya mehleng;  ya tlwaelo; 
org	mokgatlo; 
organ	 okane;  ditho; setho; 
organisation	 mokgatlo; peakanyo; 
organisational	ya mokgatlo; 
organisations	mekgatlo; 
organised	beakantšwego;  rulagantšwego; 
organisers	barulaganyi;  babeakanyi; 
organising	 go rulaganya; go beakanya; 
organization	mokgatlo; 
organizations	mekgatlo; 
organized	 beakantšwe; rulagantšwe; 
organizers	barulaganyi;  babeakanyi; 
organs	ditho tša go bolela; 
orientation	sebopego;  tlwaetšo; 
origin	mathomo;  setlogo; 
original	sa mathomong;  ya mathomo; 
originally	mathomong; 
origins	mathomong;  setlogo; 
other	ye nngwe; 
others	tše dingwe; 
otherwise	go sego bjale; 
ought	 swanetše; nyaka; 
our	ya rena;  sa rena; 
ours	ya rena;  sa rena; 
ourselves	rena; 
out	 tšwele; ntle; 
outcome	 ditlamorago; poelo; 
outcomes	 ditlamorago; dipoelo; 
outdoor	ka ntle; 
outgoing	ya go sepela; ya go theta; 
outline	magomo;  akaretša; 
outlined	 rulagantšwe;  akareditšwe; magomo; 
outlines	dithulaganyo;  magomo;  akaretša; 
outlook	 boikalo; sebopego; tebeledišišo; 
output	bokgoni bja tšweletšo ya mošomo; 
outputs	bokgoni bja tšweletšo ya mošomo; 
outreach	phatlalala;  leba setšhabeng; 
outside	bokantle;  ka ntle; 
outsourced	 kgopela thušo ka ntle; kgopela ka ntle; 
outstanding	 se se kgahlišago; ye e kgahlišago; 
outward	ya ka ntle; 
oval	selee; 
overall	obarolo; 
overarching	pipelago; akaretšago; 
overcome	fenya; 
overcrowding	lešaba le le ntši; 
overseas	mošola wa mawatle; 
oversee	 hlokomela; laola; 
overseeing	go laola;  go hlokomela; 
oversight	tlhokomedišišo; 
overview	kakaretšo; 
overwhelming	 ntši kudu; ntši go fetišiša; 
owed	kolotilwe; kolotwago; 
owing	kolota; 
own	 ya gagwe; gagwe; 
owned	bile ya gagwe;  bile mong; 
owner	mong; 
owners	beng; 
ownership	bong; 
pace	lebelo; 
package	sephuthelo; sehlopha; 
packages	dihlopha; diphuthelo; 
page	letlakala; 
pages	matlakala; 
paid	 lefile; lefela; 
pain	 sehlabi; bohloko;  lehlaba; 
painful	 go kweša bohloko; bohloko; 
painting	 go penta; seswantšho; 
paintings	mepento; diswantšho; 
palace	mošate; 
panel	 panele; baahlodi;  sekgoba sa lebato sa go ikgetha; 
paper	 polelongwalwa; pampiri;  lephephe;  kuranta; 
papers	dipolelongwalwa;  maphephe;  dikuranta; dipampiri; 
par	palo; 
paragraph	temana; 
paragraphs	ditemana; 
parameters	mathoko; ditikano; 
parent	motswadi; 
parental	ya botswadi; 
parenting	botswadi; 
parents	batswadi; 
park	phaka; 
parking	phaka; 
parks	phaka; 
parliament	palamente; 
parliament's	ya palamente;  ba palamente; 
parliamentarian	leloko la palamente; 
parliamentarians	maloko a palamente; 
parliamentary	ya palamente;  ba palamente; 
parliaments	dipalamente; 
parole	tokollo ka parola; 
part	seripa;  karolo ya polelo; 
part-time	letogo; 
partial	 ka seripa; ya seripa; 
partially	ka boripana; 
participant	mokgathatema; 
participants	moraloki; 
participate	kgatha tema;  tšea karolo; 
participated	 tšere karolo; kgathile tema; 
participates	kgatha tema;  tšea karolo; 
participating	kgatha tema;  tšea karolo; 
participation	go tšea karolo;  go kgatha tema; 
participatory	ya go tšea karolo;  ya go kgatha tema; 
particular	itšego; 
particularly	kudukudu; 
particulars	ditlhalošišo; 
parties	 diphathi; mekgatlo; 
partly	 ka seripa; ka boripana; 
partner	 modirišani; molekani; 
partnered	dirišani; gwerane; 
partners	 balekane; badirišani; 
partnership	tirišano; 
partnerships	ditirišano; 
parts	dikarolo;  ditho; 
party	phathi; 
pass	 ragela; atlega;  ragela kgwele; 
passed	 ragile kgwele; atlegile; 
passenger	monamedi; 
passengers	banamedi; 
passes	 ragela; atlega;  raga kgwele; 
passing	feta;  fetago; 
passport	pasporoto; 
past	 go tšwa go; lefetilephethikgole; 
path	tsela; 
patient	molwetši; 
patients	balwetši; 
patriotism	kwelobohlo; go ba le thekgo; 
pattern	sekaelo; 
patterns	dipaterone; dikaelo; phethene; 
paved	 adile; pipile; 
pavilion	phabilione; moagoboithabišo; 
pay	 tefo;  lefa; lefela; 
payable	ya go lefa;  ye e lefšago; 
paying	 lefa; lefela; 
payment	tefo; 
payments	ditefo; 
pays	 lefa; lefela; 
pdf	Pdf; 
peace	khutšo; 
peaceful	ka khutšo;  ya khutšo; 
peak	ntlhora; 
peer	thaka; 
penalties	diphenale; melora; 
pending	 emetšwe; letilwe; 
pension	phenšene; 
pensions	diphenšene; 
people	batho; 
people's	sa batho;  ya batho;  wa batho; 
peoples	batho; 
per	ka; 
perceived	bonwago;  bonwego; 
percent	phesente;  kgolong; 
percentages	dipersente; 
perception	temogo; 
perceptions	maikutlo;  ditemogo; 
perform	dira;  diragatša; 
performance	 tiragatšo;  diragatša; papalo; 
performances	diragaditše;  tiragatšo; dithaloko; 
performed	diragaditše; dirile; 
performer	modiragatši; 
performers	modiragatši; 
performing	dira;  diragatša; 
performs	dira;  diragatša; 
perhaps	mohlomongwe; 
period	 paka; lebaka; 
periodical	 ka mabaka; kgatišobaka; 
periods	mabaka;  dinako; dipaka; 
perjury	kenollo; 
permanent	 sa mmaruri; ruri; 
permanently	ruri; 
permission	tumelelo; 
permit	 tumelo; dumelela; 
permits	diporomete;  ditumelo; dumelela; 
permitted	dumeletše; 
perpetuate	tšwetša pele; 
person	 mmolelwa;  mmoledišwa;  mmoledi; motho; 
person's	sa batho;  ya batho;  wa batho; 
personal	motho; 
personally	ka bonna; 
personnel	bahlankedi;  bašomedi;  bašomi; 
persons	batho;  mmolelwa;  baboledi;  baboledišwa; 
perspective	ponego; 
perspectives	diponego; 
pertaining	 ya mabapi le; ka ga; 
petition	thapedi; 
petitions	dingongoregongwalwa; dithapedi; 
petrol	petrolo; 
petroleum	petroleamo; 
pharmaceutical	ya dihlare;  sa dihlare; 
phased	ya tebego; ya dikgato; 
phases	dikgato; 
phenomenon	ponagalo; 
philosophy	filosofi; 
phone	 foune; mogala; 
photo	 seswantšho; senepe; 
photograph	senepe; 
photographers	batšeadinepe; 
photographic	ya dinepe;  ya diswantšho; 
photographs	dinepe;  diswantšho; 
photos	dinepe;  diswantšho; 
physical	 ya mmele; sebopego;  (sa) mmele; 
physically	ka botlotla;  ka sebele; 
piano	tlase; 
picture	seswantšho; 
pictures	diswantšho; 
piece	seripa; 
pieces	dikarolo;  ditho; 
pillar	kokwane; 
pillars	dikokwane; 
pilot	mofofiši wa difofane;  mofofane; 
pioneers	batšwetšapele; 
pivotal	bohlokwa; 
place	lefelo;  bea; 
placed	beile; 
placement	peyo; thomelo; 
places	mafelo;  bea; 
placing	bea; 
plain	lebala;  (ya) bonolo; 
plains	mabala; 
plaintiff	mmelaedi; 
plaintiff's	molli; 
plan	 thala;  rulaganya;  maano; morero;  polane; 
planet	setšatši; 
planned	thadile;  polane;  rulagantše;  rerile; 
planning	thalo;  go rera; 
plans	 thala;  maano; merero;  dipolane; 
plant	 lefelo la go šoma ka metšhene; bjala;  mešifa;  semela; 
plants	 dimela; bjala;  mafelo a go šoma ka metšhene;  mešifa; 
plastic	plastiki;  (sa) plastiki; 
platforms	dipholateforomo; 
platinum	platinamo; 
play	 tiragatšo; thaloko; 
played	ralokile; 
player	moraloki; 
players	baraloki; 
playhouse	ntlothalokelo; 
playhouses	dintlothalokelo; 
playing	raloka; 
plays	dithaloko;  ditiragatšo; 
plea	kgopelo; 
plead	ipolela; 
pleading	 ipiletša; ipolela; 
pleadings	boipobolo; 
please	 kgahla;  kgahliša; hle;  ka kgopelo; 
pleased	kgahlišitše; kgahlile; 
pleasure	lethabo; 
pledge	holofetša; 
pledged	holofeditše; 
plenary	ya peakanyo;  ya thulaganyo; 
plight	bokamoso;  seriti; 
plus	le;  hlakanya; 
pm	mathapama;  ka meriti; 
poaching	 go tsoma ka bohodu; go bolaya diphoofolo; 
poem	sereto; 
poet	sereti; 
poetry	theto; 
poets	direti; 
point	 šupa; ntlha;  khutlo; 
pointed	 ya ntlha;  šupile; ya khutlo; 
points	 dikhutlo; dintlha;  ditšhupo; 
police	maphodisa;  lephodisa; 
policies	 maikemišetšo;  dipholisi tša inšorense;  dipholisi; dikwano; melaotshepedišo; 
policing	hlapetša; 
policy	 maikemišetšo;  pholisi ya inšorense;  pholisi; kwano; 
political	(ya) politiki; 
politics	 politiki; dipolitiki; 
pollution	tšhilafatšo; 
pool	mogobe; 
poor	diila; 
poorer	diila;  diila kudu; 
poorest	diila kudukudu; 
poorly	gampe; 
popular	 tuma; tsebegago; 
population	batho;  setšhaba;  baagi; 
pornography	 ditiro tša thobalano;  maponapona; ditiro tša maponapona; 
port	 lehlakore ntsogohlo; boemakepe; 
portfolio	potfolio; 
portion	karolo;  kabelo; 
portray	swantšha; 
portrayed	swantšhitše; 
ports	 mahlakore a ntsogohlo; maemakepe; 
pose	bonagala;  tšwelela; 
posed	 bonagetše; tšweletše; 
position	 kemo; maemo; 
positions	dikemo; maemo; 
positive	phosithifi; 
positively	kgakaone; 
possess	na le; 
possession	 go swara kgwele; leruo; 
possibilities	dikgonagalo; 
possibility	kgonagalo; 
possible	kgonagala; 
possibly	ka kgonagalo; 
post	modiro;  posa;  poso; 
post-apartheid	ka morago ga kgethologanyo go ya ka merafe; 
postal	ya poso; 
postponed	fegilwe; emišitšwenyana; 
postponement	phego; 
postpones	emišanyana; 
posts	 diposo;  posa; mediro; 
pot	pitša; 
potential	 maamušo; bokgoni; 
potentially	 ye go kgonagalago; ye e kgonago; 
poverty	tlala; 
power	maatla;  mmušogadi;  maatla a go buša;  tokelo; 
powerful	go ba le maatla; 
powers	 ditokelo; maatla; mebušogadi;  maatla a go buša; matlapalo; 
practicable	kgonego; 
practical	(ya) tirišo; 
practice	 tiro bošomelo;  tlwaetšo; setlwaedi;  maitokišo; 
practices	ditlwaedi; ditirobošomelo;  maitokišo; ditlwaetšo; 
practise	 tlwaetša; go itlwaetša;  tlwaetša ka go katiša; 
practitioner	modiragatši; 
practitioners	bašomedi;  badiragatši; 
praise	reta; 
prayer	thapelo; 
pre-colonial	ya pele ga bokoloniale; 
pre-trial	pele ga tsheko; 
preamble	matseno; 
precede	eta pele; 
preceded	etile pele; 
preceding	etilego pele; 
precinct	lefelo; 
precincts	mafelo; 
precious	ye bohlokwa;  se bohlokwa; 
precisely	ka nepagalo; 
preference	sa go ratwa;  go rata;  ya go ratwa; 
preferential	ya thato; 
preferred	 ratilwe; ratwa; 
pregnancy	go ima; 
pregnant	 wa go ima; go ima; 
prejudice	tseba;  kgethollo; 
preliminary	 (sa) mathomo; tlhalošokakanyo ya mathomo; 
premier	tonakgolo; 
premised	 beile;  beakantšwe; beilwe; 
premises	mafelo;  mafelwana; 
preparation	tokišo; 
preparations	boitokisetšo; tokišo; 
preparatory	(ya) boitokišetšo; 
prepare	lokiša;  itokiša; 
prepared	lokišitšwe;  beakantšwe; 
preparing	lokiša;  itokiša; 
prescribe	bea; 
prescribed	kgethetšwego; 
prescribing	bea; 
prescription	taelelo; 
prescripts	mafelwana; 
presence	go ba gona; 
present	 mpho;  gabjale;  hlagiša; gona; 
presentation	kgafelo; 
presentations	dikgafelo; 
presented	hlagišitše; 
presenting	hlagiša; 
presently	gabjale;  mo lebakeng le; 
presents	 dimpho; aba;  hlagiša; 
preservation	 pabalelo; poloko; 
preserved	thibetšwe tshenyego; 
preserving	thibela tshenyego; 
preside	swara setulo; 
presidency	Kantoro ya mopresidente; 
president's	ya mopresidente; 
presidential	ya mopresidente; 
presidents	dipresidente; 
presiding	šoma maemong; 
press	tobetša;  kgatišo; 
pressing	pitlelago; 
pressure	kgatelelo; 
pressures	dikgatelelo; 
prestigious	 ye bohlokwa;  se bohlokwa; ya maemo a godimo; 
presumed	tšerwe gore;  tšere gore; 
pretty	 botsana; botse; 
prevail	 lego gona; šalela; 
prevailing	 lego gona; šalela; 
prevalence	palo ya bao ba feteditšwego ka nako yeo e itšego; 
prevent	 go thibela; thibela; 
prevented	thibetše; 
preventing	 go thibela; thibela; 
prevention	thibelo; 
previous	fetilego; 
previously	 ya mathomong;  mathomong; peleng;  ya peleng; 
price	theko;  preisi; 
prices	dipreisi; ditheko;  ditheko; 
pricing	go bea preisi;  go bea theko; 
pride	boikgantšho;  boikgogomošo; 
priest	 moprista; moruti; 
prima	phorema; 
primarily	gagolo; 
primary	 ya peleng ye bohlokwa; ya mathomong; 
prime	 ya godimo;  ya tlalo; ya maemo; 
principal	 hlogo ya sekolo; hlogo; 
principals	dihlogo;  dihlogo tša sekolo; dikhumopolokwa; 
principle	theo;  kutu; 
principles	ditheo;  dikutu; 
print	 gatiša ka seatla;  gatiša;  kgatišo; lešela la mebala; 
printed	gatišitšwe ka seatla;  gatišitšwe; gatišišwe; 
printing	 gatiša ka seatla;  gatiša; lešela la mebala; 
prior	pele ga tsheko; 
priorities	bohlokwa; 
prioritise	tliša peleng; 
prioritised	tlišitše peleng; 
priority	bohlokwa; 
prison	 kgolego; kgolego; toronko; 
prisoner	mogolegwa; 
prisoners	bagolegwa;  dibofša; 
prisons	dikgolego; 
privacy	 sephiring; sephiri; 
private	sephiri;  mongfela; 
privilege	tshwanelo; 
privileged	 bile le monyetla; bile le sebaka; 
privileges	tokelo; 
prize	sefoka; 
prizes	difoka; 
pro	ratago;  thekgago; 
proactive	 wa boithomelo; sa boithomelo; 
probably	mo gongwe; 
probation	 yo a sa lekolwago; ya nakwana; 
probe	nyakišiša;  fatišiša; 
problem	marara; 
problems	mathata; 
procedural	ya tshepedišo; 
procedure	tshepedišo; 
procedures	ditshepedišo; 
proceed	tšwela pele; 
proceeding	tšwela pele; 
proceedings	ditherišano; 
proceeds	lengwalo; 
process	 khuša; tsela;  tshepetšo;  sepediša; 
processed	 sepediša;  šomilwe; sepedišitše; khušitše; 
processes	 ditshepetšo;  khuša;  sepediša; ditsela; 
processing	 khuša; tsela;  tshepetšo;  sepediša; 
procession	 go sepela ka tatelano; lenaneo; 
proclamation	kgoeletšo; 
procurement	bodiredi bja ka ntle; borekedi; 
produce	 ntšha; puno;  tšweletša; 
produced	 tšweleditše puno;  tšweleditše; ntšhitše; 
producer	 mmapadiši; motšweletši;  mohlagiši; 
producers	bahlagiši; babapatši;  batšweletši; 
produces	 ntšha; dipuno;  tšweletša; 
producing	 ntšha; puno;  tšweletša; 
product	seatišo; 
production	 tšweletšo; puno; 
productions	 ditšweletšo; dipuno; 
productive	-tšweletšago; 
productivity	botšweletši; 
products	diatišo; ditšweletšwa; 
profession	boithutedi; 
professional	setsebi; 
professionals	bašomi ba phrofešenale; diphrofešenale; ditsebi; 
professions	diphrofešene; 
professor	Moprofesara; 
profit	poelo; 
profits	dipoelo; 
profound	 ye kgolo; ye e kgahlišago; 
program	lenaneo; 
programme	lenaneo; 
programmed	šomilwe; 
programmes	mananeo; 
programming	peakanyo ya mananeo; 
programs	mananeo; 
progress	tšwelopele;  tšwela pele; 
progression	kgatelopele; 
progressive	ya tšwelopele;  -tšwelelago;  tšwelopele; 
prohibit	thibela; 
prohibited	thibetše; 
prohibition	kiletšo; 
project	morero; 
projected	 beile morero; laeditšwe; 
projection	tšweletšo; 
projections	 ditšweletšo; ditaetšo; 
projects	 diprotšeke; merero; 
prominent	ye e tumilego; 
promise	tshephišo; 
promised	tshephišitše; 
promises	tshephiša; 
promote	 tšwetša pele; hlatloša; 
promoted	 tšweleditšwe pele; hlatlošitšwe; 
promotes	tšwetša pele;  hlatloša; 
promoting	tšwetša pele;  hlatloša; 
promotion	tšweletšopele; 
promptly	ka ntle le tikatiko;  ka potlako;  ka pela; 
promulgate	tsebagatša; 
promulgated	tsebagaditše; 
promulgation	 kgoeletšo; tsebagatša phatlalatša; 
proof	bopaki; 
proper	ya makgonthe;  ya maleba; 
properly	 ka maleba; gabotse; 
properties	 dimelo; dithoto;  dieng;  diphahla; 
property	 semelo; thoto;  seeng;  phahla; 
proportion	tekatekano;  kabelo;  setseka; 
proposal	tšhišinyo; 
proposals	ditšhišinyo; 
propose	hlagiša; 
proposed	hlagišitše; 
proposes	šišinya; 
prosecute	sekiša; 
prosecuted	sekišitše; 
prosecuting	sekišago; 
prosecution	bosekiši; tshekišo; 
prosecutions	ditshekišo; 
prosecutors	batšhotšhisi; 
prospective	letilwego;  emetšwego; 
prospectus	prospekthase; 
prosperity	 lehumo; katlego; 
prosperous	 humile; atlegile;  humilego; 
protect	šireletša; 
protected	šireleditše; 
protecting	šireletša; 
protection	tšhireletšo; 
protective	šireletšang; 
protector	mošireletši; 
protest	 ipelaetša; ganana;  kganano; 
protests	 ipelaetša; ganana; dikganano; 
protocol	prothokholo; 
protocols	mananeokalafo; diprothokholo; 
proud	motlotlo; 
proudly	ka boitšhireletšo; 
prove	hlatsela;  fa bohlatse; 
proved	 hlatsetše; file bohlatse; 
proven	hlatsetše; 
provide	fa;  beakanyetša; 
provided	file;  ge fela;  abile; 
provident	phrobitente; 
provider	moabi; 
providers	baabi; 
provides	fa;  beakanyetša; 
providing	fa;  beakanyetša; 
province	karolo; 
province's	ya phrobentshe; 
provinces	dikarolo; diprobentshe; 
provincial	ya phrobentshe; 
provision	neo; 
provisional	(sa) lebakanyana; 
provisions	dijo; 
proviso	 mabaka; maemo; 
proxy	moemedi; 
prudent	 ka tlhokomelo; ka šedi; 
prudential	ya tlhokomelo;  ya šedi; 
psychological	 ya mogopolo; ya monagano; 
public	batho;  (ya) bohle; 
publication	phatlalatšo; 
publications	diphatlalatšo; 
publicly	 phatlalatša; pepeneneng; 
publish	phatlalatša; 
published	 phatlaladitšwe; phatlaladitše; 
publisher	mophatlalatši; 
publishers	baphatlalatši; 
publishes	phatlalatša; phahlalatša; 
publishing	phatlalatša; phahlalatša; 
punishment	kotlo; 
purchase	reka; 
purchased	rekile; 
purchases	reka; 
purporting	 tšeago; itirago; 
purpose	morero; 
purposes	merero; 
pursuant	malebakana le; ka ga;  mabapi le; 
pursue	 šala morago; nyaka;  phegelela; 
pursued	 phegeletše; nyakile;  šetše morago; 
pursuing	 šala morago; nyaka;  phegelela; 
pursuit	tšhalomorago; phegelelo; 
push	kgorometša; 
put	bea;  beile; 
puts	bea; 
putting	bea; 
qualification	boithutelo;  mangwalo a thuto; 
qualifications	 mangwalo a dithuto; dithuto; 
qualified	kgonago; 
qualify	 hlalošago;  dumelela; kgona; 
qualifying	 hlalošago;  dumelela; kgona; 
qualitative	ya boleng; 
qualities	 dikhwalithi; boleng; 
quality	 khwalithi; boleng; 
quantitative	ya bontši; 
quantity	bokaakang;  bontši; 
quarter	 kwarata; kgweditharo; 
quarterly	ka kotara; 
quarters	dikotara; 
queen	mohumagadi; 
queries	 diphatišišo; dipotšišo; 
quest	nyakišišo; 
question	potšišo; 
questioned	botšišitše; 
questionnaires	dipotšišonyakišišo; 
questions	dipotšišo; 
quickly	ka pela; ka potlalo; 
quite	 oketšega; kudu;  go fetišiša; 
quorum	khoramo; 
quotation	tlhabo ka tsopolo; 
quotations	ditsopolo; 
quote	khouta; 
race	mohuta;  morafe;  peišano;  mohlobo;  phadišano;  šiana; 
races	merafe;  mabelo;  šiana; 
racial	semorafe; 
racism	kgethologanyo ya semorafe; 
racist	motho wa go kgetholla go ya ka semorafe; 
radio	 seyalemoya; radio; 
raid	tlhaselo;  tšhwahlelo; 
railway	seporo; 
rain	pula;  pula e a na; 
rainbow	molalatladi; 
rainfall	pula; 
raise	kuka; 
raised	kukile; 
raises	kuka; 
raising	kuka; 
rally	 rali; kgobokano; 
rand	ranta; 
range	 paka; mola;  katologano; 
ranges	dikatologano;  mehuta; dipaka; mela; 
ranging	 paka; mola;  katologano; 
rank	 go fa maemo;  kgati; maemo; 
ranks	direnke; maemo a mošomo; 
rape	kata;  peto;  kato; 
rapid	phororo;  akgofago; 
rapidly	ka lebelo; 
rare	sego bonolo; sa diregego bonolo; 
rate	lebelo;  lekanya;  tswalo;  motšhelo;  lebelo la tšwelopele; 
rates	motšhelo; 
rather	upša; 
ratification	dumelela semmušo; 
ratified	dumeletše semmušo; 
rating	boemo; 
ratings	dikelo; 
ratio	kabo; 
rationalisation	beakanya leswa; 
raw	tala;  ka fao di lego ka gona; 
re	ka ga;  mabapi le; 
reach	fihlelela; 
reached	fihleletše; 
reaching	fihlelela; 
read	bala; 
reader	mmadi;  padišo; 
readers	babadi;  dipadišo; 
readily	lokilego; 
readiness	go loka; 
reading	palo;  go bala; 
ready	loka; 
reaffirm	 tiiša leswa; tiišetša leswa; 
real	ya makgonthe; 
realisation	 temogo; phihlelelo;  temošo; 
realise	bona; 
realised	lemogile;  fihleletše; 
realising	 lemoga; fihlelela; 
realities	 dilo tša tlhago;  dilo tša makgonthe; dilo tša nnete; 
reality	 tlhago;  makgonthe; nnete; 
realization	 temogo; phihlelelo;  temošo; 
realize	 lemoga; fihlelela; 
really	ka nnete; 
reason	 phega; lebaka; 
reasonable	kwalago; 
reasonably	 ka fao go kwagalago; ka lebaka; 
reasons	diphega; mabaka; 
reburial	go boloka leswa; 
recall	go fološa setulong; 
recapitalisation	aba letlotlo; 
receipt	setlankana;  tšhupatefo; 
receipts	ditseno; 
receive	amogela; 
received	amogetše; 
receives	amogela; 
receiving	amogela; 
recent	ye sa tšwago go feta; 
recently	malobanyana; 
reception	kamogelo; 
recession	go phuhlama ga ekonomi;  go wa ga ekonomi; 
recipient	moamogedi; 
recipients	baamogedi; 
reclaim	hwetša leswa;  kgopela leswa; 
recognise	lemoga; 
recognised	 lemogilwe; bonwe; 
recognises	bona;  lemoga; 
recognising	bona;  lemoga; 
recognition	temogo; 
recognize	bona;  lemoga; 
recognized	 lemogilwe; bonwe; 
recommend	digela; 
recommendation	keletšo; 
recommendations	dikeletšo; ditigelo; 
recommended	digetše; 
recommends	digela; 
reconciliation	poelanyo; 
reconstruction	kagoleswa; 
record	pego;  lenanethoto;  bega dinaka; 
recorded	begilwe;  begile dinaka; rekhotilwe; 
recording	kgatišo; 
records	direkhoto; dipego;  bega dinaka; 
recover	kokotlela; 
recovered	hweditše; 
recovery	pholo;  tielela; 
recreation	 boitapološo;  maitišo; kagoleswa; 
recreational	ya boitapološo; 
recruitment	go thwala mošomong;  go kgokgoetša; 
rectify	phošolla; 
red	khubedu; 
redistribution	peakanyoleswa; kaboleswa; 
redress	phošollo;  beakanya leswa; 
reduce	 iša; fokotša; 
reduced	 išitše; fokoditše; 
reducing	 iša; fokotša; 
reduction	phokotšo; 
reductions	diphokotšo; 
refer	 iša;  lebiša; lebelela; 
reference	dipuku;  tšhupetšo;  dipuku tša go bala; 
references	dipuku;  ditšhupetšo;  dipuku tša go bala; 
referral	 ya tšhupetšo; ya go balwa; 
referred	išitšwe;  lebišitšwe; 
referring	 lebiša; iša; 
refers	 šupa; e šupa;  e ra; 
refined	hlwekišitšwego; 
reflect	bonagatša; 
reflected	bonagaditše; 
reflecting	bonagatša; 
reflection	 sešupo; sekgantšhi; 
reflective	ya taetšo;  ya pontšho; 
reflects	bonagatša; 
reform	phetošo;  mpshafatšo;  mpshafatša; 
reforms	dimpshafatšo;  mpshafatša;  diphetošo; 
refund	pušeletšo;  bušetša; 
refurbishment	peakanyoleswa; tsošološo; 
refusal	 go gana; go se dumele;  go ganetša; 
refuse	 ditlakala; gana; 
refused	 dirile ditlakala; ganne; 
refuses	 ditlakala; gana; 
regard	 ka ga;  hlompha; hlokomela;  mabapi le; 
regarded	bone; 
regarding	malebana; 
regardless	go sa hlokomelwe;  go sa balwe; 
regards	mahlatse le mahlogonolo;  wa lena; 
regeneration	tsošološo; 
regime	mokgwa wa pušo; 
region	selete; 
regional	ya selete;  - ya selete; 
regions	dilete; 
register	 ngwadiša;  pukuina; rejistara; 
registered	ngwadišitše; retšistarile; retšisetara; 
registering	 ngwala ka go pukuina;  ngwadiša; rejistara; retšisetara; 
registers	dipukuina; diretšisetara;  ngwadiša; rejistara; 
registrar	mongwadiši; 
registration	boingwadišo; 
registries	dingwadišo; mananeongwadišo; 
registry	lenaneongwadišo; ngwadišo; 
regular	 ya ka mehla; (ya) ka molao;  ka mehla; 
regularly	 ka mehla; ka tekanelo; 
regulate	 sepetša ka molao; laola; 
regulated	 sepedišitše ka molao; laotše; 
regulates	 sepetša ka molao; laola; 
regulating	 sepetša ka molao; laola; 
regulation	molawana; 
regulations	melawana; 
regulator	molaodi; 
regulators	balaodi; 
regulatory	 ya taolo; ya bolaodi; 
rehabilitation	tsošološo; 
rehearsal	tokišetšo ya tiragalo;  itokiša; 
rehearsals	itokiša;  ditokišetšo tša tiragalo; 
reinforce	maatlafatša leswa; 
reintegration	kopanyoleswa; 
reiterate	gatelela;  bušeletša; 
reiterated	gateletše; bušeleditše; 
reject	gana;  selahlwa; 
rejected	 lahlile; ganne; 
relate	 anega; amana;  amega; 
related	 tswalana;  tswalanego; amana; 
relates	 anega; amana;  amega; 
relating	 go anega; amana;  amega;  mabapi le; 
relation	kamano; 
relations	dikamano; 
relationship	kamano;  tswalano; 
relationships	dikamano;  ditswalano; 
relative	 babo;  amanago;  leamanyi; leloko; 
relatively	ka papetšo; 
relatives	 ba amanago; maloko;  ba leloko;  dikabo;  maamanyi; 
release	lokolla; 
released	phahlaladitše; Lokollotše; 
releases	 phatlalatša; lokolla; 
relevance	maleba; 
relevant	lebanego; 
reliable	tshepega;  botegago; 
relief	 tapološo; popego; 
religion	 bodumedi; tumelo; 
religions	 ditumelo; bodumedi; 
religious	 (ya) bodumedi;  ya tumelo; tumelo; 
rely	tshepha; bota; 
remain	šala; 
remainder	 mašalela; lešalela; 
remained	šetše; 
remaining	šetšego; 
remains	mašaledi; 
remand	fega; 
remarkable	makatšago;  kgahlišago; 
remarks	ditshwaotshwao; 
remedies	dipheko;  dikalafo; 
remedy	 pheko; kalafo; 
remember	elelwa; 
remembered	eletšwe;  gopotše; 
remembrance	segopotšo;  kgopotšo; 
remind	gopotša; 
reminded	gopoditše; 
reminder	segopotšo; 
reminders	bagopotši; digopotši; 
remote	kgakala; 
removal	go tloša;  go raka; 
remove	 tloša; raka; 
removed	 tlošitše; rakilwe;  tlošitšwe; 
removing	 tloša; raka; 
renaissance	tsošološo; 
rename	thea lefsa; 
renamed	theile leina leswa; 
renaming	thea lefsa; 
render	 direla; aba; 
rendered	abile;  diretše; 
rendering	 direla; aba; 
renew	mpšhafatša; 
renewal	mpshafatšo; 
renewed	mpshafaditše; 
renovations	dipeakanyoleswa; ditsošološo; 
renowned	 yo a tsebegago; yo a tumilego; 
rent	 rente; hira; 
rental	rente; go renta; 
repair	 tokišo; lokiša; 
repairs	 ditokišo; lokiša; 
repatriation	pušetšogae; 
repeal	fediša; 
repealed	fedišitše;  fedišitšwe; 
repeals	fediša; 
repeat	boeletša; 
replace	 bea legatong la; bea bakeng; 
replaced	 bea legatong la; beile bakeng sa; 
replacement	peobakeng; 
replies	 dikarabo; araba;  fetola;  diphetolo; 
reply	araba;  fetola; 
report	pego; 
report-back	 pego ya ka moragonyana; begela; 
reported	begile; 
reporting	bega; 
reports	dipego; 
reposition	 beakanya leswa; bea leswa; 
repositioning	go bea leswa; 
repository	bobolokelo; boboloko; 
represent	emela; 
representation	kemedi;  tšweletša;  kemelo; 
representations	dikemedi; dikemelo;  ditlhagišo; 
representative	moemedi; 
representatives	baemedi; 
represented	emetše; 
representing	emela; 
represents	emela; 
repressive	ya kgatelelo;  ya peelothoko; 
republic	repabliki; 
republics	direpabliki; direphabliki; 
request	kgopelo; 
requested	kgopetše; 
requester	mokgopedi; 
requesting	kgopela; 
requests	dikgopelo; 
require	nyaka; 
required	nyakile; 
requirement	senyakwa; 
requirements	nyako; 
requires	nyaka; 
requiring	nyaka; 
requisite	ya maleba; 
rescue	phološa; 
research	nyakišišo;  dinyakišišo; 
researcher	mofatišiši; monyakišiši; 
researchers	bafatišiši; banyakišiši; 
reservation	peelomadulo; go se bolele selo; peeletšomadulo; 
reserve	boloka;  motlatši; 
reserved	 beetšwe; go se tsenatsene;  beetše; 
reserves	baakotši; boloka;  batlatši; 
residence	madulo; 
resident	modudi; 
residential	bodulo; 
residents	badudi; 
resides	dula; 
residing	dula; 
resignation	boitokollo; 
resilience	 go se nyame mooko;  go se fele maatla; kgotlelela;  ganelela; 
resistance	 go retela;  boitamolelo;  twantšho; thibela; 
resolution	sephetho; 
resolutions	diphetho; 
resolve	rarabolla; 
resolved	rarollotše; 
resolving	rarabolla; 
resounding	tlala;  kwagalago; 
resource	methopo; 
resources	methopo; 
respect	hlompha; 
respected	hlomphile; 
respective	ya malebana; 
respectively	ka tatelano; 
respects	hlompha; 
respond	araba;  kganela; 
responded	kganetše; arabile; 
respondent	mofetodi;  moarabi; 
respondents	bafetodi;  baarabi; 
responding	araba;  kganela; 
responds	araba;  kganela; 
response	 phetolo; karabo; 
responses	dikarabo;  diphetolo; 
responsibilities	maikarabelo; 
responsibility	 boikarabelo; maikarabelo; 
responsible	ikarabelago; 
responsive	 ya phetolo; ya go arabela; 
rest	khutšo;  seka sa khutšo; 
restitution	pušetšo ya ditokelo tša tšeano; 
restoration	pušetšo; pušetšosekeng; 
restorative	ya pušetšo; ya pušetšosekeng; 
restored	buseditše; 
restoring	busetša; 
restraint	kemelothoko; 
restrict	thibelela; 
restricted	 ileditše; thibeletše; 
restriction	mollwane;  kiletšo; 
restrictions	mellwane;  dikiletšo; 
restructuring	peakanyoleswa; tsošološo; 
result	 searolo; sephetho;  dipoelo;  poelo;  seatišo; 
resulted	feleditše; 
resulting	feletša; 
results	diatišo; diarolo;  diphetho; dipoelo; 
retail	kgwebjana; 
retain	hwetša gape;  bušetša;  hwetša leswa; 
retained	 bušeditše;  hweditše gape; hweditše leswa; 
retention	pušetšo; khwetšoleswa; khwetšogape; 
retired	 rotše modiro; tlogetše modiro; 
retirement	go rola modiro; 
retrieval	khwetšo; 
return	boa;  bušetša; 
returned	boile;  bušeditše; 
returns	boa; 
reveal	utolla; 
revealed	utollotše; 
revenue	ditseno; 
revenues	ditseno; 
reverse	boela morago; 
review	tshekatsheko; 
reviewed	sekasekilwe; 
reviewing	sekaseka; 
reviews	ditshekatsheko; 
revise	boeletša; 
revised	boeleditše; 
revision	poelelo;  tshekamolla;  poeletšo; 
revisions	dipušeletšo; poeletšo; 
revitalisation	peakanyoleswa; tsošološo; 
revoke	phumola; 
revolution	 modikologo; borabele;  tikološo; 
revolutionary	 moferekanyi; ferekanyago; 
reward	 putsa; fa;  aba; putsetša; 
rhino	tšhukudu; 
rich	 humile; mohumi; 
right	 la go ja;  ka maleba; tokelo;  sejeng;  toka; 
rightful	ya maleba; 
rights	ditokelo; 
rise	hlatloga;  rotoga; 
rising	 hlaba; gola;  tšwelela; 
risk	kotsi; 
risks	dikotsi; 
river	noka; 
rivers	dinoka; 
road	tsela; 
roads	ditsela; 
robust	 ye maatla; tiilego; 
rock	leswika; 
rod	 phatatekanyi; kgati; 
role	karolo; 
role-players	bakgathatema;  batšeakarolo; 
roles	dikarolo;  ditema; 
roll	rolo;  palongwalwa; 
roll-out	abela;  tsenya tirišong; 
rolled	rotšwe; 
rolling	 dira nkgokolo; kgokologa;  dikološa; 
rollout	abela;  tsenya tirišong; 
rolls	 dira nkgokolo; kgokologa;  dikološa; 
room	phapoši; 
rooms	diphapoši; 
root	modu; 
rooted	 ikepetšego; theilwego; 
roots	medu; 
rose	 rotogile; hlatlogile; 
round	 (ya) go dikologa;  (ya) nkgokolo;  lehlatlolane; dikologa;  nkgokolo; 
rounded	nkgokolo;  dikologile; 
roundtable	tafola ya dipoledivano; 
route	tsela; 
routes	ditsela; 
routine	tlwaelo; 
royal	sešate;  bogoši; 
royalties	mašokotšo; 
royalty	tefelo;  ba mošate; 
rule	molao;  rula; 
rules	 melawana; melao; 
ruling	sephetho; 
rulings	diphetho; 
run	ntlha; 
running	tshepedišo; 
runs	 tšhabeša;  ela; sepela; 
rural	nageng; 
sacred	kgethegileng; 
sacrifice	boikgafelo;  sehlabelo; 
sacrifices	maikgafelo; dihlabelo; 
sad	swaba; 
saddened	nyamišitšwe; 
sadness	manyami; 
safe	bolokegilego;  polokelo; 
safeguarding	sireletša; 
safety	 boiphemelo; polokego; 
said	 boletše; rile; 
salaries	 megolo; meputso; 
salary	 moputso; mogolo; 
sale	thekišo; 
sales	diphokoletšotefo; dithekišo; 
same	swana; 
sample	sešupo; 
samples	dišupo; disampolo; 
sampling	dira sampolo; 
sanction	kotlano ya dinaga; 
sanctions	dikotlotahliši; dikotlano tša dinaga; 
sanitation	tlhwekišo; 
sap	maswi; 
saps	 matute; maswi; 
satellite	 mothekgi; sathalaete; 
satisfaction	kgotsofalo; 
satisfactory	ye e kgotsofatšago;  ya go kgotsofatša; 
satisfied	kgotsofetše; 
satisfies	kgotsofatša; 
satisfy	kgotsofatša; 
save	boloka;  go thiba; 
saving	boloka;  go thiba; 
savings	tšheletepolokwa; 
saw	saga; 
say	bolela; 
saying	 rego; bolela; 
says	re;  bolela; 
scale	 leratho;  legapi; sekala; 
scarce	hlokega; 
scene	tema;  felo; 
scenes	ditemanatiragatšo; mafelo;  ditema; 
schedule	šetule; 
scheduled	šetuletšwe; 
schedules	 dišetule; dišetulo; 
scheduling	šetula; 
scheme	 beakanya;  tlhakatiro; peakanyo; 
schemes	dipeakanyo;  ditlamo; ditlhakatiro; 
scholar	moithuti; 
scholars	baithuti; 
scholarship	pasari; 
school	sekolo;  sekolo sa sekontari; 
schooling	 go tsena sekolo; dikolo; 
schools	dikolo; 
science	thutamahlale; 
sciences	dithutamahlale; 
scientific	tša saense; 
scope	monabo; 
score	 moputso;  sekoro;  nweša; mola;  masomepedi; 
scorecard	lenaneo la dintlha; 
scoring	 fa meputso; kora;  nweša; sekora;  go nweša; sekoro;  fa dintlha; 
scourge	matshwenyego; 
screen	hlahloba;  tšhireletšo; 
screening	tekodišišo; 
script	 mogatišo; sengwalwa; 
scrutinise	latišiša; 
scrutinize	latišiša; 
scrutiny	 tekodišišo; tlhokomedišišo; 
sculpture	bobetli; 
sea	lewatle; 
seal	setswaledi;  bitiela; 
sealed	 tswaletšwe; bitietše; 
search	fenyekolla; 
searched	nyakile; fenyekollotše; 
season	sehla; 
seasonal	 ya sehla; ya lebakanyana; 
seasons	dihla; 
seat	bodulo;  setulo; 
seats	madulo;  ditulo; 
sec	motsotswana; 
second	 tlatša;  motsotswana; (ya) bobedi; 
secondary	(ya) bobedi; 
secondly	ya bobedi; 
secret	sephiri; 
secretariat	bongwaledi; 
secretary	mongwaledi; 
secretary-general	mongwaledipharephare; 
section	karolo; 
sectional	ya dikarolo; 
sections	dikarolo; 
sector	lefapha; 
sectors	mafapha; 
secure	 lotegilego; lota; 
secured	lotegilego;  lotilwe; 
securing	 šireleditše; lota; 
securities	ditšhireletšego;  dipolokego; ditšhireletšo; 
security	 tšhireletšego;  tšhireletšo; polokego; 
see	bona; 
seeing	bona; 
seek	 kgopela; nyaka; 
seeking	 kgopela; nyaka; 
seeks	 kgopela; nyaka; 
seem	 tšwelela e ke; bonala; 
seems	 tšwelela e ke; bonala; 
seen	bone; 
segment	mosehlwana; 
segregation	kgethologanyo; 
seize	thopa; 
seized	thopile; 
seizure	dithunthane; bolwetši bja go wa;  tšeela; 
select	kgetha; 
selected	kgethile; 
selection	tlhopho; 
self	yena;  nna; 
self-determination	boitaolo bja naga; 
self-sufficiency	go kgona go itirela; 
selfless	go direla ba bangwe;  go se be sejato; 
sell	rekiša; 
selling	rekiša; 
seminar	seminara; 
seminars	diseminara; 
send	romela; 
sending	go romela; 
sends	romela; 
senior	godimo;  godingwana; 
sense	dikwi;  sekwi; 
sensitive	 kwešišago; kwang; 
sent	rometše; 
sentence	kahlolo;  ahlola;  lefoko; 
sentenced	 ahlotšwe;  ahlotše; dirile mafoko; 
sentences	mafoko;  dikahlolo;  ahlola; 
sentencing	 go ngwala lefoko;  go a hlola; ahlola; 
separate	 aroganya; aroganego;  arogane; 
separated	aroganego;  arogane;  arogantše; 
separately	ka go arogana; 
separation	karoganyo; 
sequestration	tšeela thoto ka lebaka la sekoloto; 
series	 mohlwaela; molokoloko; 
serious	ka nnete;  go se segasege;  ka makgonthe; 
seriously	ka nnete;  ka makgonthe; 
servants	badiredi;  bahlankedi; 
serve	romela;  direla;  solela; 
served	rometše;  diretše;  soletše; 
serves	romela;  direla;  solela; 
service	 kamogetšo; tirelo; 
serviced	diretše;  amogetše; 
services	ditirelo;  direla; dikamogetšo; 
serving	romela;  direla;  solela; 
session	kopano;  tiragalo; 
sessions	 dikopano; ditiragalo; 
set	 sehlaga;  sete; sehlopha;  bea (nako); 
sets	 sehlaga; teka; disete; sehlopha;  bea (nako); 
setting	lokiša; 
settle	ikagela; 
settled	 dutše; feditše go lefa;  lefetše; 
settlement	bofalalelo; 
settlements	maikgafelo; mafalalelo; 
settler	 mofalaledi; modudi; 
settlers	badudi;  bafalaledi; 
seven	šupa; 
several	mmalwa; 
severe	kudu;  ka maatla; 
sew	roka; 
sewing	roka; 
sex	bong; 
sexual	sa thobalano;  ya bong; 
sexually	tša thobalano;  tša bong; 
shall	o tlo; 
shape	sebopego;  go fa sebopego; 
shaped	 betlegile; bopegile;  bopile; 
shapes	dibopego;  go fa sebopego; 
shaping	go fa sebopego; 
share	kabo;  kabelo;  aba;  go šielana; 
shared	ielane; abile; 
shareholder	mongdišere; 
shareholders	bengdišere; 
shareholding	go ba mong wa dišere; 
shares	dišere; 
sharing	 abelana;  abela; aba;  go šielana; 
sharks	dišaka; 
sharp	bogale;  sekatletlolo; 
she	 yena; o; 
shed	 hlohlorega; leobo; 
shedding	oba; mengwakana ya polokelo;  hlohlorega; 
sheet	 lakane; letlakala;  lesenke; 
sheets	 masenke;  malakane; matlakala; 
shelter	seširelo;  mošaša;  šireletša; 
sheriffs	dišerifi; 
shift	tšhifi; 
shifted	tšhifi; 
shifting	tšhifi; 
shifts	 dinako tša mošomo; Ditšhifi; 
ship	sekepe; 
shipping	go romela ka sekepe; 
ships	dikepe; 
shock	letšhogo; 
shocked	 maketše;  tšhogile; tlabegile; 
shocks	matšhogo; dišoko; 
shop	lebenkele; 
shopping	 go ya mabenkeleng; go reka; 
shops	mabenkele; 
shore	lebopo; 
shores	mabopo; 
short	kopana; 
short-term	lebaka le lekopana; 
shortage	tlhaelelo; 
shortages	ditlhaelelo; 
shorter	kopananyana; 
shortly	ka boripana;  ka bokopana; 
should	o swanetše; 
shoulders	magetla; 
show	bontšha; 
showcase	laetša;  bontšha; 
showcasing	laetša;  bontšha; 
showed	bontšhitše; 
showing	laetša;  bontšha; 
shown	bontšhitše; 
shows	bontšha; 
side	lehlakore;  patoga;  lehlakore la lešela; 
sign	 seka seo se bonagalago;  saena;  leswao; seka; 
signal	 temoši; lemoša;  tšhupetšo; 
signals	 ditšhupetšo; lemoša; ditemoši; disikinale; 
signature	tshaeno; 
signed	saenetše; saenetšwe; sekile; 
significance	 mohola; bohlokwa; 
significant	 ye bohlokwa; ye mohola; 
significantly	 ye bohlokwa; ye mohola; 
signifies	ye e rago; ye e šupago;  ye laetšago; 
signing	saena; 
signs	maswao;  saena; 
silver	silibere; 
similar	swana;  swanago; 
similarly	ya go swana; 
simple	bonolo;  nolo; 
simply	gabonolo; 
simultaneously	mmogo;  ka nako e tee;  gotee;  sammaletee; 
since	go tloga; 
sincere	bonneteng; go bolela thwii; 
sincerely	ka go bolela thwii;  ka bonnete; 
sing	-opela; 
singer	moopedi; 
singing	 go opela; opela; 
sister	kgaetšedi; 
sisters	bosesi; bokgaetšedi; 
sit	sofa;  setulo; dula; 
site	setsha; 
sites	 disaete; ditsha; 
sitting	tulo; 
sittings	ditulo; 
situate	bea; 
situated	dutše; 
situation	 bodulo; maemo; 
situations	 madulo; maemo; 
six	tshela; 
sixth	(ya) boselela;  teetsheleng; 
size	 golo; bogolo; 
skill	 botsebi; bokgoni; 
skilled	wa tsebo;  wa bokgoni; 
skills	 botsebi; bokgoni; 
slave	 lekgobagadi; lekgoba; 
slavery	bokgoba; 
slaves	makgobagadi; 
slightly	gannyane; 
slip	thelela;  thupana; 
slow	nanya; 
small	 noka;  nyane; nnyane; 
small-scale	ye nnyane; 
smaller	nnyanenyana; nyanenyana; 
so	 ka fao; bjale; 
so-called	ye e bitvwago; 
soccer	kgwele ya maoto; 
social	 selegae; setšhaba;  kagišano; 
socially	ya setšhaba;  ya selegae;  ya kagišano; 
societal	ya setšhabeng; 
societies	dikopano;  ditšhaba; 
society	kopano;  setšhaba; 
socio-economic	ekonomi ya setšhaba; 
socioeconomic	ekonomi ya setšhaba; 
soil	mobu;  mabu; 
sold	rekišitše; 
soldiers	sešole;  mašole; 
sole	kgato ya seeta; 
solely	feela; 
solid	 ya bothata;  e tiilego; sethata;  selo se sethata; 
solidarity	kwelanobohloko; thekgano; 
solution	tharollo;  setološwa;  motswako; 
solutions	 setološwa; ditharollo;  metswako; metswakotološwi; 
some	 tše dingwe; ba bangwe; 
someone	motho yo mongwe; 
something	se sengwe; 
sometimes	ka dinako tše dingwe; 
somewhat	gannyane; 
son	 ngwana wa mošemane; morwa; 
song	 koša; pina; 
songs	dikoša;  dipina; 
soon	mo nakong ye e sa fetšego pelo;  ka pela; 
sophisticated	ye e hlakahlakanego; ye e tšwetšego pele; 
sort	beakanya; 
sought	 kgopela; nyaka; 
soul	moya; 
souls	meboya; 
sound	 modumo; tiilego; 
sounds	tiilego;  medumo; 
source	mothopo;  mohlodi; 
sources	methopo;  mehlodi; 
sourcing	hwetša; 
south	 ya borwa; borwa; 
southern	ya borwa; 
sovereign	boipušo;  kgoši; 
space	sebaka;  sekgoba; 
spaces	dibakana; 
spatial	 ya sekgoba; sekgoba; 
speak	bolela; 
speakers	seboledi;  mmoledi; 
speaking	bolela; 
speaks	bolela; 
spear	lerumo; 
special	kgethilwego;  itšeng; 
specialisation	 go tseba fela;  go kgona fela; go šoma fela; 
specialised	tseba; 
specialist	matwetwe; 
specially	kudukudu; 
species	legoro; 
specific	hlomameng; 
specifically	kudu;  fela ka ga;  mabapi le; 
specifications	ditlhalošadinyakwa; 
specified	file;  šupile; 
specify	šupa; 
specimen	 sešupo; sešupa; 
specimens	 dišupo; mehlala; 
spectacular	tiragatšo ye botse; 
spectrum	kakaretšo; 
speech	polelo; 
speeches	dipolelo; 
speed	lebelo;  bjako; 
speedy	ka potlako;  ka lebelo; 
spend	diriša;  šomišwa; 
spending	 diriša; šomišwa; 
spent	dutše;  tšere; 
sphere	nkgokolo; 
spheres	 dinkgokolo; dikgokolo; 
spirit	moya; 
spiritual	moyeng;  semoya; 
split	pharola; 
spoke	 boletše; rile; 
spoken	boletše; 
spokesperson	seboleledi;  mmoleledi; 
sponsored	thekgilwe; 
sport	dipapadi; 
sporting	 raloka dipapadi; dipapadi; 
sports	papadi; 
spotlight	lebonepontšho; 
spouse	mogatša; 
spouses	bagatša; 
spread	phatlalatša;  fetetša; 
square	 go dira sekwere; sekwere; 
stabilise	tiiša; 
stability	boitsetsepelo; 
stable	setala; 
stadiums	mapatlelo; 
staff	lepara; 
stage	kgato;  sethala;  kariki;  sefala; 
stages	 difala;  dithala; dikgato;  dikariki; 
staging	kelo ya magato a bolwetši; 
stakeholders	baamegi; bakgathatema; 
stalwart	motshepegi; 
stalwarts	bagale; 
stamp	setempe; 
stance	maemo; 
stand	pabilione; 
standard	mphato;  kemo; 
standardised	ya go swana;  ye swantšhitšwego; 
standardization	 ka go swana; tshwantšho; 
standards	mephato; dikemo; 
standing	swara;  eme; 
stands	ema;  eme; 
stanza	tematheto; 
star	naledi; 
stars	dinaledi; 
start	thoma; 
started	thomile; 
starting	thoma; 
starts	thomiša; 
state	 mmušo; naga; 
state-owned	ya mmušo; 
stated	 thomile; dinaga;  thomišitše; 
statement	 taodišo; tlhalošetšo; 
statements	kanego; 
states	 dinaga;  mebušo; maemo; 
stating	fa leemo; 
station	seteišene; 
stationery	dingwalelo; 
stations	diteišene; 
statistical	ya dipalopalo; 
statistician-general	mošomi wa dipalopalopharephare; 
statistics	dipalopalo; 
statue	molao;  sehlwaseeme; 
stature	molao wa go ngwalwa; 
status	maemo; 
statute	molao; 
statutes	melao; 
statutory	ya molao; 
stay	dula; 
steadily	gannyanegannyane;  ka go nanya; 
steady	kgwahlile; 
steal	utswa; 
steel	tšhipi;  tshipitshipi; 
steer	otlela; 
steering	seteraeba; 
step	 dikgato; kgato;  setepe; 
steps	ditepe; dikgato; 
sterling	kgahlišago; 
still	homotša; 
stimulate	tsoša; 
stimulating	 goketša; tsoša; 
stipulate	šupa; 
stipulated	šupile; 
stock	diruiwa;  phahlo; 
stolen	 utswitše; utswitšwe; 
stone	 kgatla ka maswika;  ntšha thapo; thapo; 
stood	eme; 
stop	 emiša; ema; 
storage	 bobolokelo; poloko; 
store	boloka;  lota;  polokelo; 
stored	 lotile; bolokile; 
stories	dikanegelo; 
storm	ledimo; 
story	taba;  kanegelo; 
storyteller	moanegi; 
storytellers	baanegi; 
storytelling	go anega kanegelo; 
strategic	 ya togamaano; ya maano; 
strategies	maano; 
strategy	leano; 
streams	meela; 
street	setrata; 
streets	mebila; 
strength	go tia; 
strengthen	maatlafatša; 
strengthened	maatlafaditše; 
strengthening	maatlafatša; 
stress	 tobeletša; kgatelelo;  tobeletšo;  kgatelelo ya monagano; 
strict	tlhoko; 
strides	 dikgato; magato; 
strike	 phula;  loma;  go ngala mošomo; hlaba; 
string	thapo; 
strip	 moseto; gagola;  mosetwana wa lešela; 
strips	 mesetwana ya lešela;  ditsekana; marathana; meseto; 
strive	katana; 
striving	katana; 
strong	maatla;  tiilego; 
stronger	maatlanyana; 
strongly	ka fao go tiilego;  ka maatla; 
struck	 phutše;  ngadile mošomo;  lomile; hlabile; 
structural	 ya sebopego; ya popego; 
structure	 popego; sebopego; 
structured	bopegile;  beakantšwe; 
structures	dibopego;  dipopego; 
struggle	 ragaraga; katana;  thagarago; 
struggles	 ragaraga; katana; dithagarago; 
struggling	 ragaraga; katana;  thagarago; 
student	 morutwa; moithuti; 
students	 barutiwa; baithuti; 
studies	ithuta; 
studio	phapoši;  phapošikgašo; 
studios	diphapošikgašo; diphapoši; ditutio; 
study	ithuta; 
style	setaele; 
sub	 fasana; nnyane; 
sub-item	selonyana;  selo sa ka fasana; 
sub-programme	lenaneonyana; 
sub-regulation	molawana wa ka fasana; 
subject	 serutwa;  molata; sediri;  ikoba; 
subjected	ikobile; dirile;  barutwa;  itlemile; 
subjects	 didiri; balata;  barutwa; balaolwa; 
submission	kakanyo; 
submissions	dikakanyo;  diromelwa; 
submit	neela; 
submitted	neetše; 
submitting	neela; 
subparagraph	temananyana; temana; 
subpoena	piletšo tshekong;  tagafaro; 
subpoenaed	tagafarile; bileditše tshekong; 
subscribe	tsenela; 
subscribed	tsenetše; 
subsection	karolwana; 
subsections	dikarolwana; 
subsequent	latelang; 
subsequently	mafelelong;  ka morago; ka maragonyana; 
subsidiary	ya ka fasana; 
subsidies	dikabo; 
subsidy	seabo; 
subsistence	thekgo;  thušo; ya boiphedio; tša boiphedišo; 
substance	selo; 
substances	dilo; 
substantial	kudu;  ye ntši; 
substantially	kudu;  ye ntši; 
substantive	leina; 
substitute	 bea bakeng sa;  kemedi; emela; 
substituted	 emetše; beile bakeng sa; tšeetše legato; 
substitutes	 bea bakeng sa; emela; 
substituting	 bea bakeng sa; emela; 
substitution	go bea bakeng sa; 
subtropical	(sa) nngamolatšatši; 
succeed	latela; 
succeeded	atlegile; 
success	katlego; 
successes	dikatlego; 
successful	atlega; 
successfully	 ka katlego; atlegilego; 
succession	tatelano; 
successor	molatedi; 
such	 ya mohuta woo; yeo; 
suffer	bolawa ke bolwetši; 
suffered	bolailwe ke bolwetši; 
suffering	tlaišego; 
sufficient	-lekanego; 
sufficiently	 ka go lekana; ye e lekanego; 
sugar	swikiri; 
suggest	hlagiša; 
suggested	hlagišitše; 
suggestion	kakanyetšo; 
suggestions	dikakanyo; 
suggests	hlagiša; 
suitable	swanetšego; 
suitably	 ka maleba; ka tshwanelo; 
sum	palo;  tlhakano; 
summary	kakaretšo; 
summer	selemo; 
summit	sehloa; 
summits	dihloa; disamiti; makgotlakgoparara; 
summoned	biditšwe;  biditše; 
summons	tagafalo; 
sung	opetše; 
superior	godimo; 
supervisees	 hlahla;  hlokometše; laola; 
supervision	tlhokomelo; 
supervisory	ya tlhokomelo;  ya taolo;  ya tlhahlo; 
supplement	tlaleletšo; 
supplementary	oketšago; 
supplied	 abile phepo; abilwe;  abile diphahlo;  abile; 
supplier	moabi; 
suppliers	baabi; 
supplies	diphepo; 
supply	kabo;  phahlo;  phepo;  aba; 
support	 -thekga;  thekga; hlokomela; 
supported	 hlokometše; thekgile; 
supporting	 thekga; hlokomela; 
supportive	 ya thekgo; sa thekgo; 
supports	 thekga; hlokomela; 
supposed	swanetše;  swanetšego; 
supreme	kgolo;  ya godimo; 
sure	bonnete; 
surely	ka bonnete; 
surface	sefahlego;  bogodimo; 
surplus	mašalela; 
surrender	ineela; 
surrounding	 dikologilego;  dikologa; tikologo; 
surveillance	 tekodišišo;  tlhapetšo; bohlodi; 
survey	tekolo; 
surveyor	molekodi; 
surveyors	balekodi; 
surveys	ditekolo; 
survival	phologo; 
survive	phologa; 
surviving	phologa; 
suspect	mogononelwa;  gonona;  gononela; 
suspected	gononetšwe; 
suspects	bagononelwa; 
suspend	 emiša; fega;  kadietša; 
suspended	-fegilwego; 
suspension	kemišo; 
suspensions	 diphego; dikemišo; diphego; Disaspenšene; 
sustain	swarelela; 
sustainability	go šoma go ya go ile; 
sustainable	ya go šoma go ya go ile;  ya go ya go ile; 
sustained	swareletše; 
sustaining	swarelela; 
swear	 roga; ena; 
swearing	 roga; ena; 
sworn	entšitšwe; ikanne; 
symbol	seka; 
symbolic	ya leswao;  ya taetšo; 
symbolically	ka taetšo; 
symbolises	laetša;  bontšha; 
symbolism	taetšo;  pontšho tšhupetšo; 
symbols	 maswao; dika; 
symposium	simphosiamo; 
symptom	 sešupo; seka; 
symptoms	 dišupo; dika; 
system	mokgwa; 
systematic	ka peakanyo; 
systematically	ka peakanyo; 
systemic	ya lenaneo; 
systems	mekgwa;  ditshepedišo; 
table	 tafola; lenaneo;  lenane;  tlhopho; 
tabled	 beile lenaneong; filwe;  hlophilwe;  adilwe; 
tables	ditlhopo; mananeo;  manane;  ditafola; 
tabs	kgotla; dithepo; 
tackle	baka; 
tags	maswao; ditheke; 
take	tšea; 
taken	tšere; 
takeover	 amogetša;  tšea; tšea madulo; 
takes	tšea; 
taking	 tšea; go tšea; 
tale	kanegelo; 
talent	 neo; talente; 
talented	-filwe; 
talents	dineo;  ditalente; 
tales	dikanegelo; 
talk	bolela; 
talking	go bolela; 
talks	bolela; 
tall	telele; 
tangible	ye e bonagalago;  ye e swaregago; 
tap	kokota;  pompi;  thepe; 
targeted	nepile;  lebantše;  nepišitše;  lebantšwe; 
targeting	 lebantše;  nepišitše; nepiša; 
targets	lebanya; dinepša; dilebanywa; 
tariffs	ditefelo; mananeotefo; 
task	tiro; 
tasked	filwe modiro; 
tasks	ditiro; 
taught	rutile; 
tax	motšhelo; 
taxable	ya go lefišwa lekgetho;  ya go lefišwa motšhelo; 
taxation	motšhelo; 
taxed	lefišitšwe motšhelo; 
taxes	metšhelo; 
taxpayer	motšhedišwa; 
taxpayers	balefamotšhelo; 
teach	ruta; 
teacher	morutiši; 
teachers	barutiši; 
teaching	thuto; 
team	sehlopha; 
teams	dihlopha; 
teaser	mmotšišiši; potšišo ye thata; 
technical	thekniki; 
technicians	boradithekniki; ditheknišeine; 
technique	 botsebi;  thekniki; mokgwa; 
techniques	mekgwa;  dithekniki;  botsebi; 
technological	ya theknolotši; 
technologies	ditheknolotši; 
technology	theknolotši; 
telecommunication	bokhoukhou; 
telecommunications	kgokaganyo ya mogala; 
telephone	 mogalantšu;  founa; mogala; 
television	thelebišene; 
tell	botša; 
telling	go botša; 
tells	botša; 
temporarily	lebakanyana;  ya nakwana;  ka nakwana; 
temporary	(sa) lebakanyana; 
ten	lesome; 
tend	 tlwaetše; fela; 
tender	tentere; 
tendered	thentarilwe; abilwe; 
tenders	dithentara; 
tension	 kgagamalo; ngangego; 
tenure	 lebaka la mošomo; pakatiro; 
term	 lereo; kotara; 
terminate	fediša; 
terminated	fedišitše; 
termination	phedišo; 
terminology	mareo; 
terms	mabaka; 
terrestrial	ya lefaseng; therestriale; 
territorial	ya mellwane; 
territories	mellwane; 
territory	naga; 
terrorism	botšhošetši; 
terrorist	motšhošetši; 
tertiary	ya godingwana; 
test	 teko;  molekwana; leka; 
tested	lekilwe; 
testimony	bohlatse; 
testing	leka; 
tests	meleko; ditekolo;  melekwana; 
text	temana;  diteng; 
than	go feta; 
thank	leboga; 
thanks	 ke a leboga; ditebogo; 
that	yeo; 
that's	ke gore; 
the	ya; 
theater	teatere; 
theatre	teatere; 
theatres	diteatere; 
theft	bohodu; 
their	ya bona; 
them	bona; 
theme	morero; 
themes	merero; dikošanatiragatšo; 
themselves	bona;  bona ka bobona; 
then	bona; 
theory	teori; 
therapy	 terapi; kalafi; 
there	fao; 
thereafter	ka morago ga fao; 
thereby	go realo; ka fao; 
therefore	ka tsela yeo; 
therein	ka fao; 
thereof	ka moo; 
thereon	ka fao; 
thereto	fao; 
thereupon	moragonyana ga fao; 
therewith	 ka pejana morago ga fao; mabapi le seo; 
these	tše; 
they	ba;  bona; 
thing	selonyana;  selo sa ka fasana; 
things	dilo; 
think	gopola; 
thinking	 monagano; kgopolo; 
third	teetharong; 
thirdly	 ya boraro; sa boraro; 
thirds	boteetharong; 
thirty	masometharo; 
this	selonyana;  selo sa ka fasana; 
thorough	ka botlalo; 
those	bao; 
though	le ge go le bjale; 
thought	kgopolo; 
thoughts	dikgopolo; 
thousand	sekete; 
thousands	dikete; 
threat	tšhošetšo; 
threaten	tšhošetša; 
threatened	tšhošeditše; 
threats	ditšhošetšo; 
three	tharo; 
three-day	matšatši a mararo; 
three-year	mengwaga ye meraro; 
threshold	bonnyane bja thekgo; 
thriving	 atlega;  huma; gola; 
through	ka mologo o tee; 
throughout	 ka moka; ka botlalo; 
thus	ke gore; 
ticket	thekethe; 
ticketing	aba dithekete; 
tickets	dithekete; 
tie	lekalekana;  seswaraganyi; 
tiers	mahlakore;  dikarolwana; 
ties	lekalekana; diswaraganyi; 
till	thili; 
time	nako; 
timeframes	 mellwane ya nako; dinakopewa; dinako; 
timely	e sa le nako;  ka nako; 
times	atiša; 
tirelessly	ka ntle le go lapa;  ka go se fele maatla; 
title	leina;  thaetlele; 
titled	ye leina la;  ye filwego leina; 
titles	 dithaetlele; maina; 
to	go ya; 
tobacco	 motšoko; motsoko; 
today	lehono; 
together	mmogo; 
toilet	 pitšana ya boithomelo; boithomelo;  ntlwana ya boithomelo; 
toilets	 dintlwana tša boithomelo; boithomelo;  dipitšana tša boithomelo; 
told	boditšwe; 
tolerance	kgotlelelo; 
tomorrow	gosasa; 
ton	tone; 
tonight	 mantšiboa; bošego bja lehono; 
tons	ditone; 
too	kudu;  le bona;  le nna; 
took	tšere; 
tool	thulusi;  setlabelo; 
toolkit	setlabelo; sephuthelo sa ditlabelo; 
tools	 dithulusi; ditlabelo; 
top	godimo;  topo; 
topic	taba; 
topics	dihlogotaba; ditaba; 
total	 yohle;  hlakanya; palomoka; 
totalled	 dirilwe palomoka;  hlakantše; dirile palomoka; 
tough	 ye maatla; tiilego; 
tour	leeto; 
touring	etela; 
tourism	boeti; 
tourist	moeti; 
tourists	baeti; 
tournament	 phadišano; thonamente; 
tournaments	diphadišano; dithonamente; 
tours	maeto; 
toward	go leba;  go ya; 
towards	go leba;  go ya; 
town	motse;  toropo; 
towns	 ditoropo; metse; 
townships	makheišene; 
toy	sebapadišwa; 
trace	 latišiša; lata; 
track	 tselana; tsela; 
trade	kgwebo;  gweba;  tiro; 
trading	gweba; 
tradition	tlwaelo;  go ya ka taodišo;  setšo; 
traditional	 -setšo; tša bagolo; 
traditionally	ka setšo; ka setlwaelo; 
traditions	 ditaodišo; ditlwaelo;  ditšo; 
traffic	dinamelwa;  sephethephethe; 
trafficking	 ya dinamelwa; ya sephethephethe; 
tragedy	masetlapelo; 
tragic	 ya masetlapelo; ya sehlogo; 
train	 rutantšha; terene; 
trained	rutantšhitšwe; hlahlilwe; rutantšhitše; 
training	thutantšho; 
trajectory	putlaganyo; 
transactions	dithekišetšano; 
transfer	 tšhutišo; kopolla;  šuthiša; 
transferred	fetišeditšwe; šuthišeditšwe; šuthišitše; 
transferring	kopollotve; šuthiša; 
transfers	ditšhutišo;  fetiša;  šuthiša; 
transform	fetišeša; fetoša; 
transformation	phetogo; 
transformed	 fetošitše; fetišeditše; 
transforming	 go fetoša; go fetišetša; 
transition	 phetogo ya segalo; phetolelo; 
transitional	 ya phetogo; ya lebakanyana; 
translate	fetolela; 
translated	fetoletše; 
translation	phetolelo; 
translator	mofetoledi; 
translators	bafetoledi; 
transmission	 phetetšo; phetišetšo; 
transmit	gaša;  fetiša;  fetetša; 
transmitted	feteditše;  fetišitše;  gašitše; 
transparent	 bonagatšago; bonagatšang; 
transport	 thotha; rwala; 
transportation	thotho; 
travel	-eta; 
travelled	etile;  sepetše; 
travelling	go eta;  go sepela; 
treasure	sehlokwa;  selo se bohlokwa; 
treasures	dihlokwa;  dilo tše bohlokwa; 
treasuries	ba matlotlo; dišegotlotlo; 
treasury	 sešegotlotlo; matlotlo; 
treat	 alafa; dira; 
treated	dirile;  alafile; 
treaties	dikwano; 
treatment	 kalafi; kalafo; 
treaty	kwano; 
tree	mohlare; 
trees	mehlare; 
trend	phetogo; 
trends	diphetogo; 
trial	tsheko;  tshekišo; 
trials	 ditshekišo; ditsheko; 
tribunal	 kgorotsheko; kgoro; 
tribunals	dikgoro;  dikgorotsheko; 
tribute	seloba; 
tried	lekile; 
triple	 dira gararo; gararo; 
triumph	phenyo; 
trophy	sefoka;  mogopo; 
troupe	sehlopha sa dibini; 
truly	ka nnete; 
trust	 trasete; holofela; 
trustee	mmolokedi; 
trustees	dithrasti; babolokedi; 
trusts	holofela; dithrasete; 
truth	therešo; 
try	tharo; 
trying	leka;  go leka; 
turfs	lloneng; mafelwaneng; bjanyeng; 
turn	sebaka;  retologa; 
turnaround	peakanyoleswa;  tokišo; retologa; 
turned	retologile; 
turning	meno; 
twelve	lesomepedi; 
twentieth	ya bomasomepedi; 
twenty	masomepedi; 
twice	gabedi; 
two	pedi; 
two-day	matšatši a mabedi; 
two-thirds	peditharong; 
type	mohuta;  tlanya; 
types	mehuta;  tlanya; 
typically	ka tlwaelo;  ka mehleng; 
ultimate	ya mafelelong; 
ultimately	mafelelong; 
un	se; 
unable	 go se kgone; palelwa; 
unacceptable	ye sa amogelegego; 
unanimous	ya go swana;  ya go kwanelwa; 
unauthorised	ye sa dumelelwago; 
uncertainty	hloka bonnete; 
unconstitutional	go se ye ka molaotheo; 
under	fase; 
underdevelopment	 tlhokego ya tlhabollo; go se hlabologe; 
undergo	 tsenela; dira; 
underlying	-bohlokwa; 
undermine	 nyenyefatša; nyatša; 
underpin	 tiiša; thekga; 
understood	kwešišitše; 
undertake	 tsenela; dira; 
undertaken	 tsenetše; dirile; 
undertaking	 lesolo; dira;  mošomo;  modiro; 
undertook	 tsenetše; dirile; 
underwater	ka fase ga meetse;  tša ka fase ga meetse; 
underway	 phethagatšwa; dirwa; 
undue	 ya go se nyakege; ye sego maleba; 
unemployed	yo a sa šomego;  wa go hloka mošomo; 
unemployment	 -sa šomego; go hloka mošomo; 
unfair	ye sa;  ye sa lokago; 
unfortunately	ka maswabi; 
unhappy	nyamile;  hloka lethabo;  swabile; 
unified	kopantše; 
uniform	 semphato; swanago; 
unify	kopanya; 
union	kopano; 
unions	dikopano; 
unit	botee; 
unitary	ya setee;  ya mohlakanelwa; 
unite	 kopantšha; kopanya; 
united	kopantšwego; 
units	 U; metšo; 
unity	seboka; 
universal	 ya bohle; ya mang le mang; 
universe	lefase le legodimo ka bophara; 
universities	diyunibesithi; 
university	yunibesithi; 
unknown	ya go se tsebje; 
unlawful	ye sego molaong; 
unleash	thakgola; 
unless	ka ntle le ge; 
unlike	 go sa swane; go thulana;  go fapana; 
unlikely	ya go se kgonagale; 
unnecessary	 ga e hlokagale; ya go se hlokagale; 
unprecedented	 ya go se tsebje; ye e se ya kago ya dirwa; 
unqualified	 hloka maloka; hloka maswanedi; 
unreasonable	 ya go se kwagale; ya go se kwešišege; 
unregistered	 yo a sa ngwadišwago; tše sa ngwadišwago; 
unsafe	ye sa bolokegago; tlhokapolokego; 
until	go fihla;  go fihlela; 
untold	ye sa anegwago;  ye sa botšwago; 
unusual	ye sego ya mehleng; 
unveil	tsebagatša; 
unveiled	tsebagaditšwe; 
unveiling	tsebagatša; 
up	godimo; 
upcoming	ye e tlago; 
update	sedimoša; mpshafatša; 
updated	sedimošitše; sedimošitšwe; mpshafaditše; 
updates	sedimoša; mpshafatša; 
upgrade	kaonafatša; 
upgraded	kaonafaditše; 
upgrades	kaonafatša; 
upgrading	kaonafatša; 
uphold	thekga;  tiišetša; 
uploading	tsenya; louta; 
upon	ka morago ga;  go yona; 
urban	motseng; 
urge	tutuetšo; 
urged	tutueditše; 
urgency	boitlhaganelo; 
urgent	ya potlako;  ya tšhoganetšo; potlalo; 
urgently	ka tšhoganetšo;  ka potlako; 
urges	kgopela; 
us	rena; 
usage	tšhomišo; 
use	tirišo ya sekero;  tirišo ya nalete;  diriša;  šomiša; 
used	omišitšwe; 
useful	mohola; 
user	modiriši;  mošomiši; 
users	 bašomiši; badiriši; 
uses	šomiša;  diriša; 
using	 diriša;  šomiša; omiša; 
usually	ka mehla; 
utilisation	 tirišo; tšhomišo; 
utilise	šomiša;  diriša; 
utilised	 dirišitše; šomišitše; 
vacancies	dibaka;  dikgoba; 
vacancy	sebaka;  sekgoba; 
vacant	ga e na selo;  hloka selo; 
valid	maleba;  nepagetšego; 
validity	mohola; 
valley	molapo; 
valuable	ye bohlokwa; 
valuation	tshekatsheho; tekolo; 
value	mohola;  boleng; 
valued	mehola;  diretšwe boleng; 
values	mekgwa ya boitshwaro; 
van	bene; 
variation	phapano; 
varied	 fapafapanego; fapanego; 
varies	fapane; 
variety	mehutahuta; 
various	ya mehutahuta; 
vary	fapanya; 
varying	fapanya; 
vast	kgolo; 
vehicle	senamelwa; 
vehicles	dinamelwa; 
vendor	morekiši; 
ventures	tsena; phonkgelela; 
venue	lefelo; 
venues	mafelo; 
verification	kgonthišišo; 
verify	-kgonthišiša; 
version	mohuta; bešene; 
very	kudu; 
vessel	sekepe;  tšhika;  mothapo;  sebjana; 
vested	filwego;  gafetšwego; 
veterans	bagale;  bomahlwaadibona; 
via	ka; 
viability	kgonagalo;  kgonega;  kgona go šoma ka katlego; 
viable	ye e kgonagalago;  ya go kgona go šoma ka katlego;  ye kgonegago; 
vibrant	 wa mafolofolo; ya mafolofolo; 
vice	patanyi; 
vice-chairperson	motlatšamodulasetulo; 
victim	motšwasehlabelo; 
victims	batšwasehlabelo; 
victor	mofenyi; 
victory	phenyo; 
videos	dibidio; 
view	tebelelo; 
viewed	bogetšwe;  bogetše; 
viewing	bogela; 
views	lebelela; 
village	motse; 
villages	metse; 
violations	dikgatako; 
violence	dikgaruru;  thubakanyo; 
violent	 wa dikgaruru; tša dikgaruru;  sa dikgaruru; 
virtually	 ya go nyaka go swana; ka go nyaka go swana; 
virtue	maemo a tlhompho;  maitshwaro a makaone; 
visible	bonagala; 
vision	pono; 
visionary	mogopolelapele; mogopolelabokamoso ka bohlale; 
visit	 ketelo; etela; 
visited	etetše; 
visiting	go etela; 
visitor	moeng; 
visitors	 baeng; baeti; 
visits	etela;  diketelo; 
visual	ya pono; 
visually	go go swantšha;  ka go bona; 
vital	bohlokwa; 
vocational	-piletšo; 
voice	kodu; 
voices	mantšu; 
void	 tlhokego; sebaka;  sekgoba; 
volatility	ya go fetoga ka pela;  ya go fetoga semeetseng; 
voluntarily	ka boithaopo; 
voluntary	boithaopo; 
volunteer	moithaopi; 
volunteers	baithaopi; 
vote	 bouta;  bouto; kgetha; 
voted	kgethile;  boutetše; boutile; 
voter	mokgethi; 
voters	bakgethi;  babouti; 
votes	 bouta; diboutu; kgetha; 
voting	go bouta; 
vulnerability	 go ba seemong sa go hlaka; go ba kotsing;  go ba seemong sa go hlophega; 
vulnerable	go ka gobala bonolo; 
wage	 tefo; mogolo; 
wages	megolo; meputso; 
waiting	letile;  emetše; 
walk	sepela; 
walks	sepela; 
wall	leboto; 
walls	maboto; 
want	 nyakego; nyaka; 
wanted	nyakega; 
wants	 dinyakwa; nyaka; 
war	ntwa; 
ward	 phapoši ya balwetši; mohlokomelwa; 
wards	bahlokomelwa; diphapoši tša balwetši; diwate; 
warm	borutho;  tutetšego; 
warmth	borutho; 
warning	temošo; 
warrant	taelo; 
warrants	ditaelo; 
wars	dintwa; 
was	e bile; 
waste	 ditlakala;  marathana; senya;  tšhila; 
watch	 tšhupanako; sešupanako; 
water	 nošetša; meetse;  nwešetša;  noša; 
waters	 nošetša; meetse;  tšhela;  nwešetša; 
wax	motu; 
way	tsela;  mokgwa; 
ways	mekgwa;  ditsela; 
we	rena; 
we've	re; 
weak	fokola; 
weakness	bofokodi;  seemo sa go hloka maatla le mafolofolo; 
weaknesses	mafokodi;  seemo sa go hloka maatla le mafolofolo; 
wealth	bohumi; 
weapon	sebetša; 
weapons	dibetša; 
weather	boso; 
web	bolepu; 
website	setsha sa inthanete; 
websites	diwepsaete; 
week	beke; 
week-long	beke ka moka;  botelele bja beke; 
weekend	mafelelo a beke; 
weeks	dibeke; 
weight	 sekadi; boima;  imetša; 
welcome	amogelwa; 
welcomed	amogetšwe; 
welcomes	amogela;  amogelwa; 
welcoming	amogela;  amogelwa; 
welfare	pabalelo; 
well	 petse; sediba; 
well-being	go phela gabotse; 
well-known	 tsebegago kudu; tsebegago;  tumilego; 
wellbeing	go phela gabotse; 
went	 tšwa; ile; 
were	bile; 
west	 ya bophirima; bodikela;  bophirima; 
western	bodikela; 
wetland	mohlaka; 
wetlands	mehlaka; 
what	seo;  eng; 
what's	seo se; 
whatever	efe goba efe;  eng goba eng; 
whatsoever	le gatee; 
when	 neng; ge; 
whenever	 nako efe goba efe; nako yeo; 
where	 kae; fao; 
whereas	mola; 
whereby	mo e lego gore; 
whereupon	ka pela morago ga fao; 
wherever	kae goba kae; 
whether	ge eba;  e ka ba; 
which	 bao;  seo;  efe; yeo; 
whichever	efe goba efe; 
while	 ka go le lengwe; mola; 
whilst	 mola e le gore;  ka go le lengwe; mola; 
whip	sefepi; 
whips	difepi; 
white	tšhweu; 
whites	makgowa;  tše tšhweu; 
who	 mang; bao; 
whole	ka moka; 
wholesale	holeseile; 
wholly	 ka moka; ka botlalo; 
whom	 mang; yoo; 
whose	yo; 
why	goreng; ka lebaka la eng; 
wide	ahlama;  -phara; 
widely	ka go ralala;  ka bophara; 
wider	mphara;  ahlamile; 
widespread	ye phatlaletšego;  ka bophara; 
wife	 mogatša; mosadi; 
wild	 befetšwego;  ya nageng; ragaraga; 
wildlife	diphoofolo;  bophelo bja diphoofolo; 
will	wili; tla; 
willing	nyaka; 
willingness	go nyaka; 
win	fenya; 
wind	phefo; 
winding-up	tswalela;  fediša;  rekiša;  go fetša; 
window	lefastere; 
wine	beine; 
winner	thwadi; 
winners	bathopi; 
winning	thopa;  fenya; 
winter	marega; 
wisdom	bohlale; 
wish	tumo;  lakaletša;  tlhologelo; 
wishes	ditlhologelo;  ditakaletšo;  ditumo; 
wishing	 go lakaletša;  go duma; go hlologela; 
with	le;  ka; 
withdraw	 metša mantšu; tloša; 
withdrawal	 gomiša;  tšwa;  gogela morago; goma; 
withdrawn	 gogetše mantšu morago;  tlošitše; meditše mantšu; 
within	 ka gare; ka go; 
without	ka ntle le; 
witness	hlatse;  paki; 
witnessed	 dipaki; bone; 
witnesses	 dipaki; dihlatse; 
woman	mosadi; 
women	basadi; 
women's	ya basadi; 
won	thopile; 
wonderful	ye e kgahlišago;  ya go kgahliša; 
wood	kota;  legong;  moopu;  sethokgwa; 
word	lentšu; 
words	mantšu; 
work	 tiro ya kgabo; dira;  mošomo; 
worked	 šomile; dirile; šomie; 
worker	 mošomi; modiri; 
workers	badiri;  bašomi; 
workforce	bašomi; 
working	šoma; 
workplace	mošomong; 
works	dira;  šoma;  mešomo; 
workshop	bošomelo; 
workshops	diwekešopo; 
workspace	lefelo la mošomo; 
world	lefase; 
world's	ya mafase;  ya lefase; 
world-class	ya meaemo a godimo; 
worlds	mafase; 
worldwide	ya lefase ka bophara; 
worrying	 belaetšago; tshwenyago;  hlophago boroko; 
worse	mpe; 
worst	mpe kudu; 
worth	lebanego;  swanetšego; 
worthy	 swanetše; lebane; 
would	tla; 
wound	ntho;  phula madi; 
wounds	 phula madi; dintho; 
write	ngwala; 
writer	mongwadi; 
writers	bangwadi; 
writers'	ya bangwadi; 
writing	mongwalo; 
writings	mengwalo; 
written	ngwadile; 
wrong	phošo; 
wrote	ngwadile; 
xenophobia	lehloyo la batšwantle; 
xenophobic	wa go hloya batšwantle;  wa lehloyo la batšwantle; 
year	ngwaga; 
year's	ya ngwaga; 
year-on-year	ngwaga ka ngwaga; 
years	mengwaga; 
yes	ee; 
yesterday	maabane; 
yet	 le ge go le bjale; le bjale; 
yield	tswala;  tšweletša; 
yields	 ditšweletšwa; dipuno; 
you	wena; 
young	ngwana; 
younger	nnyane;  mofsa; 
your	ya gago;  tša gago;  sa gago; 
youth	bofsa; 
zero	lefeela; 
zone	zoune; 
zones	dizoune; 
zoo	serapa sa diphoofolo; 
