Act of Parliament	umThetho wePalamende
Africa Institute of South Africa	iHlangano ye-Afrika yeSewula Afrika
African American	Um-Amerika om-Afrika
African Christian Democratic Party	Ihlangano ye-African Christian Democratic Party
African Development Bank	Ibhanga eThuthukisa ama-Afrika
African Diaspora	Iphalalo lama-Afrika
African Economic Community	Umnotho womPhakathi wama-Afrika
African National Congress	I-African National Congress
African National Congress Youth League	Ihlangano yeLutjha le-African National Congress
African Union	Inyonyana ye-Afrika
African country	Inarha ye-Afrika
African language	Ilimi le-Afrika
African nationalist	Umsekeli-narha we-Afrika
African people	Abantu be-Afrika
African renaissance	Ukuvuselelwa kobu-Afrika
African state	Umbuso we-Afrika
African wild cat	ipaka
Agricultural Research Council	Ikhansela Erhubhulula kezoLimo
Ambassador of	Umzenda we-
Arts and Culture Trust	Ithrasti yobuKghwari namaSiko
Bantu Authorities Act	UmThetho we-Bantu Authorities
Basic Conditions of Employment Act	ImiThetho yesisekelo sabaSebenzi
Black Economic Empowerment	UkuThuthukiswa kwabaNzima ngomNotho
Board of Directors	Ibhodi yabaNqophisi
British High Commissioner	uKomitjhinara omKhulu weBritain
Broad-based Black Economic Empowerment Act	UmThetho i-Broad-based Black Economic Empowerment Act
Bureau of Heraldry	Ibhiro yezobuKghwari
Call of South Africa	Ivakatjho/Ukubizwa kweSewula Afrika
Central Energy Fund	IsiKhwama se-Eneji ePhakathi
Chamber of Mines	Ikundla yeeMayini
Chief Executive Officer	umPhathi wesiGungu oPhezulu
Chief Justice	umPhathi wamaJaji
Christian Democratic Party	Ihlangano yeChristian Democratic
Civil Rights Movement	umSikinyeko wamaLungelo wabaHlali
Coat of Arms	Isiphandla senarha
Commission for the Promotion and Protection of the Rights of Cultural, Religious	Ikomitjhini yokuThuthukisa kanye nokuVikela amaLungelo wamaSiko, zeKolo
Commonwealth of Independent States	Ukuzijamela kwemiBuso yeentjhaba ezizijameleko
Congress of Democrats	iHlangano yabantu abakholelwa entandweni yenengi
Constitution of the Republic of South Africa	umThethosisekelo weRiphabliki yeSewula Afrika
Constitutional Assembly	umbuthano womthethosisekelo
Constitutional Court	Ikhotho yomthethosisekelo
Council for Scientific and Industrial Research	Ikhansela yeSayensi neRhubhululo kwezamaBubulo
Council of Ministers	Umkhandlu waboNgqongqotjhe
Council of Provinces	Umkhandlu wamaPhrovinsi/weemfunda
Council of Traditional Leaders	Umkhandlu wabaRholi beNdabuko
Cradle of Humankind	I-Cradle of Humankind
Criminal Procedure Act	uMthetho weKambiso yobuLelesi
Customs and Excise	umKhuba kanye nemiThelo yangaphakathi
Day of the Covenant	Ilanga lesiVumelwano
Democratic Alliance	IDemocratic Alliance
Democratic Party	Ihlangano yeDemocratic Party
Department of Justice	UmNyango wezoBulungiswa
Department of National Education	UmNyango weFundo yeliZwe loke
Department of State	umNyango womBuso
Department of Water Affairs	UmNyango weeNdaba zamaNzi
Deputy Speaker	Isekela likaSomlomo
Deputy Speaker of Parliament	Isekela likaSomlomo ePalamende
Director of Public Prosecution	umNqophisi weVikeleko lomPhakathi
Director of Public Prosecutions	abaNqophisi beVikeleko lomPhakathi
Dutch East India Company	I-Dutch East India Company
Dutch Reformed Church	I-Dutch Reformed Church
Eastern Cape	iPumalanga Kapa
Employment Equity Act	umThetho wokuQatjha ngokuLinganisa
Environmental Impact Assessment	Ukuhlola amandla kwezebhoduluko
European Union	Inyonyana ye-Eurpoe
Executive Council	umKhandlu wesiGungu
Financial Services Board	iBhodi yemiSebenzi yeeMali
Financial and Fiscal Commission	Ikomitjhani yeemali kanye nerevenyu yombuso
Fire Protection Association	iHlangano eVikela imiLilo
First World	Iphasi mazombe elithuthuke ngokwaneleko
First World War	Ipi yokuthoma yephasi mazombe
Foundation for Creative Arts	Isisekelo esimayelana nekghono lobuKghwari
Free State	i-Free State
Free State Stadium	Itatawu leFree State
Freedom Charter	Umtlolo onikela amalungelo wekululeko
Freedom Day	Ilanga leKululeko
Freedom Front	Ifreedom Front
Gauteng Provincial Government	Umbuso/uRhulumende wePhrovinsi ye-Gauteng
Heads of Diplomatic Missions	Iinhloko zamaMitjhini waboSomaqhinga
Health Professions Council of South Africa	Umkhandlu waboNesi eSewula Afrika
High Court	Ikhotho ePhakemeko
High Court of South Africa	iKhotho ePhakemeko yeSewula Afrika
Horn of Africa	Iphondo le-Afrika
House of Assembly	Indlu yesiBethamthetho
House of Commons	Indlu yabaHlanganisiweko
House of Delegates	Indlu yeenThunywa
House of Lords	Indlu yamaKholwa
House of Representatives	Indlu yabaJameli
Human sciences research	irhubhululo ngesayensi yabantu
Industrial Development Corporation	ikhamphani eThuthukisa ibubulo
Information Society and Development	ilwazi ngomphakathi nokuThuthukisa
Inkatha Freedom Party	Ihlangano i-Inkatha Freedom Party
International Labour Organisation	Ihlangano yemisebenzi yeentjhabatjhaba
International Monetary Fund	i-International Monetary Fund
International Olympic Committee	Ikomidi yemidlalo yeentjhabatjhaba
International Relations	Itjhebiswano elihlangana neenarha
International Telecommunications Union	Inyonyani yethungelelwano ngommoya kweentjhabatjhaba
Labour Relations Act	umThetho wobudlelwano kwezomsebenzi
Land Claims Court	Ikhotho yemibango yenarha
Language Task Group	Isiqhema esiqalelele ilimi
Member of Parliament	ilunga lepalamende
Minister of Education	UNgqongqotjhe wezeFundo
Minister of Justice	Ibhodi yemiKhawulo yaboMasipala
Minority Front	I-Minority Front
Municipal Demarcation Board	Umkhandlu wokumaketha zelimo enarheni
NCOP Committee	Ikomidi ye-NCOP
Natal Indian Congress	Ihlangano yeNatal India
National Agricultural Marketing Council	Imyuziyemu yomlando wamasiko enarheni
National Assembly	Indlu yesiBethamthetho seNarha
National Commissioner	Ikomitjhinara yesiTjhaba
National Cultural History Museum	Imyuziyemu yomlando wamasiko enarheni
National House of Traditional Leaders	Indlu yamakhosi
National Intelligence Agency	I-Ejensi yobuHlakani beNarha
National Marketing Council	Umkhandlu wokuMaketha enarheni
National Monuments Council	Umkhandlu  wamaTje weenKhumbuzo enarheni
National Party	Isiqhema seNational Party
National Qualifications Framework	I-National Qualifications Framework
National Revenue Fund	Isikhwama seRevenyu yenarha
National Swimming Federation	Ihlangano yokuDuda enarheni
National Training Board	Ibhodi eBandula isiTjhaba
New National Party	Isiqhema seNational Party eTja
Nkosi Sikelel' iAfrika	INkosi Sikelel' iAfrika
Nobel Peace Prize	Unongorwana we-Nobel Peace Prize
Northern Cape	Itlhagwini Kapa
Orange Free State	I-Orange Free State
Orange River Sovereignty	I-Orange River Sovereignty
Organisation for African Unity	Ihlangano yeBumbano lama-Afrika
Organisation of African	Ihlangano ye-Afrika
Organisation of African Unity	Ihlangano yeBumbano le-Afrika
Pan Africanist Congress of Azania	I-Pan Africanist Congress of Azania
People Against Gangsterism and Drugs	Abantu abalwisana nobuLelesi kanye neenDakamizwa
Perishable Products Export Control Board	IBhodi elawula imikhiqizo eyonakala msinya  ethunyelwa ngaphandle
President of the Senate	UMongameli weSenate
Pretoria Art Museum	I-Pretoria Art Museum
Pretoria East Cemetery	Amathuna we-Pretoria East
Provincial Commissioner	uKomitjhinara wesiFunda
Provincial House of Traditional Leaders	Indlu yesiFunda yabadosiphambili bezeNdabuko
Public Administration	Ukuphathwa komphakathi
Public Order Policing	AmaPholisa atjheja ukukhamba kuhle kwezinto emphakathini
Public Protector	UmVikeli womPhakathi
Public Service Commission	Ikomitjhini yemiSebenzi yomPhakathi
Republic of South Africa	Iriphabliki yeSewula Afrika
Reserve Bank	I-Reserve Bank
SA Library for the Blind	Ibulungelo leencwadi leSewula Afrika labantu abangaboniko
San rock painting	Imigwalo yamatje wesitjhaba sama-San
Second World War	Ipi yesibili yePhasi
Sector Education and Training Authority	Isiphathimandla seNgcenye yezeFundo kanye neBandulo
Skills Development Act	umThetho wokuThuthukisa amaKghono
South African Bureau of Standards	I-South African Bureau of Standards
South African Chamber of Commerce	I-South African Chamber of Commerce
South African Communist Party	I-South African Communist Party
South African Council of Churches	Umkhandlu wamasondo weSewula Afrika
South African Defence Force	Iphiko lokuVikela leSewula Afrika
South African National Civic Organisation	Ihlangano yeSewula Afrika yenarha yomphakathi 
South African National Defence Force	iPhiko leNarha lokuVikela leSewula Afrika
South African National Parks	Amaphaga weNarha eSewula Afrika
South African Native National Congress	I-South African Native National Congress
South African Police	Amapholisa weSewula Afrika
South African Qualifications Authority	AbaGunyazi bamaKhwalifikhetjheni eSewula Afrika
South African Reserve Bank	Ibhanga yeSewula Afrika
South African Revenue Service	Imisebenzi yeRevenyu eSewula Afrika
South African Secret Service	Umsebenzi oyifihlo weSewula Afrika
South African Sugar Association	Ihlangano yeTjhukela eSewula Afrika
South African design	Idizayini yeSewula Afrika
South African tea	Itiye yeSewula Afrika
Southern Africa	I-Sewula Afrika
Southern African Large Telescope	iTheleskowubhu ekulu eSouthern Afrika
State Department	umNyango womBuso
State President	uMengameli womBuso
Statistics South Africa	Iimbalobalo zeSewula Afrika
Supreme Court	Ikhotho ePhakemeko
The Call of South Africa	Ukubizwa kweSewula Afrika
The National Qualifications Framework	iTlhatlha lamaKhwalifikhetjheni wenarha
The South African National Council for the Blind	Ikhansela yabantu abangaboniko  yenarha yeSewula Afrika
UN Security Council	Umkhandlu weVikeleko we-UN
Union of South Africa	Inyonyani yeSewula Afrika
United Christian Democratic Party	Ihlangano i-United Christian Democratic Party
United Democratic Front	Ihlangano i-Democratic Front
United Democratic Movement	I-United Democratic Movement
United Nations	Iintjhaba ezibumbeneko
Universal Declaration of Human Rights	ukuvezwa kwamalungelo wobuNtu eenarheni-mazombe
Water Research Commission	Ikomitjhini eRhubhulula ngamanzi
West Bank	Ibhanga yeTjingalanga
Western Cape	Itjingalanga Kapa
Willem Prinsloo Agricultural Museum	Imyuziyemu yezeLimo i-Willem Prinsloo Agricultural Museum
World Heritage Site	Indawo yamagugu wePhasi-mazombe
World Trade Organisation	iHlangano yeRhwebo lePhasi-mazombe
World War I	Ipi yePhasi yokuthoma
World War II	Ipi yePhasi yesibili
World Wildlife Fund	Isikhwama seenlwana zommango ePhasini-mazombe
abuse of power	ukuphathwa kumbi kwamandla
academic freedom	ikululeko ngokwefundo
account for	ukuziphendulela mayelana na
account to	ukuziphendulela ku
accountable for	ukuziphendulela ngoku-
accounting officer	isiphathiswa esinokuziphendulela
acid mine drainage	idreyini ye-esidi yeemayini
act of state	umthetho wombuso
ad hoc	kwesikhatjhana
administration of justice	ukuphatha  ubulungiswa
administrative action	isenzo sokuphatha
administrative function	umsebenzi wokuphatha
administrative powers	amandla wokuphatha
advancement of technology	ukuthuthukiswa kwethekhnoloji
advisory body	umkhandlu oyelelisako
affirmative action	ihlelo lokulungisa
against the law	ukuphambana nomthetho
agent of change	umlethimatjhuguluko
air traffic	ubunengi bezinto ezikhamba emmoyeni
air traffic control	ilawulo lethrefiki yommoya
all rights reserved	woke amalungelo  afunjethwe
all the time	ngaso soke isikhathi
annual financial statement	iintatimende zeemali zaqobe mnyaka
annual general meeting	umhlangano waqobe mnyaka
annual report	umbiko wokuphela komnyaka
appoint the cabinet	-khetha ikhabinedi
appropriate technology	ithekhnoloji efaneleko
area of interest	indawo yekareko
area of jurisdiction	indawo yamandla wokuthatha iinqunto
area of land	indawo yenarha
area of responsibility	indawo yesibopho
armed struggle	ipi yeenkhali
as amended	njengombana kukhitjelelwe
as far as possible	kude ngendlela ongakghona ngayo
as many as	ngobunengi ngo
as soon as possible	msinyazana/ ngokukopeza kwelihlo
assumption of duty	ukuthoma ukusebenza
at a meeting	emhlanganweni
at the age of	emnyakweni we-
attainment of independence	ukuzuzwa kwekululeko
attend a meeting	ukukhambela umhlangano
basic human rights	Amalungelo wobuntu asisekelo
basic needs	iindingo ezisisekelo
basic rights	amalungelo asisekelo
bear witness to	ukuba ngufakazi kilokho
bed and breakfast	Amalalo nokudla kwebhrakfesi
bilateral relations	itjhebiswano lamahlangothi amabili
bill of rights	ivikelamalungelo
black power movement	umsikinyeko wamandla wabantu abanzima
board of directors	Ibhodi yabaNqophisi
board of trustees	iBhodi ebekiweko/ekhethiweko
body of water	umzimba wamanzi
border post	imikhawulo yeenarha
bottom line	okuqakathekileko
box office returns	indawo lapha kuthengiswa khona amathikithi
branches of government	amagatja wombuso/karhulumende
budget process	ikambiso/irherho lebhajedi
budget vote	Ivowudu ngesabelo seemali
build a part	ukwakha ingcenye
bunch of grapes	ipakana yamadribe
bus rapid transit	ikambiso yeenthuthi zomphakathi
business community	ibhizinisi yomphakathi
business sector	iphiko lebhizinisi
by the authorities	ngokweemphathimandla
by virtue of	ngokubakhona kwento
by way of	ngokwendlela yokwenza
by word of mouth	ngokukhuluma ngomlomo
call centre operator	umsebenzisi wesentha yemitato
call for nominations	ukufaka  amabizo wabakhethwako
capacity building	ukwakha ikghono
capital city	ihlokodorobho
central government	umbuso ophakathi
certify a bill	ukuqinisekisa umthethomlingwa
chamber of commerce	ikundla yekhomesi
change of address	ukutjhugulula isiphande
change of course	ukutjhugulula ikhosi
changes over time	amatjhuguluko ngokukhamba kwesikhathi
changing society	umphakathi otjhugulukako
checks and balances	ikambiso lapha iingcenye zehlangano zinamandla wokulawula ezinye iingcenye
chief executive	Umphathi wesiGungu
chief whip	uSosibebhe omKhulu
child abuse	ukutlhoriswa kwabentwana
child rearing practices	indlela abentwana abakhuliswa ngayo
children of Africa	abentwana be-Afrika
city centre	ikaba yedorobho
civil rights	amalungelo wabahlali
civil service	umsebenzi womphakathi
civil society	umphakathi
civil war	ipi yomphakathi
coat of arms	isiphandla
code of conduct	imithetho yokuziphatha
code of ethics	indlela yokuziphatha ngendlela elungileko
collection of data	ukubuthelelwa kwedatha
collective responsibility	isibopho ngokuhlanganyela
colonial power	amandla wekholoni
colonial rule	ukubuswa yikholoni
come into force	ukuba khona
come to the point	ukuveza iphuzu
committee meeting	umhlangano wekomidi
common interest	okuthandwa nguwokewoke
community broadcasting service	umrhatjho womzana
community building	ukwakha umphakathi
community development	ukuthuthukisa umphakathi
community involvement	ukuzibandakanya komphakathi
community participation	ukubandakanyeka komphakathi
community police forum	iforamu yamapholisa womphakathi
community service	umsebenzi womphakathi
conclude an agreement	ukuvumelana
conditions of contract	imibandela yekontraga
conditions of service	imibandela yomsebenzi
conflict prevention	ukukhandela irarano
conflict resolution	ukurarulula irarano
constitutional democracy	idemokhrasi yomthethosisekelo
constitutional mandate	igunya ngokomthethosisekelo
constitutional state	Umbuso womthethosisekelo
consumer price index	isilinganiso sokutjhuguluka kwentengo
contempt of parliament	ukudelela ipalamende
convene a meeting	bamba umhlangano
cooperation agreement	isivumelwano ngokubambisana
course of action	unobangela wokwenza okuthileko
cultural change	itjhuguluko ngokwesiko
cultural community	umphakathi onamasiko
cultural diversity	ukuhlukahlukana ngokwamasiko
cultural goods	ipahla yamasiko
cultural heritage	ilifa lamasiko
cultural revolution	ivukelambuso ngokwamasiko
culture of human rights	isiko ngamalungelo wobuntu
current affairs	iindaba zanje
customary law	imithetho yokwenza izinto ngokwendlela yakade
customs and excise	umkhuba  nemithelo yangaphakathi
cutting edge	ukudosa phambili/ntanzi
data collection	ukubuthelela imininingwana
date of birth	ilanga lamabeletho
decent living	ukuphila ngendlela ehle
deciduous fruit industry	ibubulo leenthelo eziwako
defence force	iphiko lezokuvikela
degree of freedom	ubukhulu bekululeko
delegated legislation	umthetho ogunyaziweko
demand and supply	isifuno nokuthunyelwa ngaphandle
democratic culture	isiko lentando yenengi
democratic election	amakhetho wentando yenengi
democratic political order	umlayo wepolotiki wentando yenengi
democratic principle	ikambiso/irherho lentando yenengi
democratic society	umphakathi wentando yenengi
democratic state	umbuso wentando yenengi
democratic transformation	amatjhuguluko wentando yenengi
democratic values	imikghwa yentando yenengi
deputy minister	isekela likangqongqotjhe
deputy president	isekela likaMongameli
dereliction of duty	ukubhalelwa kukwenza umsebenzi
developing country	inarha esathuthukako
development initiatives	Imizamo yokuthuthuka
development process	ikambiso yokuthuthuka
development programme	ihlelo lokuthuthuka
development strategy	iqhinga lokuthuthuka
diplomatic corps	umkhakha wabahlakani opheleleko o-akhredithiweko
diplomatic relations	amatjhenbiswano kwezobuhlakani
direct support	isekelo elibunqopha
director general	umnqophisi zombelele
disaster management	ilawulo lehlekelele
disciplinary action	isenzo sokukhalinywa
discussion document	umtlolo okucocwa ngawo
dispossession of land	ukuthathwa kwenarha
distribution capacity	umthamo wokwaba
distribution of resources	ukwabiwa kweensetjenziswa
distribution of wealth	ukwabiwa komnotho
district municipality	umasipala wesiyingi
diverse society	umphakathi ohlukahlukeneko
diversity of people	ukuhlukahlukana kwabantu
divide and rule	ukuphatha ngokuhlukanisa abantu
domain name authority	igunya lebizo ledomeyini
down for discussion	ukungabi namandla wokucoca
draft bill	umTlamo womThethomlingwa
draft legislation	umtlamo womthetho
early warning	amatshwayo wamsinya
early warning system	ikambiso yesiyeleliso samsinya
ease of access	ukungena lula
economic empowerment	ukunikela umnotho amandla
economic growth	ukuthuthuka komnotho
economic impact	amandla womnotho
economic relations	amatjhebiswano kwezomnotho
economic sector	iphiko lezomnotho
economic strength	amandla wezomnotho
effective public service	umsebenzi womphakathi okhamba kuhle
election period	isikhathi samakhetho
election process	ikambiso yamakhetho
election results	imiphumela yamakhetho
enabling environment	ukukghonakalisa ibhoduluko
entitled to vote	ukuba negunya lokuvowuda
environmental impact	amandla webhoduluko
environmental impact assessment	Ukuhlola amandla kwezebhoduluko
equal opportunities	amathuba alinganako
equality before the law	ukulingana ngaphambi komthetho
every three years	qobe minyaka emithathu
executive action	isenzo sesigungu
executive authority	isigungu esiphetheko
executive organs of state	imikhakha yesigungu sombuso
explanatory memorandum	imemorandamu enehlathululo
fair election	amakhetho akhambe kuhle
fall in love	-qoma
fauna and flora	iinlwana neentjalo
field of study	umkhakha ofundelwako
fill a vacancy	ukuvala isikhala/ ukuqatjhwa
financial year	umnyaka weemali
fiscal discipline	ukujeziswa ngokwerevenyu yombuso
five hundred and six	amakhulu amahlanu nesithandathu
follow up	ilandelela
food security	ivikeleko lokudla
forced labour	umsebenzi owenziwa ngokukatelelwa
fore and aft	ngaphambili nangemva
fore and after	ngaphambili nangemva
foreign direct investment	ukusisa iimali zangaphandle bunqopha
foreign exchange	itjintjiselwanomali yangaphandle
foreign policy	umgomo weenarha zangaphandle
free of charge	simahla
free society	umphakathi otjhaphulukileko
freedom fighter	umlwelikululeko
freedom of association	ikululeko yokuhlanganyela
freedom of conscience	ikululeko yokuzicabangela
freedom of movement	ikululeko yokuya lapha ufuna ukuya khona
freedom of religion	ikululeko yekolo
freedom of scientific research	ikululeko yokurhubhulula ngokwesayensi
freedom of speech	ikululeko yokukhuluma
freedom of the press	ikululeko yeembikiindaba
from the front	ukusuka ngaphambili
full supply level	ukuzalisa izinga lalokho okuthunyelwako
functional area	indawo okusetjenzelwa kiyo
fundamental human rights	amalungelo wobuntu aqakathekileko
fundamental rights	amalungelo aqakathekileko
future research	irhubhululo lesikhathini esizako
gender equality	ukulingana ngokobulili
gender inequality	ukungalingani ngokobulili
gender violence	ukulwisana ngobulili
general election	ikhetho zombelele
get away with	ukungatholwa unomlandu
give evidence	nikela ubufakazi
global development	ituthuko yephasi mazombe
global economy	umnotho wephasi mazombe
global village	ithreste lephasi mazombe
go on for	ukuragela phambili nokufuna
goods and services	iimpahla kanye nemisebenzi
governing party	ihlangano ebusako
government action	isenzo sombuso
government authority	igunya lombuso
government by the people	umbuso wabantu
government department	umnyango wombuso
government funding	isikhwama seemali zombuso
government level	izinga lombuso
government of the day	umbuso wesikhatheso
government policy	umgomo wombuso
government sector	iphiko lombuso
government services	imisebenzi yombuso
governmental organisation	ihlangano yombuso
grassroots level	ezingeni eliphasi
guard of honour	ukuhlonitjhwa
guilty of contempt	ukubekwa umlandu wokungahloniphi ikhotho
half a million	isiquntu sesigidi
have a vote	ukuvowuda
head of government	ihloko yombuso
head of office	i-ofisi ekulu
health care	itlhogomelo lezamaphilo
hierarchy of authority	irherho lokulandelana ngokuphatha
historically disadvantaged	abadinywe amathuba ngaphambilini
hold a meeting	ukubamba umhlangano
hold office	ukuba se-ofisini
honorary citizenship	ubakhamuzi obuhloniphekako
honours and awards	ukuhlonitjhwa kanye nemitlomelo
host country	inarha engusomnyanya
host nation	isitjhaba esingusomnyanya
house of assembly	Indlu yesiBethamthetho
houses of parliament	izindlu zepalamende
human development	ituthuko yabantu
human dignity	isithunzi sabantu
human nature	imvelo yabantu
human race	iphaliswano labantu
human resource	umuntu
human resource development	ukuthuthukisa abantu
human rights	amalungelo wobuntu
human rights abuse	ukutlhoriswa kwamalungelo wobuntu
human rights activist	umlweli wamalungelo wobuntu
human security	ivikeleko labantu
imbalances of the past	ukungalingani kwesikhathi esidlulileko
immediate past president	umengameli oqeda ukuphatha
in accordance with	ngokukhambisana nalokho
in accordance with the rules	ngokukhambisana nemithetho
in addition to	ngokungezelela kilokho
in an acting capacity	ngokuba  sesikhundleni sokuba mjaphethe
in any way	ngenye nenye indlela
in case of	nange kwenzeka
in celebration of	ngokunyanyela
in compliance with	ngokukhambisana nalokho
in connection with	mayelana nalokho
in consultation with	ngokubonisana nalokho
in excess of	ukudlula lokho
in favour of	ngokuvumelana nalokho
in front of	ngaphambi kwa
in good faith	ngommoya omuhle
in office	nge-ofisini
in so far	ukufikela lapho
in spite of	nanyana kunjani
in support of	ngokusekela
in terms of	ngokutjho kwalokho
in the balance	ngokudzimelela
in the course of	nakwenzeka lokho
in the evening	ebusuku
in the event of	nakwenzeka lokho
in the field of	emkhakheni walokho
in the gap	esikhaleni
in the interim	okwesikhatjhana
in the lead	ngokudosa phambili
in the long term	ekukhambeni kwesikhathi
in the majority	ngokwenengi
in the morning	ekuseni
in the name of	ngokugunyazwa
in the picture	ukuba lapho
in the white	ukubonakala
inaugural address	ikulumo yokwethula umuntu
inaugural meeting	umhlangano wokwethula umuntu
income tax	umthelo
indigenous culture	isiko lendabuko
indigenous language	ilimi lendabuko
indigenous people	abantu bendabuko
industrial society	ibubulo lomphakathi
infant mortality rate	inani lokuhlongakala kwamasana
information retrieval	ukuthola ilwazi
information retrieval system	ikambiso yokuthola ilwazi
inner city	ngaphakathi kwedorobho
inspector of mines	umhloli weemayini
intellectual property rights	amalungelo wepahla engeyengqondo
intergovernmental relations	itjhebiswano laborhulumende
interim constitution	umthethosisekelo wesikhatjhana
international affairs	iindaba zeenarha mazombe
international community	umphakathi weenarha mazombe
international humanitarian law	umthetho wepi
international olympic committee	Ikomidi yemidlalo yeentjhabatjhaba
international relations	amatjhebiswano weenarha mazombe
interrupt the proceedings	ukuthikazisa iinkambiso
investment of capital	ukusiswa komnotho
job creation	ukwakha imisebenzi
joint committee	ikomidi yehlanganyela
joint meeting	umhlangano wehlanganyela
joint responsibility	isibopho esihlanganyelweko
joint rules committee	imithetho yekomidi ehlanganyelweko
joint sitting	Ihlalohlanganisela leziNdlu zePalamende
judicial authority	igunya lezobulungiswa
keep in mind	ukukhumbula
keep up to date	ukwenza kukhambisane nesikhathi
key performance area	indawo eqakathekileko yokusebenza
labour force	amandla kwezomsebenzi
labour intensive	ukungenelela kwezomsebenzi
labour market	imakethe kwezomsebenzi
lack of energy	ukungabi namandla
land ownership	ubunikazi benarha
land reform	ukubuyekezwa kwemithetho yenarha
land restitution	ukubuyiselwa kwenarha kubanikazi
land rights	amalungelo wenarha
language policy	umgomo welimi
language practice	ukuphrakthisa ilimi
language rights	amalungelo welimi
law enforcement	ukugandelelwa komthetho
lay a charge	ukubika umlando
leader of the opposition	umdosiphambili wesiqhema esiphikisako
learning process	ikambiso yokufunda
least of all	okungakaqakatheki
legacy of apartheid	umthetho webandlululo
legal deposit library	ibulungelo leencwadi lokudibhozida elisemthethweni
legislative authority	igunya lomthetho
legislative function	umsebenzi womthetho
legislative power	amandla womthetho
legislative powers	amandla womthetho
legislative process	ikambiso yomthetho
level of government	izinga lombuso
level of service	amazinga wokuthuthukisa
levels of development	amarhelo wamalungelo
liberation movement	ijima lekululeko
liberation struggle	ikululeko yomzabalazo
limited access	amandla amancani
lingua franca	ilimi okuvunyelenwe ngalo ukobana libe ngelisetjenziswako
list of members	inengi lamavowudu
local government	umbuso wendawo
local government level	izinga lombuso wendawo
local government sector	iphiko lombuso wendawo
local municipality	umasipala wendawo
local sphere of government	umkhakha wombuso wendawo
mainstream economy	umnotho wabantu boke
majority of votes	ukwenza ikambebayibuza
majority party	ihlangano yenengi
make a mark	ukwenza isitatimende
make a statement	ukwenza umzamo
make an effort	ukwenza umzamo
management review	ibuyekezo lokuphatha
manner of speaking	indlela yokukhuluma
marine living resources	imithombo ehlala emanzini
market economy	imaraga yomnotho
mass mobilisation	ikambiso efaka boke abantu
master of ceremonies	umphathiintambo/ umphathihlelo
matter of public importance	indaba eqakathekileko emphakathini
matter of urgency	okurhabekileko
means of communication	indlela yokuthintana
means of transport	iinkhwelo ezikhwelwako
member of parliament	ilunga lepalamende
member of the council	ilunga lomkhandlu
member states of the UN	ilunga lombuso we-UN
memorandum of understanding	ikontraga yokuzwisisana
metropolitan area	indawo elidorobho
middle class	abantu abaphakathi nendawo ngokomnotho
minority domination	ukubakhona kwenani elincani labantu
minority party	ihlangano encani
mode of operation	indlela yokusebenza
moment in time	ongeze wakulibala
money laundering	ukubolekisa ngemali ukuze uthole inzuzo enengi
months of the year	iinyanga zonyaka
mortality rate	inani labahlongakeleko
mother tongue	ilimi  likamma
multicultural society	umphakathi onamasiko ahlukahlukeneko
mutual understanding	ukuzwisisana
mutually exclusive	ukungafani kwezinto ezimbili
national affairs	iindaba zenarha
national anthem	ingoma yesitjhaba
national asset	umnotho wenarha
national budget	ibhajedi yenarha
national coat of arms	isiphandla
national conference	ikhonferensi yenarha
national department	umnyango wenarha
national development	ituthuko yenarha
national economy	umnotho wenarha
national education	ifundo yenarha
national executive	isigungu senarha
national executive authority	igunya lesigungu senarha
national executive committee	ikomidi yesigungu senarha
national flag	iflarha yenarha
national government	umbuso wenarha
national identity	ubunjalo benarha
national interest	inzuzo yenarha
national leader	umdosiphambili wenarha
national level	izinga lenarha
national level of government	izinga lombuso wenarha
national policy	umgomo wenarha
national pride	ukuzikhakhazisa kwenarha
national reconciliation	ukubuyisana ngokwenarha
national security	ivikeleko lenarha
national sphere of government	umkhakha wombuso wenarha
national strategy	iqhinga lenarha
national symbols	amatshwayo wenarha
national unity	ibumbano lenarha
natural justice	ubulungiswa bemvelo
natural resources	imithombo yemvelo
need to know	ngifuna ukwazi
new dispensation	isikhathi sombuso omutjha
not later than	kungakapheli isikhathi esithileko
number of children	inani labentwana
number of deaths	inani labahlongakeleko
oath of office	isifungo se-ofisini
of paramount importance	okuqakatheke khulu
office bearer	onesikhundla e-ofisini
official language	ilimi elisemthethweni
official residence	ukuhlala ngokusemthethweni
on the defence	ukuzivikela
on the market	emakethe
on the run	ukubaleka
on the second	ukuyelela
on the wing	nawuphaphako
on top of	phezu kwa
open society	umphakathi onganafihlo
open source software	ingaphakathimtjhiningqondo elivulekileko
opening address	Ikulumo yokuvula
order of merit	ukulandelana ngokuqakatheka kwezinto
order of preference	indlela okwenyulwa ngakho
order of the day	ikambiso yamhlokho
ordinary session	isetjheni evamileko
organs of state	izakhiwo zombuso
out of control	ukungalawuleki
out of date	ukuphelelwa sikhathi
out of print	ukungasagadangiswa
out of service	ukungasebenzi
out of stock	ukuphela
outbreak of war	ukusuka kwepi
ownership of land	ubunikazi benarha
paradigm shift	itjhuguluko lamsinya
parliament is in session	ukuhlala kwepalamende
parliamentary committee	ikomidi yepalamende
parliamentary correspondent	iincwadi eziya epalamende
parliamentary democracy	ipalamende yentando yenengi
parliamentary process	ikambiso yepalamende
participate in the debate	ukuzibandakanya kukulumo-pendulwano
participatory democracy	ukubandakanyeka kuntando yenengi
party discipline	ukunqotjhiswa kwehlangano
party system	ikambiso
pass laws	ukuphumelelisa imithetho
pave the way	ukuphendla indlela
peaceful coexistence	iphaliswano ngaphandle kwepi
peaceful demonstration	ukutjengisa ngendlela enokuthula
peaceful transition	ukutjhuguluka ngokuthula
per capita	ihloko yomuntu
performing arts council	umkhandlu owenza zobukghwari
permanent residence permit	imvumo yokuhlalela safuthi
pillar of strength	into umuntu ayama kiyo/ umuntu okusizako
pilot project	iphrojekthi esalingwako
place of safety	indawo yevikeleko
platinum group metals	isiqhema seensimbi zeplathinamu
play the lead	ukuba mdosiphambili
playing field	itatawu lokudlala
point of contact	umjameli
point of view	umbono
police service	umsebenzi wamapholisa
policy development	ukuthuthukisa umgomo
policy environment	umgomo webhoduluko
policy formulation	ukubumba umgomo
policy framework	itlhatlha lomgomo
policy implementation	ukuphumelelisa ukwenziwa komgomo
policy making	ukwenza umgomo
policy statement	umgomo wesitatimende
political context	ngokwendlela yepolotiki
political control	ilawulo lepolotiki
political development	ukuthuthukisa ipolotiki
political dispensation	ikambiso kwezepolotiki
political environment	ibhoduluko lezepolotiki
political instability	ukunganzinzi ngokwepolotiki
political leadership	ubudosiphambili kwezepolotiki
political order	umlayo wepolotiki
political party	ihlangano yepolotiki
political process	ikambiso yepolotiki
political rights	amalungelo kwezepolotiki
political system	irherho lezepolotiki
political tradition	ikolelo kwezepolotiki
poor living conditions	ukutlhaga
poorest of the poor	ukutlhaga ngendlela erarako
popular culture	isiko elidumileko
popular participation	ukuzibandakanya ngendlela edumileko
popular sovereignty	ukuduma kwenarha enomazibuse
population register	irejista yesiqhema somhlobo ofanako ohlala kileyo ndawo
population size	ubukhulu besiqhema somhlobo ohlala kileyo ndawo
portfolio committee	ikomidi yomsebenzi othileko
powers and functions	amandla nemisebenzi
powers that be	amandla akhona
practical reality	okwenzeka kwamambala
praise singer	umvumi oyimbongi
precincts of parliament	izakhiwo zepalamende
presiding officer	isiphathiswa esingameleko
press freedom	ikululeko yeembikiindaba
primary health care	itjhejo lezamaphilo
private sector	iphiko langasese
professional ethics	imikghwa emihle yokuziphatha
professional organisation	ihlangano esebenza kuhle
prophets of doom	umuntu olindele bona kwenzeke izinto ezimbi ngaso soke isikhathi
proportional representation	ukujameleka ngokwamavowudu
provincial administration	ukuphathwa kweminyango yesifunda
provincial budget	ibhajedi yesifunda
provincial government	umbuso wesifunda
provincial legislature	isibethamthetho sesifunda
provincial level	izinga lesifunda
provincial sphere of government	umkhakha wombuso wesifunda
provision of services	ukunikelwa kwemisebenzi
public administration	ukuphathwa komphakathi
public domain	indawo yomphakathi
public expenditure	iindleko zomphakathi
public funds	iimali zomphakathi
public health	amaphilo womphakathi
public hearing	ukulalelwa kwemibono yomphakathi
public interest	ukuthanda komphakathi
public meeting	umhlangano womphakathi
public money	imali yomphakathi
public office	i-ofisi yomphakathi
public opinion	umbono womphakathi
public participation	ukubandakanywa komphakathi
public policy	umgomo womphakathi
public relations officer	isiphathiswa setjhebiswano lomphakathi
public sector	iphiko lomphakathi
public service	umsebenzi wombuso
public services	imisebenzi yombuso
public transport system	ikambiso yeenthuthi zomphakathi
public works	imisebenzi yomphakathi
public works programme	ihlelo lemisebenzi yomphakathi
pumped storage scheme	indlela yokudlulisela amanzi kwezinye iindawo
put a motion	ukubeka umbono
put in writing	ukutlola lokho okutjhoko phasi
quality of life	izinga lepilo
question paper	iphepha lesihlahlubo
quota system	ikambiso elawulwa mthetho
race relations	itjhebiswano hlangana nobuhlanga
racial equality	ukulingana ngobuhlanga
racial segregation	ukuhlukana ngobuhlanga
rainbow nation	isitjhaba esihlukahlukeneko
range of vision	ukuhluka kwemibono
rapid transit system	ikambiso yeenthuthi
redistribution of land	ukwabiwa kwenarha
reference book	incwadi kamazisi
regional integration	ukuhlangana ngokweeyingi
register of members	irejistara yamalunga
removal from office	ukususwa e-ofisini
remuneration package	umrholo ofaka namarhubhelo
required to carry	okutlhoga bona kuthwalwe
reside in	ukuhlala e
residence permit	imvumo yokuhlala
resistance movement	umsikinyeko womphakathi
resistance to change	ukungafuni amatjhuguluko
resolution of conflict	ukurarulula irarano
resource base	isisekelo somthombo
responsible for	umsebenzi wami ngilokhu
restitution of land	ukubuyiselwa kwenarha ebantwini
restitution of land rights	ukubuyiselwa kwamalungelo weenarha ebantwini
return on investment	amakonyana atholaka ngemva kokusisa imali
right of access	ilungelo lokungena
right to assemble	ilungelo lokubhenyoga
right to human dignity	ilungelo lokubhenyoga
right to life	ilungelo lokuphila
right to privacy	ilungelo lokubhenyoga
right to strike	ilungelo lokubhenyoga
right to vote	ilungelo lokuvowuda
rights and privileges	amalungelo namalungelo akhethekileko
rise and fall	ukuphakama nokufadalala
rite of passage	umnyanya otjengisa ukuphuma kwesinye isigaba uye kwesinye
road network	ithungelelwano lendlela
road show	ukwenza umbukiso
rule of law	ukusebenza komthetho
rules and orders	imithetho nemilayo
rules of debate	imithetho yobulungiswa bemvelo
rules of natural justice	imithetho yekambiso
rules of procedure	umsebenzi webulungelo leencwadi lesikolo
ruling party	isiqhema esibusako
rural development	ukuthuthukisa iindawo zemakhaya
school library service	ihlelo lokudla okudliwa bafundi esikolweni
school nutrition programme	isayensi nethekhnoloji
science and technology	ukusetjha nokuphulukisa
search and rescue	indawo yombuso
seat of government	indawo yombuso
security clearance	ukususwa kwevikeleko
security forces	isiqhema sangasese sevikeleko
sending and receiving	ukuthumela nokwamukela
sense of responsibility	ukuziphendulela
sense of touch	ukuthinta
separate but equal	okuhlukeneko kodwana okulinganako
separate development	ituthuko ehlukeneko
separation of powers	ukuhlukaniswa kwamandla
services industry	ibubulo lemisebenzi
services rendered	imisebenzi eyenziweko
set in motion	ukukhamba
shortage of skills	ukutlhogeka kwamakghono
sitting of parliament	ukuhlala kwepalamende
small town	idorobho  elincani
social benefits	iinzuzo zomphakathi
social capital	ithungelelwano letjhebiswano elihlangana nabantu abahlala nabasebenza emphakathini othileko
social change	itjhuguluko lomphakathi
social contract	ikontraga yomphakathi
social control	ilawulo lomphakathi
social development	ukuthuthukiswa komphakathi
social interaction	ukuhlangana komphakathi
social justice	ubulungiswa emphakathini
social movement	umsikinyeko womphakathi
social security	ivikeleko lomphakathi
social services	imisebenzi yomphakathi
social system	ikambiso yomphakathi
social upliftment	ukukhuphula umphakathi
social welfare	ihlalakuhle yomphakathi
socio-economic development	ituthuko yezehlalakuhle nezomnotho
source of income	umrholo
source of information	umthombo welwazi
source of water	umthombo wamanzi
sovereign democratic state	umbuso kamazibuse wentando yenengi
sovereign state	umbuso kamazibuse
sphere of government	umkhakha wombuso
standard of living	indlela yokuphila
state assets	ipahla yombuso
state emblem	itshwayo eliyibheji yombuso
state institutions	iinhlangano zombuso
state money	imali yombuso
state of emergency	umthetho wobujamo oburhabako
state of mind	ubujamo bomkhumbulo
state of the nation address	ikulumo eyethulwa mbuso enarheni
state revenue	irevenyu yombuso
status of women	ubujamo babantu bengubo
status quo	indlela yekambiso
statute book	incwadi yomthetho wepalamende
strategic management	iqhinga lokuphatha
structural violence	ipi ehlelekileko
struggle for liberation	umzabalazo wekululeko
subject for discussion	okuzokukhulunyelwa phezu kwakho
subject to the provisions of	kulawulwe kukuba khona kokuthileko
substantive motion	umbono osekelweko
supply and demand	ipahla efunekako  nalokho okufunekako
supreme law	umthetho ophezulu
sustainable development	ukuthuthuka kuhle ngendlela eneragelo phambili
sustainable economic growth	ukukhula kuhle ngendlela eneragelo phambili komnotho
sworn in	ukufungiswa esikhundleni
system of government	ikambiso yombuso
systems approach	ikambiso yeendlela
table of contents	okumunyethweko
take account of	ukulalela omunye umuntu
take advantage of	ukuthatha isiqunto
take an oath	ukufunga
take cognisance of	ukutjheja okuthileko
take cognizance of	ukutjheja okuthileko
take into consideration	ukuyelela okuthileko
take off	susa
task team	isiqhema esisebenzako
tax revenue	irevenyu yomthelo
technical services department	umnyango wemisebenzi ethekhnikhali
term budget	ibhajedi yethemu
term of office	isikhathi sokuba se-ofisini
terms and conditions	imibandela nemikhawulo
terms of reference	imibandela yokusebenza
terms of trade	imibandela yebubulo
the Cold War	ipi yemibono
the East	iPumalanga
the West	iTjingalanga
the common good	okuvamileko okuhle
the disadvantaged	abadinywe amathuba
the historically disadvantaged	abadinywe amathuba ngaphambilini
the masses	ubunengi
the powers that be	amandla akhona
the right	ilungelo
the services	imisebenzi
the struggle	umzabalazo
the voiceless	abanganalizwi
thousand and one	ikulungwana nakunye
time of arrival	isikhathi sokufika
time of departure	isikhathi sokukhamba
title deed	ithayitlela
to and fro	ukuya phambili nemva
to bear fruit	ukukhiqiza iinthelo
to the effect that	bekufike lapha
top management	umphathi ophezulu
top secret	ifihlo ephezelu
total onslaught	ukuthelwa ngepi
track record	indlela okusetjenzwe ngayo
trade relations	amatjhebiswano kwezerhwebo
trade union	inyonyana
trading partner	umlingani
traditional leadership	ubudosiphambili kwezendabuko
traffic control	ukulawula ithrefigi
training facilities	iinkghonakalisi/iinsetjenziswa zokubandula
training institution	ihlangano yokubandula
transition to democracy	ukutjhuguluka kuyiwe embusweni wentando yenengi
translation of the Bible	ukutjhugululwa kweBhayibheli
tree of knowledge	umuthi welwazi
tree of life	umuthi wepilo
umbrella body	kufakwe koke hlangana
unanimous concurrence	isehlakalo esingathinti boke abantu
under the auspices of	ngaphasi kwelawulo le
under the authority of	ngaphasi kwela
unemployment rate	inani lokutlhogeka kwemisebenzi
unfair discrimination	ukubandlululwa
unique people	umhlobo womuntu
united nations organisation	Ihlangano i-united nations organisation
university of technology	iyunivesithi yethekhnoloji
unreserved postal service	imisebenzi yeposo engakabanjiswa
up to date	ukukhambisana nesikhathi
up to standard	ukuba sebujameni obufaneleko
upper middle class	abantu abasezingeni eliphezudlwana ngokomnotho
urban area	indawo yedorobheni
urban centre	isentha yedorobho
urban development	ituthuko yendawo elidorobho
urban renewal	Ukuvuselela iindawo zemadorobheni
value system	ikambiso yobungako
violation of human rights	ukwephula amalungelo wobuntu
violence against children	ukuhlukunyezwa kwabantwana
violence against women	ukuhlukunyezwa kwabomma
voice of the people	ilizwi labantu
vote in favour	ukuvowudela umuntu othileko
vote of thanks	amezwi wokuthokoza
waste management	ukuphatha kumbi
ways and means	iindlela  kanye
welfare state	ihlalakuhle yombuso
winds of change	amatjhuguluko
winter rainfall region	isifunda sezulu lebusika
with effect from	ukusukela ngomhlaka
with the sun	kanye nelanga
with the wind	kanye nommoya
within a radius of	ukuba hlangana nendawo
within the limits	hlangana nemikhawulo
word of welcome	igama lokwamukela
working group	isiqhema esisebenzako
world community	umphakathi wephasi mazombe
you are here	sewufikile