APRIL	MMESA; 
Africa	Aforika; 
Africa's	ya Afrika; 
African-American	Moamerika wa Afrika; 
Africans	Maafrika; 
Afrikaans	Seaforikanse; 
America	Amerika; 
American	Moamerika; 
April	Mmesa; 
Asian	Moashia; 
Audios	Tse utlwahalang; 
Auditor	Mohlahlobi wa dibuka; 
Auditor-General	Mohlakisi e Moholo; 
Bay	Kou; 
Beginner's	ya maithutwane; 
Boer	Leburu;  Rapolasi; 
Britain	Borithane; 
British	Ya Borithani; 
CEOs	Baofisiri ba baholo ba phethahatso ; 
Chairman	Modulasetulo; 
Christian	Mokreste; 
Christianity	Bokreste; 
Clerks	Ditlelereke; 
Commissioner	mmusisi; Komishenara; 
Confederations	ditlamahano; 
DECEMBER	TSHITWE; 
December	Tshitwe; 
Deregister	Tlhakolo ya ngodiso; 
Dome	Kgidikwenyane; 
Dominican	ya Dominiki; 
Dr	ngaka (ngk); 
Dutch	Fora; 
English	Senyesemane; 
Excellency	boitsebelo;  bohlwahlwa;  Boqhetseke; 
FEBRUARY	Tlhakola; 
FRIDAY	Labohlano; 
February	Hlakola; 
Federal	Bofederale; 
Filter	sefe; 
Fort	setshabelo; 
French	ya For a; Sefora; 
Friday	Labohlano; 
Fridays	Labohlano; 
Gazette	 Lesedinyana la mmuso; Gazette; 
German	Jeremane; 
Germany	Jeremane; 
Glossary	Glosari;  Tlelosari; tlotlontswe; 
God	Modimo; 
Guardian	Mohlokomedi; 
HIV-positive	na le tshwaetso ya HIV; 
Handbook	bukana; 
I'm	Ke; 
Indian	Moindia; 
Infecting	tshwaetsang; 
Interjections	malahlelwa; 
Islam	Moiselamo; 
Islamic	Sesolomane; 
Italy	Itali; 
JANUARY	Pherekgong; 
JULY	PHUPU; 
JUNE	PHUPJANE; 
January	Pherekgong; 
Jewish	ya Majode; Sejode; 
Jonathan	Jonathane; 
Jordan	Jorotane; 
Joseph	Joseph (Josefa); 
June	Phupjane; 
Keyword	lentswe la sehlooho; 
KwaZulu-Natal	KwaZulu-Natala; 
LinkedIn	hoketswe; 
MONDAY	MANTAHA; 
MR	Mohl.; 
Madam	Mofumahadi; 
Mama	Mme; 
Mandela's	ya Mandela; 
Mayor	Majoro; 
Meanwhile	 ka nako eo; kgabareng; 
Methodist	Wesele; 
Monday	Mantaha; 
Moses	Moshe; 
Mourns	 Hlonama; llela; 
Mozambique	Mozambiki; 
Mr	Mohl.; 
Mrs	Mafum.; 
NB	Hlokomela; 
NOVEMBER	PUDUNGWANA; 
Natal	Natala; 
Nigerian	Moahi wa Nigeria; 
November	Pudungwana; 
OCTOBER	MPHALANE; 
October	Mphalane; 
Offender's	ya motshwaruwa;  Ya motlodi wa molao; 
Olympic	Olimpiki; 
Olympics	Diolimpiki; 
Parliament's	ya palamente; 
Postpones	dikopo tsa phetolo ya letsatsi; 
Presidency	Ofisi ya Presidente; 
President's	ya Presidente; 
Prince	Kgosana; 
Protector	Motshireletsi; 
RSVP	Beheletsa (RSVP); 
Registrar	Mongodisi; 
Rejoice	Thabo; 
Russia	Rashea; 
Russian	Morashea; 
SA	SA (Afrika Borwa); 
SEPTEMBER	LWETSE; 
Saturday	Moqebelo; 
Secretariat	Bongodi; 
Secretaries	Bangodi; 
Secretaries-General	Bangodi-kakaretso; 
Self-Governance	Mmuso o ipusang; 
September	Loetse; 
Skip	Tlola; 
Sunday	Sontaha; 
Surname	Sefane; 
Switchboard	Boto ya dikgokahanyo;  bolaoding ba mehala; 
TUESDAY	LABOBEDI; 
TV	Thelevishene; 
Thursday	Labone; 
Tuesday	Labobedi; 
Unsubscribe	ho se ingodisetse; 
WEDNESDAY	LABORARO; 
Williams	Bo-William; 
Xhosa	 Sexhoza; Isi-Xhosa; 
Zimbabwean	Moahi wa Zimbabwe; 
Zulu	Mozulu; 
ability	bokgoni; 
able	kgona; 
about	 malebana le; ka;  mabapi le; 
above	ka hodima; 
above-mentioned	tsebisitsweng;  tsebahaditsweng;  boletsweng ka hodimo; 
abroad	mose; 
absence	bosiyo; 
abuse	 -sebedisa hampe;  ho hlekefetsa; tlhekefetso; 
abused	 -sebedisa hampe;  ho hlekefetsa; tlhekefetso;  ho sebedisa hampe; 
academia	thuto;  borutehi; akhademiya; 
academic	borutehi;  ya thuto; 
academics	 tsa thuto; barutehi; 
academies	 diakhademi; tsa borutehi; 
academy	akhademi;  tsa borutehi; 
accelerate	akofisa; 
accelerated	akofisitse; 
accelerating	 akofisang; akofisa; 
acceleration	potlakiso; 
accept	 -amohela; amohela; 
acceptable	amoheleha; 
acceptance	 kamohelo;  kananelo; tumello; 
accepted	amohetse; 
accepting	amohelang; 
access	fihlella; 
accessed	fihlella; phihlello; 
accessibility	phihlello; katleho; 
accessible	fihlelleha; 
accession	phihlello; katleho; 
accident	kotsi; 
accidents	kotsi; 
acclaim	ho ipelaetsa;  ho qosa; 
acclaimed	ipelaeditse; qositse; 
accommodate	amohela;  bopella;  akaretsa;  kenyeletsa; 
accommodated	 amohetswe; bopeletswe; kenyeleditswe;  akareditswe; 
accommodation	bodulo; 
accompanied	bile teng; tsheheditse;  feleheditse; 
accompany	 -ba teng; -tshehetsa;  ho felehetsa; 
accomplish	phetha; 
accomplished	phethile;  fihleletse; 
accord	tumellano;  selekane;  setlamo; 
accordance	tumellano; 
accorded	 entse selekane;  entse setlamo; dumellane; 
according	ho ya ka; 
accordingly	ka ho ya ka; 
account	 tshupaletlotlo;  tshupamolato; akhaonte; 
accountability	boikarabelo; 
accountable	-ikarabelang; 
accountant	akhaontente;  raditjhelete; 
accountants	akhaontente;  raditjhelete; 
accounted	 tshupaletlotlo;  tshupamolato; akhaonte;  akhaonto; 
accounting	 tshebetso ya tsa ditjhelete; tshupaletlotlo; 
accounts	ditshupaletlotlo;  ditshupamolato; diakhaonto; 
accreditation	 tumello;  kamohelo;  kananelo; tokelo; 
accredited	 ananetswe; amohetswe;  filwe tokelo;  dumelletswe; 
accruals	dikeketso; 
accrue	-sebediseha; 
accrued	-sebediseha; 
accumulate	bokella; 
accumulated	bokella; 
accuracy	 ho nepahala.;  nepo; nepahalo; 
accurate	 nepahetse; nepahetseng; 
accused	moqosuwa; 
achieve	fihlella;  -atleha; 
achieved	atlehile;  fihleletse; 
achievement	-katleho; 
achievements	 diphihlello; dikatleho; 
achieving	 atlehang; fihlellang; 
acknowledge	dumela; 
acknowledged	 dumetse; dumela; 
acknowledges	 dumetse; dumela; 
acquire	fumana;  -fumana; 
acquired	fumane; 
acquisition	phihlello; theko;  phumano; 
act	molao;  etsisa;  -bapala; 
acted	etsisitse; molao;  entse;  bapetse; 
acting	-bapala; 
action	diketso; 
actions	diketso; 
active	matjato; 
actively	 ka matjato; ka mahlahahlaha; ka mafolofolo; 
activism	 matjato; mafolofolo; mahlahahlaha; 
activist	moitseki; 
activists	baitseki; 
activities	mesebetsi; 
activity	mosebetsi; 
actor	sebapadi; 
actors	dibapadi; 
actress	sebapadi; 
acts	 etsisa;  -bapala; melao;  bapala;  diketso; 
actually	 ruri;  hantlentle; bonnete; 
ad-hoc	nakwana; mokobobo; 
adaptation	ho tlwaela; 
add	eketsa; 
added	ekeditse;  kopantse; 
adding	kopanyang;  eketsang; 
additional	- ekeditsweng; 
address	aterese; 
addressed	aterese; 
addresses	diaterese; 
addressing	aterese; 
adds	eketsa; kopanya; 
adequately	 ka hohle;  ka ho phethahala; ka botlalo; 
adhere	-mamela ditaelo; 
adherence	ho mamela ditaelo; 
adjudication	tlhahlobo;  tekolo; 
adjustment	ho itlwaetsa; 
adjustments	ho itlwaetsa; 
administer	tsamaisa;  ho laola; 
administered	tsamaisa;  ho laola; 
administering	 laolang; tsamaisa;  ho laola; 
administration	 taolo; tsamaiso; 
administrations	 taolo; tsamaiso; 
administrative	 ya tsamaiso;  ya taolo; ya bookamedi; 
administrator	motsamaisi; 
administrators	batsamaisi;  balaodi; 
admissible	amohelehile; laoleha; 
admission	 kamohelo; tumello; 
admit	ho dumella; 
admitted	ho dumella; 
adopt	ho inkela; amohela;  akaretsa;  kenyeletsa; 
adopted	kenyeleditse;  amohetse;  akareditse;  inketse; 
adopting	 kenyeletsang;  ho inkela;  amohelang; akaretsang; 
adoption	kakaretso;  kenyeletso; kamohelo; 
adoptive	ya kenyeletso; ya kakaretso;  ya kamohelo; 
adopts	amohela;  ho inkela;  akaretsa;  kenyeletsa; 
adult	 motho e moholo; moholo; 
adults	baholo;  batho ba baholo; 
advance	 -tswella; tswelopele; 
advancement	 katleho; phihlello; tswelopele; 
advances	-tswella;  ditswelopele; 
advancing	tswela pele;  -tswella; 
advantage	molemo; 
advantages	molemo; 
advent	tswelopele; 
adverse	ferekane; 
adversely	 ka pherekano; hampe; 
adversity	bothata;  moferefere; 
advertise	bapatsa;  -bapatsa; 
advertised	bapaditse; 
advertisement	papatso; 
advertising	ho bapatsa; 
advice	keletso; 
advise	 hlalefisa; fahlolla;  eletsa; eletsa; 
advised	 hlalefisitse;  eleditse; fahlolotse; eleditse; 
adviser	moeletsi;  moeletsi; mofahlolli; 
advisers	 baeletsi;  bafahlolli; baeletsi; bahlalefisi; 
advisor	moeletsi;  moeletsi; mofahlolli; 
advisors	 baeletsi; Bahlalefisi;  bafahlolli; baeletsi; 
advocacy	thuto; 
advocate	 buella; mmuelli; 
advocates	 buella; babuelli; 
affected	-ameha; 
affecting	amang; 
affects	ama; 
affidavit	boikano; 
affirm	dumela; 
affirmation	tiisetso; 
affirming	dumelang; 
afford	kgona; 
affordable	kgoneha; 
afforded	kgonne; 
aforementioned	boletsweng pele; 
aforesaid	boletsweng pele; 
after	ka mora; 
afternoon	thapama; 
again	hape; 
against	kgahlano; 
age	dilemo;  ho hola;  dilemo tsa kgolo; 
aged	hodile;  tsofetse; 
agencies	boemedi;  kemedi; 
agency	kgwebo;  kemedi;  boemedi; 
agenda	ajenda; 
agent	sefetodi; 
agents	difetodi;  bakgothaletsi; 
ages	 dilemo; dilemo;  ho hola; 
ago	kgale; 
agreement	tumellano; 
agreements	ditumellano; 
agricultural	temothuo; ya temo; 
agriculture	 temothuo; temo; 
ahead	ka pele; 
aid	 thuso; thusa; 
aids	thusa;  dithuso; 
aim	 tobisa;  -korola; maikemisetso; 
aimed	 tobisa;  korola; maikemisetso;  ikemiseditse; 
aims	 tobisa;  -korola; maikemisetso; 
air	sebakeng;  moya;  ho aneha; 
aircraft	sefofane; 
airport	boemafofane;  difofaneng; 
airports	boemafofane;  difofaneng; 
albeit	leha; 
alcohol	tahi; 
alert	 -fadimeha; ho phaphama; 
alia	hara tse ding; 
align	tsepamisa; 
aligned	tsepamisa; 
alignment	ho tsepamisa; 
alike	ka ho tshwana; 
all	kaofela; 
allegation	monyenyetsi;  tshebo; 
allegations	menyenyetsi;  ditshebo; 
allegedly	seba;  etsa monyenyetsi; 
alleviate	 fedisa;  theola; fokotsa; 
alleviation	phediso;  phokotso;  theolo; 
alliance	mahatammoho;  boipapiso; 
allocate	aba;  -aba; 
allocated	abile;  -aba; 
allocation	kabo; 
allocations	dikabo; 
allow	 dumella; lokolla; dumela;  amohela; 
allowance	setlatsamoputso; 
allowances	setlatsamoputso; 
allowed	 dumetse; amohetse;  dumeletse;  lokolotse; 
allowing	 lokollang; amohelang;  dumelang; 
allows	 dumella; lokolla; dumela;  amohela; 
almost	ekaba;  haufi le; 
alone	 o mong; o nnosi; 
along	mabapa;  haufi le; 
alongside	bapana le; mabapa le; 
already	ho se ho etsahetse; 
also	hape; 
alter	fetola; 
alternate	fapanyetsana; 
alternative	fapaneng; 
although	leha; 
always	kamehla; 
am	hoseng (hs); 
ambassador	lenqosa; 
ambassadors	manqosa; 
ambient	maikutlo; 
ambit	lehafi; 
amend	fetola; 
amended	fetotse; 
amending	fetolang; 
amendment	 phetolo; tokiso; 
amendments	ditokiso;  diphetolo; 
amends	fetola; 
ammunition	dibetsa; 
amnesty	tshwarelo; 
among	hara tse ding; 
amongst	hara tse ding; 
amount	bokalo; 
amounted	bokalo; 
amounting	bokalo; 
amounts	bokalo; 
analogue	analoko; 
analyse	hlahlobisisa; 
analysed	hlahlobisisa; 
analysing	hlahlobisisa; 
ancestor	badimo; 
ancestors	badimo; 
ancient	 maswetso;  tsa maswetso; boholoholo; 
and	le; 
animal	 sebata; phoofolo; 
animals	 dibata; diphoofolo; 
annex	hapa; 
annexure	tlatsetso; seqhwaello;  sehokelo;  sehlomathiso;  tlhakisetso; 
anniversary	selemo; 
announce	tsebisa; 
announced	tsebisitse; 
announcement	tsebiso; 
announcements	ditsebiso; 
announces	tsebisa; 
annual	selemo le selemo; 
annually	ka selemo le selemo; 
annum	ka selemo le selemo; 
another	e nngwe; 
answer	karabo; 
answers	dikarabo; 
antenatal	 pele ho peleho; boimana; 
anthem	pina ya setjhaba; 
anti-apartheid	kgahlano le kgethollo; 
anti-corruption	 twantsho ya bobodu; thibelo ya bobodu; 
anti-pass	twantsho ya dipasa; 
anticipated	lebeletse; 
any	e nngwe le e nngwe; 
anyone	e mong le e mong; 
anything	 ntho efe kapa efe; eng kapa eng; 
apartheid	kgethollo; 
appeal	boipiletso;  ho ipiletsa; 
appealed	boipiletso;  ho ipiletsa; 
appeals	boipiletso;  ho ipiletsa; 
appear	 bonahala; hlaha; hlahella; 
appearance	tjhebahalo;  -iponahatsa; 
appeared	 bonahetse; hlahile;  hlahelletse; 
appearing	 bonahalang;  hlahellang; hlahang; 
appears	 bonahala; hlaha; hlahella; 
appellant	moipiletsi; 
appendix	lelana; 
applaud	babatsa; 
applause	ho opa matsoho; 
applicable	sebetsa; 
application	 lenaneo la khompyutha;  lenaneo la khompyuta;  kopo; tshebediso;  tshebediso {molao}; 
applications	 mananeo a khomphutha;  diphethahatso tsa molao; lenaneo la khomphutha; dikopo;  tshebediso {molao};  ditshebediso; 
applies	ho kopa; 
apply	ho kopa; 
applying	kopang; 
appointed	amohetswe; 
appointing	 ho bea; beang; 
appointments	 dikamohelo; ditlhophiso; 
appoints	ho amohela; 
appreciate	 -ananela; ananela; 
appreciated	 -ananela; ananetse; 
appreciates	 -ananela; ananela; 
appreciation	kananelo; 
approach	mokgwa wa ho; 
approached	atamela;  atametse; mokgwa wa ho; 
approaches	atamela; mokgwa wa ho; 
appropriate	tshwanela;  tshwanelang; 
appropriated	tshwanetse;  tshwanelang;  tshwanela; 
appropriately	hantle; 
appropriation	kabo; 
appropriations	dikabo; 
approval	tumello; 
approve	dumella; 
approved	dumella; 
approximately	- ka bang;  - ka ba; 
arbitration	bonamodi; 
arbitrator	monamodi; 
architect	moatjhiteke; 
architects	baatjhiteke; 
architectural	ya atjhiteke; 
architecture	thuto ya boahi; 
archival	ya polokelo; 
archives	polokelo; 
area	 erea; sebaka;  boholo ba sebaka; 
areas	dibaka;  boholo ba sebaka; 
argue	 nganga; hanana; 
argued	-pheya kgang;  nganga; hanana; 
argument	 tshetleho;  ngangisano; kgang; 
arguments	 tshetleho;  ngangisano; kgang; dingangisano; 
arise	phahama;  phaphama;  tsoha; 
arises	phahama;  phaphama; hlaphohelwa;  tsoha; 
arising	 phaphamang;  tsohang; phahamang; 
arm	letsoho; 
armed	 ikatetse;  nkile dibetsa; hlometse; 
arms	dihlomo; 
arose	 hlaphohetswe; phahame;  phaphame;  tsohile; 
around	ho potoloha; 
arrange	 hlopha; hlophisa; 
arranged	 hlopha; hlophisa; 
array	letoto; 
arrest	 -tshwara; tshwara; 
arrested	tshwere; 
arrival	ho fihla; 
arrive	fihla;  phomella; 
arrived	fihlile;  phomeletse; 
art	 bokgabo; bonono; 
artefacts	dihlahiswa tsa bonono; 
article	pehelo;  athikele; 
articles	 diathikele; dipehelo; 
articulate	hlahisa;  bua; 
articulated	hlahisitse;  buile; 
artist	seqapi; 
artistic	-kgabisang; 
artists	seqapi; dikgabisi;  dinono; 
arts	bonono; 
artwork	ditshwantsho;  botaki; 
artworks	ditshwantsho;  botaki; 
as	jwaloka; 
ascertain	netefatsa;  netefaletsa; 
aside	 ka thoko;  qatsohile; thokwana; 
ask	botsa; 
asked	botsitse; 
asking	botsa; 
asks	botsa; 
assault	ho otla;  phutuhelo; 
assembly	 lekgotla la ketsamolao;  phutheho; seboka; 
assented	dumeletswe; 
assert	 ho lokodisa; ho tiisa; 
assess	 ho hlahloba;  -lekola; lekola; 
assessed	 ho hlahloba;  -lekola; lekola; 
assesses	 ho hlahloba; lekola; 
assessing	 lekolang;  ho hlahloba; lekola; 
assessment	tekolo; 
assessments	tekolo; 
assessors	mohlahani; 
asset	letlotlo; 
assets	matlotlo; 
assign	laela; 
assigned	laetse; 
assist	thusa; 
assistance	thuso; 
assistant	 mothusi; motlatsi; 
assisted	thusitse; 
assisting	thusang; 
assists	thusa; 
associate	amanya; 
associated	amanya; 
associations	kamanyo; 
assume	 ananela; amohela; 
assumed	amohetse;  ananetse; 
assumptions	 dikgopolo; mehopolo;  menahano; 
assurance	bopaki; netafaletso;  tiiseletso; 
assure	netefatsa;  tiiseletsa;  pakela;  netefaletsa; 
assured	paketse; netefaleditse;  tiiseleditse; 
at	ho;  mane; 
athletics	 ateletiki; diatleletiki; 
atmosphere	atemosefere; 
atmospheric	 atemosefere; moya; 
attach	hokela;  amoha ka molao; 
attached	amohile ka molao; hoketse; 
attachment	poelano; kamano; 
attack	 futuhela; tlhaselo;  ka sefutho;  hlasela; 
attacks	hlasela;  futuhela;  ditlhaselo;  ka sefutho; 
attain	ho fihlella; 
attained	ho fihlella; 
attainment	phihlello; phumano;  ; 
attempt	ho leka;  boitekelo; 
attempted	ho leka;  boitekelo; 
attempts	ho leka;  boitekelo; 
attend	ho ba teng; 
attendance	boteng; 
attended	ho ba teng; 
attending	ho ba teng; 
attention	hloko; 
attitude	maikutlo;  boitshwaro; 
attitudes	maikutlo;  boitshwaro; 
attorney	mmuelli; 
attorneys	 babuelli; mmuelli; 
attract	hohela; 
attracted	hohetse; 
attribute	semelo; 
attributed	semelo; 
au	 se utlwahalang; se fihlellehang; 
auction	fantisi; 
audience	bamamedi; 
audiences	bamamedi; 
audio	kutlwahalo; 
audio-visual	- kutlo le pono; 
audit	 hlakisa; lekola;  bohlakisi; 
audited	 hlakisa; lekola;  bohlakisi; 
auditing	 hlakisa; lekola;  bohlakisi; 
auditor	molekodi;  mohlahlobi wa dibuka; 
auditor-general	Mohlahlobi-kakaretso wa dibuka; 
auditors	 bahlahlobi ba dibuka; molekodi;  mohlahlobi wa dibuka; 
audits	 hlakisa; lekola;  bohlakisi; 
august	phato; 
auspices	taolo; 
authentic	ya nnete; 
author	mongodi; 
authorisation	tumello; 
authorise	dumella; 
authorised	dumeletsweng; 
authorities	 ditsebi;  balaodi;  bolaodi; matla; 
authority	 setsebi;  molaodi;  bolaodi; matla; 
authorization	tumello; 
authorize	dumella; 
authorized	dumelletse; 
authors	bangodi; 
automated	itaolang; 
automatic	boyona; 
availability	phumaneho; 
available	fumanehang; 
average	palohare; 
aviation	tsa bofofisi; 
avoid	 qoba; thibela; 
avoidance	ho qoba; 
awaiting	emela; 
award	kgau; 
awarded	kgau; 
awarding	kgau; 
awards	 kgau; dikgau; 
aware	 -lemoha; boitemohelo; 
awareness	tlhokomediso; 
away	hole; 
babies	 masea; lesea; 
baby	lesea; 
back	 ka morao;  sekotlo; mahetla; 
backdrop	lesira; 
background	tshetleho; 
backgrounds	tshetleho; 
backlog	mosebetsi o salletseng morao; 
backlogs	mosebetsi o salletseng morao; 
bad	mpe; 
bag	mokotla; 
bail	beile; 
bake	 -baka; baka; 
baking	 -baka; bakang; 
balance	tekano;  lekalekanya;  balanse;  sekala; 
balanced	setseng; 
balances	tekano; tekatekano;  lekalekanya;  balanse;  ditekatekano;  sekala; 
ball	bolo; 
band	 bente; lebanta; 
bank	banka;  lebopo; 
banking	tshebetso ya bankeng; 
banks	 dibanka; banka;  lebopo; 
bar	bara;  baa; 
bargain	monyaolo; 
bargaining	monyaolo; 
barrier	tshitiso; 
barriers	ditshitiso; 
base	 palo ya motheo; motheo; 
based	beisi;  radiks;  palo ya motheo; motheo; 
baseline	motheo; 
basic	motheo; 
basics	metheo; 
basis	motheo; 
basket	seroto; 
battle	ntwa; 
bay	kou;  kou ya lewatle; 
be	eba; 
beach	lebopo la lewatle; 
beaches	mabopo a lewatle; 
bear	bere; 
bearer	motshwari; 
bearers	batshwari; 
bearing	bering; 
bears	 bere; dibere; 
beautiful	 tsoteha;  kgahleha; e ntle; 
beauty	botle; 
became	ho ba; 
because	hobane; 
become	ho ba; 
becomes	ho ba; 
becoming	ho ba; 
bed	bethe; 
beds	bethe; 
bee	notshi; 
been	bile; 
beer	jwala;  mothamahane;  biri; 
before	pele; 
began	qadile; 
begin	 simolla; qala; 
beginning	tshimolohong; 
begins	 simolla; qala; 
begun	 simolotse; qadile; 
behalf	lebitsong la; 
behaviour	 temalo; boitshwaro; 
behind	ka mora; 
being	ho ba; 
beings	diphedi; 
belief	kgolo/ho kgolwa; 
beliefs	ditumelo;  kgolo/ho kgolwa; 
believe	 dumela; amohela;  kgolwa; 
believed	dumetse;  kgotswe; 
believes	 dumela; amohela;  kgolwa; 
believing	dumelang; 
belong	rua; 
belonging	ho rua; 
belongs	ho rua; 
beloved	moratuwa; 
below	ka tlase; 
benchmark	molokotwane; 
beneficial	ya bohlokwa; 
benefit	 kotula ja; molemo; 
benefited	 kotula ja; molemo; 
benefits	melemo;  kotula ja; 
best	sediba; 
better	betere; 
between	dipakeng; 
beyond	ka nqane; 
bid	peheletso; 
bidders	 mmeheletsi; babelehetsi; 
bids	peheletso; belehetsa; 
biennale	dilemo tse pedi; 
big	kgolo; 
bigger	kgolo; 
biggest	kgolo; 
bilateral	ka mahlakore bobedi;  ka puisano; 
bill	 tshupamolato; sekoloto;  -romela tshupamolato; 
billion	biliyone; 
bills	 romela tshupamolato;  ditshupamolato;  ditshwantsho tsa molao;  -romela tshupamolato; dikoloto; 
bind	 phethela; tlama; 
binding	mophethelo; 
biological	ya bophelo; 
bird	nonyana; 
birds	nonyana; 
birth	 ho beleha;  peleho; tswalo; 
birthday	letsatsi la tswalo; 
black	botsho; 
blacks	botsho; 
blind	 foufala; foufatsa;  ho foufala; 
block	boloko;  leqhwa; 
blood	madi; 
blue	tala;  bolousele;  bolou; 
board	boto;  lekgotla la patlisiso; 
boards	diboto; 
boasts	ithorisa; 
bodies	 sopho e reberebe;  reberebe ya sopho; mmele; 
bodily	ya mmele; 
body	 reberebe ya sopho; mmele; 
book	buka; 
books	dibuka; 
boom	nala;  sethibelo; 
boost	phahamisa;  hodisa; 
border	 ho mena;  momeno; moedi; 
borders	 ho mena;  momeno; meedi; 
born	 hlahile; hlaha; 
borne	bere; 
borrow	kadima; 
borrowing	kadima; 
botanical	ya dimela; 
both	ka bobedi; 
bottom	 botlase; tlase;  bokatlase; 
bought	reka; 
bound	 phethela; tlama; 
boundaries	meedi; 
boundary	moedi; 
box	lebokose;  ho tebela; 
boy	moshemane; 
boys	bashemane; 
brackets	masakana; 
braille	boreile; 
branch	 aroha; lekala; 
branches	 aroha; makala; 
brand	letshwao; 
brave	ho ba sebete; 
bravery	ho ba sebete; 
breach	borokgo; 
breadth	bophara; 
breakdown	senyeha;  arola; 
breakfast	borakefese;  thahameso;  dijo tsa hoseng; 
breaking	 thuba; ho fetoha ha lentswe; 
bridge	borokgo; 
bridging	borokgo; 
brief	tsebisa; 
briefed	tsebisa; 
briefing	tsebiso; 
briefly	hakgutshwanyane; 
briefs	tsebisa; 
bring	tlisa; 
bringing	tlisang; 
brings	tlisa; 
broad	sephara; 
broad-based	bulehile;  phatlaletse; 
broadband	bulehile;  phatlaletse; 
broadcast	 hasa; kgaso; 
broadcaster	kgaso; 
broadcasters	dikgaso; 
broadcasting	bohasi; 
broaden	phatlalatsa;  hodisa; 
broadening	phatlalatsa;  hodisa; 
broader	sephara; 
broadly	ka bobatsi; 
brochure	bukana; 
brochures	dibukana; dibrotjha; 
bronze	boronse; 
brother	moreso;  moena; 
brothers	moena;  baholwane; more; 
brought	tlisitse; 
brutal	sehloho; 
brutality	sehlooho; 
budget	tekanyetso; 
budgetary	ya bajete;  ya tekanyetso; 
budgeted	 lekanyetsa; ditekanyetso;  bujete; tekanyetso; 
budgeting	 lekanyetsa; ditekanyetso;  bujete; tekanyetso; 
budgets	lekanyetsa; ditekanyetso;  ditekanyetso/dibajete; 
buffalo	nare; 
build	 ho haha; aha; 
build-up	ahilweng; 
building	moaho; 
buildings	moaho; 
built	 ho haha;  ahile; aha; 
bureau	biro; 
buried	epela; 
burning	tjhesang; 
bursaries	dibasari; 
bursary	basari; 
bury	epela; 
bus	bese; 
business	kgwebo; 
businesses	dikgwebo; 
but	empa; 
buy	reka; 
by	ka; 
cabinet	kabinete; 
calculate	sebetsa; 
calculated	sebetsa;  sebeditse; 
calculating	sebetsa;  sebetsang; 
calculation	tshebetso; 
calendar	 almanaka; khalendara; 
call	kholo; bitsa; 
called	bitsitse; 
calling	pitso; 
calls	bitsa; 
came	tlile; 
camp	kampo; 
campaign	letsholo;  thaotha; 
campaigns	matsholo;  thaotha; 
camps	kampa; dikampo;  dikampo; 
campus	khempase; 
campuses	dikhempase; 
can	 boloka kotikoting; kotikoti;  kane; 
can't	 a ke ke; nkeke; 
cancellation	 tlhakolo; phediso; 
cancer	 mofetshe; kankere; 
candidate	 mohlahlojwa; nkgetheng; 
candidates	bonkgetheng;  bahlahlobuwa; 
cannot	nkeke; 
cap	tlotlo; 
capabilities	bokgoni; 
capability	bokgoni; 
capable	kgona; 
capacities	methamo; 
capacity	mothamo; 
capacity-building	kaho ya bokgoni; 
capita	ya tjhelete; 
capital	letlotlo;  motsemoholo; 
caps	kepesi; tlotlo; 
capture	hatisa;  -hapa; 
captured	hatisa;  -hapa; 
captures	 hatisa;  -hapa; hapa; 
car	koloi; 
carbon	khabone; 
card	karete; 
cards	dikarete; 
care	tlhokomelo;  ho hlokomela; 
career	mosebetsi;  boiphediso; 
careers	mesebetsi;  boiphediso; 
careful	ka hloko; 
carefully	ka tlhokomelo; 
cargo	 morwalo wa sekepe; thoto; 
caring	tlhokomelo;  ho hlokomela; 
carpet	 mmata;  khapete; tapeiti; 
carried	nkile; 
carries	nka; 
carry	nka; 
cash	kontane; 
cast	lahla; 
catalogue	 khathaloko; khathaluku; 
catalyst	khathalisti; 
catch	tshwara; 
categories	 mokgahlelo; dihlopha; sehlopha;  mekgahlelo; 
category	 mokgahlelo; sehlopha; 
cater	 sebeletsa; hlokomela; 
catering	tlhokomelo; phomososetso; 
cattle	dikgomo; 
caucus	khokhase; 
cause	 sesosa; lebaka; 
caused	sesosa;  bakile; 
causes	 sesosa; lebaka; 
causing	 sesosa; lebaka; 
cave	lehaha; 
caves	 mahaha; lehaha; 
cease	 emisa; thibela; 
ceases	 emisa; thibela; 
celebrate	keteka;  -keteka; 
celebrated	ketekile; 
celebrates	keteka; 
celebrating	keteka;  -ketekang; 
celebration	mokete; 
celebrations	mekete; 
cell	 sele ya beteri; sele; 
cells	 sele ya beteri; sele; 
cellular	selula; 
census	 palo ya batho; palo ya setjhaba; 
censuses	palo ya batho;  palo ya setjhaba; 
cent	sente; 
centenary	ngwahaketekgolo; 
center	setsi;  kopanelong;  bohare; 
central	hare; 
centre	setsi;  kopanelong;  bohare; 
centres	 kopanelong; ditsi;  bohare; 
centuries	 lemo tse lekgolo;  palo ya lekgolo; mengwahakgolo; 
century	 lemo tse lekgolo;  palo ya lekgolo; mongwahakgolo; 
ceremonies	mokete; 
ceremony	mokete; 
certainly	ka nnete;  ka tiiso; 
certainty	bonnete; 
certificate	setifikeiti;  setefikeiti; 
certificates	disetefikeiti; disetifikeiti; 
certification	bopaki; 
cession	kemiso; 
chain	ketane;  tjheine; 
chair	setulo; 
chaired	setulo; 
chairman	modulasetulo; 
chairperson	modulasetulo; 
chairpersons	baduladitulo; 
challenge	 tsekisana;  phethetsa;  tsekisano; phephetso; 
challenged	phepetso;  tsekisane;  phephetsa;  phepheditse; phephetso; 
challenges	 tsekisana; diphepetso; ditsekisano; 
challenging	phepetso; tsekisano;  phethetsa;  phepetsang;  tsekisang; 
chamber	phaposi; 
chambers	diphaposi;  dikamore; 
champion	mmampodi; 
champions	bommampodi; 
championship	bompodi; 
championships	bompodi; 
chance	monyetla; 
change	 phetoho; fetola;  tjhentjhe; 
changed	 fetotse; thubile;  tjhentjhe; phetoho; 
changes	thuba; diphetoho;  fetola;  tjhentjhe; 
changing	thuba;  fetolang;  thuhang;  tjhentjhe; phetoho; 
channel	 tjhanele; kgannela; 
channels	 ditjhanele; kgannela;  dikanale; 
chapter	kgaolo; 
chapters	 dikgaolo; kgaolo; 
character	 semelo; mophetwa; 
characteristic	 semelo;  tshwayang; letshwao; 
characteristics	matshwao; dimelo;  tshwayang; 
characters	dimelo; baphetwa; 
charge	 qoso; ditjeho;  ho tlatsa;  ho qosa; 
charged	e tjhajilweng; 
charges	 diqoso; ditjeho;  ho tlatsa;  ho qosa; 
charter	selekane;  lengolo la tumello; 
chartered	selekane;  lengolo la tumello; 
check	tjheka; 
checked	tjheka;  tjhekile; nnetefatso; 
cheque	tjheke; 
chief	morena; 
child	ngwana; 
childhood	bongwana; 
children	bana; 
children's	bana; 
choice	kgetho; 
choices	kgetho;  dikgetho; 
choir	khwaere; 
choose	kgetha; 
choral	-khwaere; 
chose	kgetha; 
chosen	kgetha; 
chronic	nako e telele; 
church	kereke; 
churches	dikereke; 
cinema	baesekopong;  baesekopo; 
cinemas	baesekopong; dibaesekopo; 
circumstances	maemo; 
cite	ho romela samane; 
cited	 ho romela samane; rometse samane; 
cities	motse;  metsemeholo; 
citizen	moahi; 
citizenry	boahi; 
citizens	baahi; 
citizenship	boahi;  thuto ya boahi; 
city	motse;  motsemoholo; 
civic	leaho; 
civilian	moahi; 
claim	tseko;  tleleime;  tseka;  ho tseka; 
claimed	tseko;  tleleime;  tseka;  tsekile;  ho tseka; 
claims	 ditseko; ditleleime;  tseka;  ho tseka; 
clarification	 tlhalosetso; tlhakisetso; 
clarify	hlakisa; hlalosa; 
clarion	terompeta; 
clarity	 tlhalosetso; tlhakisetso; 
class	sehlopha; 
classes	dihlopha; 
classic	ya nako tsohle; 
classical	-tlelasiki; 
classics	tsa nako tsohle; 
classification	tlhophiso; 
classified	ikgethileng; 
classroom	phaposi ya borutelo; 
clause	polelwana; 
clauses	 dipolelwana; polelwana; 
cleaning	hlwekile; 
clear	hlakileng;  bonaletsang;  hlaka;  ho apoha ha lehodimo;  phumula; 
clearing	hlwekisang; 
clearly	hlakile;  ka ho hlaka; 
clerk	tlelereke; 
click	tobetsa; 
client	moreki;  ya thuswang; 
clients	bareki;  ya thuswang; 
climate	tlelaemete; 
clinic	tleleniki;  tlelenike;  tleliniki; 
clinical	ya tleliniki; 
clinics	ditleliniki; tliliniki;  tlelenike;  tleliniki;  tleleniki; 
close	 bipetsang; haufi; 
closed	kwetswe; 
closely	e haufi haholo; 
closer	 bipetsang; haufi; 
closing	 bipetsang; haufi; 
clothing	diaparo; 
club	sehlopha; 
clubs	dihlopha; 
cluster	senkgome; 
co	 kompone; kopanelo; 
co-operation	 koporasi; tshebedisano; 
co-operative	koporasi; 
co-ordinate	ho nyalanya; 
co-ordination	nyalanyo; 
co-production	tlhahisokopanelo; 
coach	 -rupela;  khoutjho; mokwetlisi;  bese ya maeto;  kariki; 
coal	 leshala; mashala; 
coast	lebopo; 
coastal	ya mabopong; 
coat	dila;  seapesa; 
code	khoutu; 
codes	khoutu;  dikhoutu; 
cohesive	e kgomarelang; 
cold	 -batang;  mohatsela;  ho a bata;  bata; sefuba; 
collaborate	kopanang; 
collaboration	 motswako; kgokahano;  Kopano; 
collaborative	 tswakaneng;  hokahaneng; kopaneng; 
collapse	 ho putlama; -putlama; 
colleagues	basebetsimmoho; 
collect	bokella;  kgobokanya;  -bokella;  bokeletsa; 
collected	bokella;  kgobokanya;  -bokella;  bokeletsa; 
collecting	 -bokellang;  bokeletsang;  kgobokanyang; bokellang; 
collection	pokello; 
collections	dipokello; 
collective	ka bongata;  ka sehlopha; 
collectively	ka bongata;  ka sehlopha; 
college	kholetjhe; 
colleges	dikholetjhe; 
colloquium	dipuisano; 
colonial	ya bokolone; 
colonies	dikolone; 
colony	kolone; 
colour	mmala; 
coloured	mmala;  entse mebala; 
colourful	mebalabala; 
colours	mebala; 
column	 kholomo;  kolomo; tshiya; 
combination	 motswapo; popo;  kopanyo; 
combined	kopantsweng; 
come	tlo; 
comedy	metlae; 
comes	o a tla; 
coming	ya tlang; 
comma	feelwane; 
command	taelo; 
commas	difeelwane; 
commemorate	-ikgopotsa; 
commemorating	-ikgopotsa; 
commemoration	sehopotso; 
commemorative	 hopolehang; ikgopotsang; 
commence	 simolla; qala; 
commenced	 simolotse; qadile; 
commencement	 tshimollo; qaleho; 
commencing	 simollang; qalang; 
commendable	 tsotehang; babatsehang;  kgahlehang; 
commensurate	lekana; 
comment	puo; 
comments	puo; 
commercial	papatso;  ya kgwebo;  tsa kgwebo; 
commission	khomishene; 
commissioned	khomishene; 
commissioners	bahlapantshi; 
commissions	dikhomishene; 
commit	 tlama; etsa; ikemisetsa; 
commits	 tlama; etsa; ikemisetsa; 
committed	entse;  tlamile;  ikemiseditse; 
committee	komiti; 
committee's	ya komiti;  ya lekgotla; 
committees	dikomiti; 
committing	 ikemisetsang; etsang;  tlamang; 
commodities	 thepa ya kgwebo; diphahlo;  phahlo; 
commodity	 thepa ya kgwebo; phahlo; 
common	ya bohle; 
commonly	tlwaelehile;  ka tlwaelo; 
communicate	-buisana; 
communicated	buisane;  -buisana; 
communication	kgokahano;  dikgokahano; 
communication-related	amana le dikgokahano; anana le dipuisano; 
communications	dipuisano; dikgokahano; 
communities	ditjhaba;  ditjhabana; 
community	 setjhabana; setjhaba; 
community-based	amana le setjhaba; 
companies	 dikhamphani; dikhampani; 
company	khamphani; 
comparability	 papiso; tshwantshiso; 
comparable	bapiseha;  tshwantsheha; 
comparative	tshwantshanyang;  bapisang; 
compare	bapisa;  ho bapisa; 
compared	 qosehile; bapisitse; ho bapisa; 
comparison	papiso; 
compassion	kutlwelobohloko; 
compelled	 tlamehile; tshwanetse; 
compelling	tlamang;  qosang; 
compensate	lefa; 
compensation	 tlhapiso; puseletso; 
compete	 ho hlodisana; -nka karolo;  -hlodisana; 
competence	 boitsebelo; bokgoni;  tsebo; bokgeleke; 
competencies	 boitsebelo; bokgoni;  tsebo; bokgeleke; 
competency	 boitsebelo; bokgoni;  tsebo; bokgeleke; 
competent	itsebela;  tseba; 
competition	tlhodisano; 
competitive	 phehisang; hlodisana; 
competitiveness	tlhodisano;  phehisano; 
compilation	pokello; 
compile	ho bokella; 
compiled	ho bokella; 
complainant	molli; 
complaint	sello; 
complaints	dillo; 
complement	ho tlatsetsa; 
complementary	emelang; 
complete	 -qeta; phethahetseng; 
completed	qetella;  qetile;  -qeta; phethahetseng; 
completely	 ka botlalo;  ka phethahalo; kaofela; qetilwe; 
completing	 qetang; qetella;  qetellang;  -qeta; phethahetseng; 
completion	qeto;  phethahalo;  phetho; 
complex	raraneng; 
complexity	tharahano; 
compliance	boikobelo;  ; boikamahanyo; 
complied	 ikobetse; ikamahantse; 
complies	 ikobela; ikamahanya; 
comply	 ikobela; ikamahanya; 
complying	 ikobelang; ikamahanyang; 
component	karolo; 
components	dikarolo; 
composed	 qapile; hlophisitse; 
composition	 boqapi; moqoqo;  popeho;  ho qapa;  qapo;  popo; 
comprehensive	 ka hohle;  ka ho phethahala; ka botlalo; 
comprehensively	 ka hohle;  ka ho phethahala; ka botlalo; 
comprise	di na le; 
comprises	e na le; 
comprising	e na le;  di na le; 
compromise	 -inehela; ho inehela; 
compromised	 -inehela; inehetse;  ho inehela; 
compulsory	 -tlamang; e tlamang; 
computer	khomphyutha; 
computers	dikhomphutha; khomphyutha; 
comrade	khomoreiti; 
comrades	makhomoreiti; 
conceive	-ima;  ho ima; 
conceived	 ho ima;  -imme; imme; 
concentrated	loileng; 
concentration	toiso; 
concept	mohopolo; 
concepts	kutlwisiso; mehopolo; 
concern	taba;  kgathatseho;  matshwenyeho;  kgwebo; 
concerned	kgathatsehile; 
concerning	amang; amanang le; 
concerns	ama;  tshwenya; kgathatsa; 
concert	konsarete; 
conciliation	poelano; 
concrete	 konkreiti; konkereiti; 
concurrence	sehong;  mahong; 
concurrent	mmoho; 
condemned	hanane;  sotse; seolotse;  nyefotse;  nyatsitse;  ahloletswe; 
condemns	 nyefola;  nyatsa;  nyedisa; hanana;  seolla; 
condition	boemo;  boemo ba bophelo; 
conditional	ka dipehelo; 
conditions	maemo; 
condolences	matshediso; 
condom	 kgohlopo; khondomo; 
condoms	dikhondomo;  kgohlopo;  dikgohlopo;  khondomo; 
conducive	 atlehisa; tshwanela;  kgothaletsa; 
conduct	 ho itshwara;  tsamaisa; boitshwaro; 
conducted	 ho itshwara;  tsamaisa; boitshwaro; ho bintsha; 
conducting	 ho itshwara;  tsamaisa; boitshwaro; ho bintsha; 
conducts	 ho itshwara;  tsamaisa; boitshwaro; ho bintsha; 
conference	khonferense; 
conferences	dikhonferense; 
confidence	tshepo;  boitshepo; 
confident	 ho itshepa; -tshepa; 
confidential	lekunutu; 
confidentiality	lekunutu; 
confirm	netefatsa; 
confirmation	netefatso;  tiiseletso; 
confirmed	dumetse;  tiisitse;  pakile; 
confirms	netefatsa; 
confiscation	kgapo; 
conflict	kgohlano; 
conflicts	dikgohlano; 
congratulate	lakaletsa mahlohonolo;  ho lebohela; 
congratulates	lakaletsa mahlohonolo;  ho lebohela; 
congratulating	lakaletsang mahlohonolo;  lebohelang; 
congratulations	ditebohelo; ditakaletso tsa mahlohonolo; 
congress	khonkerese; 
connect	hokela;  ho hokahanya; 
connected	hoketswe;  kopantswe; 
connection	kgokelo; 
conscience	letswalo; 
consciousness	ho phaphama; 
consecutive	hlahlamanang; 
consensus	tumellano; 
consent	tumello;  ho dumela; 
consequence	sephetho;  ditlamorao; 
consequences	sephetho;  ditlamorao; 
consequential	ya ditlamorao;  ya pheletso; qetello; 
consequently	 pheletsong; qetellong; 
conservation	 ho boloka; paballo; 
conserve	 ho boloka; poloko; 
consider	 -nahana; nahana; 
considerable	 tsotehang;  hlokomelehang; babatsehang; 
considerably	 ka ho tsoteha; ka ho babatseha; ka tlhokomeleho; 
consideration	lebaka; 
considerations	mabaka; 
considered	nahanne; 
considering	 -nahana; nahana; 
considers	 -nahana; nahana; 
consistently	 kamehla; kgafetsa; 
constantly	ka ho sa fetohe; 
constituency	lebatowa; 
constitute	ho hlomamisa; 
constituted	ho hlomamisa; 
constitutes	ho hlomamisa; 
constitution	molao wa motheo; 
constitutional	ka molao wa motheo; 
constitutions	molao wa motheo; 
constraint	e nang le moedi; 
constraints	tse nang le meedi; 
construction	kaho; 
constructive	 ahang;  thehang; bopang; 
construed	amohetswe;  nahannwe; 
consult	ho rerisa; 
consultant	setsebi; 
consultants	 setsebi; ditsebi; 
consultation	therisano; 
consultations	ditherisano; 
consultative	botsisisang; 
consulted	rerisitse; ho rerisa; 
consulting	ho rerisa; 
consumable	felang; 
consumables	felang; 
consumer	mosebedisi; 
consumers	basebedisi; 
consumption	tshebediso; 
contacts	dikamano; 
contain	- kentse;  - na le; 
contained	tshetse; - kentse;  - na le; 
container	setshelo; 
containers	setshelo; 
containing	tshetse;  - kentse; kentseng;  - na le; 
contains	tshetse; - kentse;  - na le; 
contemplated	 nahanne; tadimisitse; bohile; 
contemporary	-sejwalejwale; 
contempt	 nyediso; lenyatso;  kgeso; 
content	dikateng; 
contents	 mothamo; dikahare; 
context	 boemo; maikutlo;  tikoloho; 
continents	dikontinente; 
contingency	ya nakwana; 
contingent	nakwana; 
continuation	tswelopele; 
continue	tswella; 
continued	tswella; 
continues	tswella; 
continuing	tswella; 
continuity	tswelopele; 
continuously	ka ho tswela pele; 
contract	 selekane;  ho honyela; konteraka;  honyela; 
contracted	 selekane;  ho honyela; konteraka;  honyela; 
contracting	 selekane;  ho honyela; konteraka;  honyela; 
contracts	 dilekane;  ho honyela; konteraka;  honyela; 
contractual	ka boitlamo; 
contrary	kgahlano; 
contrast	phapano;  ho fapanya; 
contravenes	tlola; 
contravention	tlolo; 
contribution	phehiso; 
contributions	diphehiso; 
contributor	mophehisi; 
contributors	baphehisi; 
control	 taolo; tsamaiso;  ho tsamaisa; 
controlled	 taolo; tsamaiso;  ho tsamaisa; 
controlling	 taolo; tsamaiso;  ho tsamaisa; 
controls	ditsamaiso;  ditaolo;  ho tsamaisa; 
convene	bitsa; 
convened	bitsitse; 
convention	tlwaelo;  selekane; 
conventional	tlwaelehile;  ka tlwaelo; 
conventions	 dilekane; ditlwaelo; 
conversation	puisano; 
conversations	dipuisano; 
conversion	 tshokoloho; phetolelo; 
convert	 ho fetolela;  mosokolohi; fetola; 
converted	 ho fetolela;  mosokolohi; fetola; 
convey	tsamaisa;  fetisa; 
convict	motshwaruwa; 
convicted	motshwaruwa; 
convinced	kgotswe; 
cookie	mophehi; 
cooperative	koporasi; 
cooperatives	dikoporasi; 
coordinate	-hokanya; 
coordinated	ho nyalanya; 
coordinating	ho nyalanya; 
coordination	taolo ya kgokahano ya mesifa; 
copies	 kopitsa; khopi;  etsisa;  dikopi;  ho kopitsa; 
copy	 kopitsa; khopi;  etsisa;  kopi;  ho kopitsa; 
copyright	tumellotshebediso;  molao wa kopi; 
corner	sekgutlo;  qola; 
cornerstone	lejwe la motheo; 
corporation	koporasi; 
corporations	dikoporasi; 
corps	dijalo; 
correct	 nepahetse; nepahetseng;  ho tshwaya;  lokisa;  -nepahetse; 
correction	 ho tshwaya; tokiso; 
correctional	ya tlhabollo;  ya ntlafatso;  ya tokiso; 
corrections	 ho tshwaya;  ditokiso; tokiso; 
corrective	lokisang; 
correctly	ka nepo; 
correspondence	mangolo;  ngollano; 
corresponding	dumellanang; 
corrupt	senya; 
cost	theko; 
cost-effective	 theko e tlase; rekela; 
costs	ditheko; ho bea theko; 
could	 boloka kotikoting; kotikoti;  kane; 
council	lekgotla;  khansele; 
councillor	lekhanselara;  mokhansele; 
councillors	makhanselara; 
councils	 dikhansele; makgotla; 
counselling	 ho fumantshwa keletso; keletso ya kgothatso; 
count	bala;  ho bala; 
countdown	 metsotso ya ho qetela; temoso ya ho tswa mmileng o bulehileng; 
counter	mmadi; 
counterclaim	 kganano ya qoso; kganano ya molato; 
counterpart	molekane; 
counterparts	balekane; 
countries	naha; 
country	naha; 
country's	 ya naha; naha; 
countrywide	naha yohle; 
couple	para;  ho tshwarahanya; 
coupled	para;  ho tshwarahanya; 
coupon	khupono; 
courage	ho ba sebete; 
course	mefuta ya dijo; 
courses	mefuta ya dijo; 
court	lekgotla;  lekgotla la dinyewe; 
court's	ya lekgotla; 
courtesy	hlompho; 
courts	 makgotla a dinyewe; makgotla; 
cover	 khavara;  anela; akaretsa; 
coverage	kakaretso;  ; 
covered	akareditse;  anetse; 
covering	 seapesa;  sekwahelo; letlalo; 
covers	 khavara;  anela; akaretsa; 
covet	ho lakatsa; 
coveted	ho lakatsa; 
cradle	thari; 
craft	 tsebo ya mosebetsi wa matsoho; bobetli;  bonono ba matsoho; 
crafts	 tsebo ya mosebetsi wa matsoho; bobetli;  bonono ba matsoho; 
created	thea; 
creates	thea; 
creating	thea; 
creation	tshimoloho;  tlholeho; 
creative	-iqapetsweng; 
creativity	boiqapelo; 
creators	babopi; 
credit	mokitlane; 
credits	krediti; mokitlane; 
cricket	seqhomelankong;  krikete; 
crime	bosenyi; 
crimes	bosenyi; 
criminal	senokwane;  motlolamolao; 
criminals	 motlolamolao;  senokwane; dinokwane; 
crisis	moseneke; 
criteria	dintlhakgetho; 
criterion	ntlhakgetho; 
critical	 nyatsa; hanana; 
critically	ka ho hanana;  ka ho nyatsa; 
crop	 tjhai; dijalo;  kila; 
crops	 tjhai; dijalo;  kila; 
cross	phethiso;  sekere;  sefapano; 
cross-border	ho tshela moedi; 
crucial	ya bohlokwa;  e molemo; 
culminate	qetella; 
culmination	qetello; 
cultural	 -botjhaba; tsa setho; 
culture	 botjhaba;  setso; setho; 
cultures	 botjhaba;  setso; setho; 
cup	kopi; 
curate	okamela; 
curators	khureitha; 
currency	tjhelete; 
current	 mophula wa motlakase; mophula; 
currently	ha jwale; 
curriculum	kharikhulamo;  lenane la thuto; 
curve	mothinya; 
custodian	mohlokomedi; 
custodians	bahlokomedi; 
custody	 ho kwallwa; tlhokomelo; 
custom	 moetlo; mokgwa; 
customary	ka moetlo; 
customer	moreki; 
customers	bareki; 
customs	mekgwa;  meetlo; 
cut	 ho tswedipana; leqeba; 
cutting	lekgalo; 
cycle	saekele; 
daily	ka letsatsi le letsatsi; 
dam	 aha letamo; letamo; 
damage	 senya; tshenyo;  ho senya; 
damages	 senya; tshenyo;  ho senya; 
dance	 ho hobela; motjeko; 
dancers	batjeki; 
dances	tjeka;  ho hobela; metjeko; 
danger	kotsi; 
dangerous	-kotsi; 
dark	lefifi;  ho lefifi; 
data	data;  datha; 
database	polokelo ya dintlha; 
databases	polokelo ya dintlha; 
date	mohla; 
dated	filwe letsatsi; 
dawn	meso; 
day	letsatsi; 
days	matsatsi; 
deaf	ho ba setholo; 
dealer	morekisi; 
dealers	 barekisi; morekisi; 
dealing	tshebedisano; 
death	lefu; 
deaths	mafu; 
debate	 kgang;  ngangisano; buisana; 
debated	 kgang;  ngangisano; buisana; 
debates	 dikgang; dingangisano; buisana; 
debt	 sekoloto; molato; 
debtor	mokoloti; 
debtor's	ya monnga sekoloto; 
debts	 sekoloto; molato;  dikoloto; 
decade	mengwaha e leshome; 
decades	mengwaha e leshome; 
deceased	mofu; 
decide	ho etsa qeto; 
decided	qetile; 
decides	ho etsa qeto; 
deciding	ho etsa qeto; 
decision	qeto; 
decision-making	ho etsa qeto; 
decisions	diqeto; 
declaration	phatlalatso; 
declare	-tsebisa; 
declared	phatlaladitse; tsebahaditse; 
declares	 -tsebisa; tsebisa; 
decrease	 ho ngotla; fokotsa; 
decreased	 ho ngotla; fokotsa; 
decryption	phetolo ya thibelo;  tokollo ya sengolwa; 
dedicate	inehela;  ho nyehela; 
dedicated	inehela;  ho nyehela; 
dedication	nyehelo;  boitelo; 
deduct	 ho fokotsa; tlosa; 
deducted	 ho fokotsa; tlosa; 
deduction	phokotso;  ho tlosa; 
deductions	phokotso;  diphokotso;  ho tlosa; 
deed	tumellano; 
deeds	tumellano; 
deem	fumana e le;  nahana hore e; 
deemed	 nahanne hore e; fumane e le; 
deems	fumana e le;  nahana hore e; 
deepen	matlafatsa;  tebisa; 
deeply	ka ho teba; 
defence	tshireletso;  boinamolelo;  dibapadi tse tshireletsang; 
defend	tshireletsa;  lwanela; 
defendant	moinamoledi; 
defiance	lenyatso;  ho nyatsa; 
deficit	kgaello; 
deficits	kgaello; 
defined	ho hlalosa; 
defines	ho hlalosa; 
defining	ho hlalosa; 
definition	 tlhalosetso; tlhakisetso; 
definitions	 ditlhakisetso; ditlhalosetso; 
degree	boemo;  kgato; 
degrees	boemo;  kgato; 
delay	tiehiso; 
delayed	tiehiso; 
delays	ditiehiso; 
delegate	 morumuwa; roma; 
delegated	 morumuwa; roma; 
delegates	 roma; baromuwa; 
delegation	baemedi; 
delegations	baemedi; 
delete	phumula; 
deleted	phumula; 
deletion	phumolo;  tlhokolo; 
deliberate	buisana; 
deliberately	ka ho kopa; 
delighted	 nyakaletse; thabile; 
deliver	 ho pepisa; -tsamaisa; 
delivered	 ho pepisa; -tsamaisa; 
delivering	-tsamaisang;  ho pepisang; 
delivers	 ho pepisa;  -tsamaisa; tsamaisa; 
delivery	ho beleha; 
demand	 -batla; tlhoko; 
demands	ditlhoko;  -batla; 
democracy	demokerasi; 
democratic	-demokrasi; 
democratically	ka sedemokrasi; 
demographic	ka bodulo; 
demonstrate	 -bontsha; ho supisa; 
demonstrated	 -bontsha; ho supisa; 
demonstrates	 -bontsha; bontsha;  ho supisa; 
demonstration	 tshupiso; bontsha;  pontsho; 
denied	hanne;  -latola;  ho hana; 
dental	ya meno; 
deny	 ho hana; -latola; 
department	lefapha;  lefaphana; 
department's	ya lefapha; 
departmental	ya lefapha; 
departments	mafapha; 
depend	itshetleha;  tshepa; 
depending	 ka ho itshetleha; tshepang; 
depends	itshetleha;  tshepa; 
deploy	diploya; 
deployed	diploya; 
deployment	phetolo ya mosebetsi; 
deposit	 dipositi;  diphosithi; peeletso;  pokellano; 
deposited	 dipositi;  diphosithi; peeletso;  pokellano; dephositi; 
depository	ya poloko; 
deposits	 dipositi;  diphosithi; peeletso;  pokellano; dephositi; 
depreciation	theoho; 
depth	botebo; 
deputies	batlatsi;  bathusi; 
deputy	motlatsi; 
derive	fumana; 
derived	fumane; 
descent	hlomphehang; 
described	 ho hlalosa; hlalosa; 
desert	lehwatata;  ho ngala; 
design	 paterone;  -rala;  rala; moralo; 
designate	reha; 
designated	rehile; 
designation	maemo;  ho thonya; 
designed	 paterone;  -rala;  rala; radile; moralo; 
designer	moradi; 
designers	baradi; 
designs	 dipaterone;  -rala;  rala; moralo; 
desirable	 tsoteha;  lakatseha; babatseha; 
desire	lakatsa;  tsota;  babatsa; 
desired	lakaditse;  babaditse; tsotile; 
despite	ho sa natswe; ka ntle ho; 
destination	moo ho uwang; 
destiny	moo ho uwang; 
destroy	-senya; 
destroyed	-senya; 
destruction	tshenyo; 
detail	 ka botlalo; ntlha; 
detailed	 ka botlalo; ntlha; 
details	 ka botlalo; dintlha; 
detained	tshwerwe;  kwaletswe;  hlahletswe tjhankaneng; 
detainees	 ba ditlamong; batshwaruwa; 
detection	 ho kwallwa; ho tshwarwa; 
detention	kgoleho; 
determine	fumana; 
determines	fumana; 
determining	fumana; 
develop	hodisa;  ho hola; 
developed	hodisitse; ho tswelapele;  ho hola; 
developing	ho tswelapele; hodisa;  ho hola; 
development	kgolo;  kgodiso; 
developmental	 ya tswelopele; ya kgolo; 
developments	dikgodiso; kgolo; 
develops	ho tswelapele; hodisa;  ho hola; 
device	sesebediswa; 
devices	disebediswa; 
devolution	phetolo ya bolaodi; 
diagnosis	tlhahlobo; 
dialogue	puisano; 
dialogues	dipuisano; 
diamond	taemane; 
diamonds	ditaemane; 
diaspora	diyasephora;  diasepora; 
dictionary	dikshenare;  buka ya mantswe; 
did	entse; 
didn't	ha a etsa; 
die	ho shwa;  -shwa;  letaese; 
died	 ho shwa; shwele;  -shwa;  letaese; 
dies	ho shwa;  mataese;  -shwa;  letaese; 
differ	fapana; 
difference	phapang; 
differences	diphapano; 
differently	ka tsela e nngwe;  ka tsela e fapaneng;  ka ho fapana; 
difficult	thata; 
difficulties	mathata; 
difficulty	bothata; 
dignified	hlomphehang; 
dignitaries	 batlotlehi; bahlomphehi; 
dignity	seriti; 
dimension	boholo; 
dimensions	boholo; tekanyo ya mahlakore; 
diplomatic	diplomatiki; 
direct	tobileng; 
directed	tobileng; 
directing	tobileng; 
direction	 tshupo; tsela;  nqa;  ditaelo; 
directions	 ditshupo; nnqa;  nqa;  ditaelo; ditsela; 
directly	ka kotloloho; 
director	molaodi; 
director-general	molaodi e moholo; 
directorate	bolaodi; 
directors	balaodi; 
directory	 tatellano ya difaele; buka ya difounu; 
directs	tobileng; 
disabilities	boqhwala; 
disability	boqhwala; 
disabled	 ho holofala; holofetse; 
disadvantage	bothata; 
disadvantaged	bothata; 
disaster	koduwa;  kodua; 
disasters	 koduwa; dikoduwa;  kodua; 
discharge	 molaka;  tjhatjholla;  lero le tswang dithong tsa bong; tokoloho; 
discharged	 molaka;  tjhatjholla;  lokolotswe;  lero le tswang dithong tsa bong; tokoloho; 
disciplinary	ka kahlolo; 
discipline	kgalemo; 
disciplines	dikgalemo; 
disclaimer	 tatolo ya molato; boitshireletso; 
disclose	 tsebahatso; pepeso; 
disclosed	 pepesitse; tsebahaditse; 
disclosure	 tsebahatso; pepeso; 
discourse	dikamano;  puisano; 
discover	sibolla; 
discovered	sibolla; 
discovery	tshibollo; 
discretion	boiponelo; 
discretionary	ka boikgethelo; 
discrimination	kgethollo; 
discuss	tshohla; 
discussed	tshohla; 
discussing	tshohlang; 
discussion	moqoqo;  puisano; 
discussions	dipuisano; moqoqo; 
disease	lefu; 
diseases	 malwetse;  bolwetsi;  lefu la bolwetse; bohloko;  bolwetse; lefu; 
dismissal	teleko; 
disparities	ho hloka tekano; 
dispensation	puso; 
display	 -pepesa;  pepeso; pepesa; 
displayed	 -pepesa;  pepeso; pepesa; 
displaying	 pepeso;  -pepesang; pepesa;  pepesang; 
disposal	tahlo; 
dispose	lahla; 
disposed	lahla; 
dispute	 tsekisana; tsekisano; 
disputes	 tsekisana; tsekisano;  ditsekisano; 
disqualified	lelekilwe; 
dissatisfied	ho se kgotsofale; 
dissemination	thuto;  kabo;  tsebiso; 
dissolution	ho qhibidiha;  ho etsa qeto; 
dissolve	qhibidiha;  ho qhala;  ho qhibidiha; 
dissolved	qhibidiha;  ho qhala;  ho qhibidiha; 
distance	 bohole; sebaka; 
distant	sebakanyana; 
distinct	 ikgethile; fapane; 
distinction	phapano; qatsoho;  boikgetho; 
distinctions	phapano; qatsoho;  boikgetho; 
distinctive	 ikgethile; fapane;  qatsohile; 
distinguished	fapaneng;  qatsohileng;  kgethehileng; 
distribute	ho qhalanya; 
distributed	ho qhalanya; 
distribution	kabo; 
district	setereke; 
districts	setereke;  ditereke; 
distrust	-hloka botshepehi; 
diverse	fapaneng; 
diversion	kgeloho; 
diversity	mefuta; 
diverted	 ikgethile; fapane; 
divide	arola;  ho arola; 
divided	arola;  ho arola; 
dividend	searolwa; 
dividends	searolwa; 
division	karolo;  ho arola; 
divisions	dikarolo;  ho arola; 
divorce	tlhalano;  tlhalo; 
do	etsa; 
doctor	ngaka; 
doctorate	kgau ya bongaka; 
doctors	ngaka; 
document	 tokomane; lengolo; 
documentation	ditokomane; 
documented	 tokomane; lengolo; 
documenting	 tokomane; lengolo; 
documents	 mangolo; ditokomane; 
does	etsa; 
doesn't	ha e etse; 
doing	etsang; 
dollar	dolara; 
domestic	lehae; 
dominant	e qatsohileng; 
domination	taolo; 
don't	ha e etse; 
donation	phano; 
donations	phano;  diphano; 
done	entse; 
donor	 mofani;  moabi; mofepedi; 
donors	banyehedi; 
door	monyako; 
doors	menyako; 
double	 ho kopola; habedi; 
doubt	pelaelo;  lekgonono; 
down	fatshe;  ditshibana;  masiba a bonolo; 
downtown	seteteteng sa toropo; toropong; 
downturn	mothinyeng; 
draft	sengolwa sa pele; 
drafted	ngotse; 
drafting	ngolang; 
drama	 tshwantshiso; papadi; 
dramatic	ya botshwantshisi; 
draw	 ho ntsha tjhelete;  -rala; seha mola; 
drawing	 ho rala; moralo; 
drawn	hutswe; 
dream	toro; 
dreams	ditoro; 
drew	 ho ntsha tjhelete;  ho rala;  -rala; seha mola; maleka; 
drink	seno; 
drinking	nwa;  nwang; 
driver	mokganni; 
driver's	ya mokganni; 
drivers	bakganni; 
drop	lerothodi;  ewa; 
drug	sethethefatsi; 
drugs	dithethefatsi;  ditlhare; 
drum	moropa;  tonka; 
dry	 omileng; omme;  ho oma;  omisa;  oma; 
dual	e habedi; 
duly	 ka molao; ka tshwanelo; 
duplication	phetapheto; 
duration	nako; 
during	kgabareng;  nakong eo; 
duties	 boikarabelo;  ditshwanelo; mesebetsi; lekgetho is a wrong Sesotho word rather mesebetsi;  lekgetho; 
duty	 boikarabelo;  tshwanelo; mosebetsi;  lekgetho; 
e-mail	imeile;  posa; 
each	kang; 
earlier	pelenyana; 
earliest	esale pele ka ho fetisisa; 
early	 hoseng; pele; 
earmarked	 lokiseditswe; hopoletswe;  nahanetswe; 
earned	una; 
earning	una; 
earnings	 dihlapiso; meputso; 
earth	 lefatshe; mobu; 
ease	bonolo; 
easier	bonolo; 
easily	 ka bobebe; habobebe; 
eastern	ya Botjhabela; 
easy	bonolo; 
economically	ka ho baballa; ya moruo;  ka poloko;  ka paballo; 
economics	thuto ka moruo; 
economies	 meruo; ekonomi; 
economists	 baboloki; bahwebi; 
economy	moruo; 
edge	ntlha;  ntshi; 
edition	kgatiso; 
editor	mohlophisi; 
editors	mohlophisi; 
educate	-ruta; 
educated	 -ruta; rutile; 
educating	 -ruta; rutang; 
education	 -ruta; thuto; 
educational	thuto; 
educator	titjhere; 
educators	dititjhere; 
effect	sephetho;  diphetho;  phethahatsang; 
effected	sephetho;  diphetho;  phethahatsang; 
effectively	ka bokgoni; 
effectiveness	 bohlwahlwa; bokgoni;  boqhetseke; 
effects	 phethahatsang; diphetho; 
efficacy	 bohlwahlwa; bokgoni;  boqhetseke; 
efficiency	bokgoni; 
efficient	ka bokgoni; 
efficiently	ka bohlwahlwa;  ka bokgoni;  ka boqhetseke; 
efforts	boikitlaetso; 
eight	robedi; 
either	ekaba; 
elderly	ka botsofe; ka boholo; 
elders	batsofe;  maqheku le maqhekwana; 
elect	-kgetha;  ho kgetha; 
elected	-kgetha;  ho kgetha; 
election	dikgetho; 
elections	dikgetho; 
electoral	ya dikgetho; 
electrical	ya motlakase; 
electricity	motlakase; 
electrification	kgokelo ya motlakase; 
electronic	elektroniki; 
electronically	ka motlakase; 
elects	 -kgetha; kgetha;  ho kgetha; 
element	karolo; 
elements	motheo; 
elevate	phahamisa;  nyolla; 
eligible	 ekaba nkgetheng; a ka kgethwa; 
eliminate	ntsha; 
eliminated	ntshano; ntsha; 
eloquently	ka ho bua hantle;  ka puo e utlwahalang; 
else	ha ho se jwalo; 
elsewhere	kaekae; 
email	imeile;  posa; 
emanating	 e hlahang; e ropohang;  e runyang; 
emancipation	tokoloho; 
embark	sebetsana; 
embarked	sebetsane; 
embarking	sebetsanang; 
embassies	bonqosa; 
embassy	bonqosa; 
embed	ho tebisa; 
embedded	ho tebisa; 
emblem	letshwao; 
embodiment	mmelefatso; 
emerge	 ho bitoha;  ho tswa; runya; hlaha;  ropoha; 
emerged	 ropohile; bitohile;  runtse;  hlahile; tswile; 
emergence	 ho bitoha; ho runya; ho tswa;  ho hlaha;  ho ropoha; 
emergency	qomatsi; 
emergent	ho hlahang;  ho runyang;  ho ropohang; 
emerging	 ropohang;  ho tswang;  ho bitohang;  runyang; hlahang; 
eminent	hlakile;  bonahang; 
emoluments	sebopeho sa meputso;  sekala sa meputso; 
emotion	maikutlo; 
emotional	 ka maikutlo; ho ferekana maikutlong; 
emotions	maikutlo; 
emphasis	tiiso; 
emphasise	ho hatella; 
emphasised	tobokeditse;  hateletse; 
emphasises	hatella;  toboketsa; 
employ	 ho thola; -hira; 
employed	 ho thola; -hira; 
employer	mohiri; 
employers	mohiri;  bahiri; 
employing	 ho thola; -hirang; 
employment	mosebetsi; 
employs	 ho thola; -hira; 
empower	 fana ka bokgoni; matlafatsa; 
empowered	matlafaditse;  fane ka bokgoni; 
empowering	 fanang ka bokgoni; matlafatsang; 
empowerment	matlafatso; 
empty	tsholla;  - lephaka; 
emulate	etsisa; 
enable	ho thusa;  ho neha bokgoni; 
enabled	ho thusa;  ho neha bokgoni; 
enables	ho thusa;  ho neha bokgoni; 
enabling	ho thusa;  ho neha bokgoni; 
enacted	entse;  sebeditse; 
enacting	etsa;  etsang; 
enactment	ketso; 
enactments	diketso; 
encourage	kgothaletsa;  ho kgothatsa; 
encouraged	 ho kgothatsa; kgothaleditse; 
encourages	kgothaletsa;  ho kgothatsa; 
encouraging	kgothaletsang;  ho kgothatsa; 
end	phetho; 
endanger	-kenya kotsing; 
endangered	-kenya kotsing; 
endeavor	ho leka; 
endeavour	ho leka; 
endeavours	ho leka; 
ended	phetho; qetello; 
endorse	thasiselletsa;  paka; tiisa;  hatella; 
endorsed	 thasiseleditse; tiisitse;  pakile;  hateletse; 
endorsement	 tiiso;  thasiselletso; bopaki; kgatello; 
ends	phetho; qetello; 
enduring	tiisetsang;  mamellang; 
energy	matla; 
enforce	-hatella; 
enforced	 -hatella; hateletse; 
enforcement	qobello; kgatello; 
engage	kenyeletsa; 
engaged	kenyeleditswe; 
engagement	beeletsa; 
engagements	dipeeletso; 
engaging	kenyeletsang; 
engender	hlahisa; 
engendering	hlahisang; 
engine	enjene; 
engineer	moenjenere; 
engineering	moenjenere; 
engineers	moenjenere;  baenjenere; 
enhance	totobatsa; 
enhanced	totobaditse; 
enhancement	kgodiso;  phahamiso; 
enhancing	totobatsa; 
enjoy	 nyakalla; thaba; 
enjoyed	 nyakaletse; thabile; 
enormous	haholo; 
enough	lekane; 
enquiries	dipatlisiso; 
enquiry	patlisiso; 
enrich	 ruisa; nontsha; 
enrol	ngodisa; 
enrolled	ngodisa; 
enrolment	ngodiso; 
enshrined	kenyeleditse; 
ensue	latela; 
ensuing	latela; 
ensured	nnetefatsa; 
ensures	nnetefatsa; 
ensuring	nnetefatsa; 
enter	kenya; 
entered	kenya; 
entering	kenya; 
enterprise	kgwebo; 
enterprises	dikgwebo; 
enters	kenya; 
entertainment	boithabiso; 
entities	ditheo; 
entitled	na le tokelo; 
entity	setheo; 
entrance	makeno; 
entrepreneurial	ya kgwebo; 
entrepreneurs	bahwebi; baqalakgwebo; 
entries	makeno;  kenello; 
entrusted	tshepetswe; 
entry	makeno;  kenello; 
envelope	enfolopo; 
environment	tikoloho; 
environmental	ya tikoloho; 
environments	tikoloho; 
envisaged	lebeletse; 
envisages	ditebello; 
epidemic	sewa; 
equal	 lekana; lekanang; 
equality	tekano; 
equally	ka ho lekana; 
equals	e lekana le; 
equipment	disebediswa; 
equipped	lokisitswe; 
equivalent	tshwana; 
eradicate	 hlaola phoso; fedisa; 
eradicating	hlalong diphoso; fedisang; 
eradication	phediso; 
error	phoso; 
errors	 phoso; diphoso; 
escape	phonyoha; 
escapes	phonyoha; 
essence	esense; 
essential	hlokeha;  tlhoko; 
essentially	ya bohlokwa; 
establish	hloma; 
established	hloma; 
establishes	hloma; 
establishing	hloma; 
establishment	 moaho; motheo; 
establishments	metheo;  meaho; 
estate	bojalefa;  leruo; 
estates	bojalefa;  maruo;  leruo; 
esteemed	hlomphehang; 
estimate	tekanyetso;  kakanyo; 
estimated	tekanyetso; ho lekanyetsa;  kakanyo; 
estimates	tekanyetso; ho lekanyetsa;  kakanyo; 
ethics	 metheo ya boitshwaro; boitshwaro; 
ethnic	morabe; 
ethnicity	bomorabe; 
ethos	melao ya boitshwaro; 
evaluate	-hlahloba; 
evaluated	-hlahloba; 
evaluating	-hlahloba; 
evaluation	teko; 
eve	pele ho; 
even	lekanang;  boreledi; 
evening	thapama;  phirimana; 
event	ketsahalo; 
events	diketsahalo; 
eventually	qetellong; 
ever	kamehla; 
every	e mong le e mong; 
everybody	e mong le e mong; 
everyone	e mong le e mong; 
everything	ntho e nngwe le e nngwe; 
evidence	bopaki;  paki; 
evident	hlakile;  ho hlakile; ho a kgolweha hore;  ho a bonahala; 
exactly	ka nepo; 
examination	hlahlobo; 
examinations	 ditlhahlobo; hlahlobo; 
examine	hlahloba; 
examined	hlahloba; 
example	mohlala; 
examples	mehlala; 
exams	ditlhahlobo; 
exceed	feta;  ho feta; 
exceeded	feta;  ho feta; 
exceeding	e fetang moedi; 
exceeds	feta;  ho feta; 
excelled	e bontshitse boqhetseke; 
excellent	bokgabane; 
except	ntle ho; 
exceptional	 qatsohile; ikgethile; 
excess	ho feta tekano; 
excessive	 e feta tekano; e feta moedi; 
exchange	phaphanyetsano;  kananyo; 
exchanges	ananya;  dikananyo; phaphanyetsano; 
excise	phethahatsa;  hlakisa; 
exclude	tlohela; 
excluded	tlohela; 
excludes	tlohela; 
excluding	tlohela; 
exclusion	kgethollo; 
exclusions	dikgethollo; 
exclusive	kgethehile; 
exclusively	ka ho kgetheha; 
exercise	kwetliso;  hlakiso;  tlhakiso;  -kwetlisa; 
exercised	kwetliso;  hlakiso;  tlhakiso;  -kwetlisa;  kwetlisitse; 
exercises	ditlhakiso; 
exercising	kwetliso;  hlakiso;  tlhakiso;  -kwetlisa; 
exhibit	sepepeso; 
exhibition	pontsho; 
exhibitions	dipontsho; 
exile	leleka;  teleko; 
exist	ho ba teng; 
existed	ho ba teng; 
existence	 ho ba teng; boteng; 
existing	e leng teng; 
exists	ho ba teng; 
exit	moo ho tsuwang le teng; 
expand	sarolla;  -atolosa; 
expanded	sarolla;  -atolosa; 
expanding	sarolla;  -atolosa; 
expansion	 tsharoloho; katoloso;  tsharollo; 
expect	lebella; 
expectation	tebello; 
expectations	ditebello; 
expected	lebella; 
expedient	ka potlako; 
expenditure	tshenyehelo; 
expenses	ditshenyehelo; 
expensive	 theko e boima; -bitsang; 
experience	boiphihlelo;  ho itemohela;  boitemohelo; 
experienced	boiphihlelo;  ho itemohela;  boitemohelo; 
experiences	boiphihlelo;  ho itemohela;  boitemohelo; 
experiencing	 itemohelang; boiphihlelo;  ho itemohela;  boitemohelo; 
expert	setsebi; 
experts	ditsebi; 
expiration	phefumoloho; 
expired	feletswe ke nako; 
expiry	phello ya nako; 
explained	hlalosa; 
explains	hlalosa; 
explanatory	ya bohlalosi; ya tlhaloso; 
explicit	e itlhalosang; 
explore	 pholletsa; ho ithuta; 
explored	 pholletsa; ho ithuta; hahlaola; 
explores	 pholletsa; ho ithuta; hahlaola; 
exploring	 pholletsa; ho ithuta; hahlaola; 
export	diyantle;  seyantle;  thomellontle; 
exports	diyantle; diromelwantle;  thomellontle; 
express	-utlwahatsa;  ho hlahisa; 
expressed	-utlwahatsa;  ho hlahisa; 
expression	palo; 
expressions	palo; 
expressly	ka tlhahiso; ka boitsebahatso; 
extend	eketsa;  atolosa; 
extended	eketsa;  atolosa; 
extending	eketsa;  atolosa; 
extends	eketsa;  atolosa; 
extent	 boemo; maemo; 
external	ntle;  bokantle;  ya kantle; 
extra	ho feta; 
extract	 seratswana;  qotso;  ho ntsha leino; ntsha; 
extraordinary	e sa tlwaelehang; e ikgethileng; 
extremely	e fetisisang; 
eye	leihlo;  lesoba la nale; 
eyes	mahlo; 
face	bokahodimo;  bokantle; 
faced	bokahodimo;  sefahleho; lehlakore;  bokantle; 
faces	bokahodimo; lehlakore;  difahleho;  bokantle; 
facilitate	tsamaisa;  bebofatsa; 
facilitated	tsamaisa;  bebofatsa; 
facilitates	tsamaisa;  bebofatsa; 
facilitating	tsamaisa;  bebofatsa; 
facilitation	potlakiso; 
facilities	sesebediswa; 
facility	sesebediswa; 
facing	tobaneng; 
facsimile	fekese; 
fact	ntlha; 
factor	lebaka; 
factors	 mabaka; lebaka; 
factory	faboriki; 
facts	dintlha; 
fail	hlolwa;  feila; 
failed	hlotswe;  feitse; 
failing	hlolwang;  feilang; 
fails	hlolwa;  feila; 
failure	ho hloleha; 
failures	ho hloleha; 
fairly	 ka botshepehi; ka kgotsofalo; 
fairness	botshepehi; 
fall	ho wa; 
fallen	wele; 
falls	wa; 
familiar	tlwaelehileng; 
families	lelapa;  maloko; lekolo; 
family	lelapa;  leloko; 
famous	tuma; 
fan	fene; 
fans	difene; 
far	hole; 
farewell	tumediso;  tsamaya hantle; 
farm	polasi; 
farmer	rapolasi; 
farmers	borapolasi; 
farming	temo; 
farms	dipolasi; 
fashion	sejwalejwale; 
fast	ho itima; 
faster	ho itima; 
father	ntate; 
fathers	bontate; 
fault	 hlwaya phoso; phoso; 
favorite	thatohatsi; 
favorites	thatohatsi; 
favour	molemo; 
favourable	 ratwang;  kgahlehang;  tsotwang;  ratehang; kgethwang; 
favourite	thatohatsi; 
faxed	fekse; rometse fekese; 
fear	letswalo;  tshabo; 
fears	tshabo;  matswalo; 
feasibility	bokgoni; 
feature	tshobotsi; 
featured	tshobotsi; 
features	tshobotsi; 
featuring	tshobotsi; 
federal	Bofederale; 
federation	federeishene; 
fee	tefo; 
feed	fepa; 
feedback	kgutlisetso; 
feeds	fepa; 
feel	utlwa; 
fees	ditefo; 
fell	wele; 
fellow	 moreso; weso; 
felt	utlwile; 
female	mosadi;  tshehadi;  -tshehadi; 
females	mosadi;  tshehadi;  -tshehadi; 
festival	mokete; 
festivals	mekete; 
festive	 ya keteko; mokete; 
fever	feberu; 
few	mmalwa; 
fewer	fokolang;  haella;  nyenyane; 
field	tshimo; 
fields	ditshimo; 
fifth	ya bohlano; 
fifty	mashome a mahlano; 
fight	ntwa; 
fighter	selwani; 
fighters	dilwani; 
fighting	ntwa; 
figure	palo; setshwantsho; 
figures	ditshwantsho;  dipalo; 
file	 feile; faele;  feila; 
filed	 feile; faele;  feila; 
files	 feile; faele;  feila; 
filing	 feile; faele;  feila; 
fill	tlatsa; 
filled	tlatsitse; 
film	filimi; 
filmmaker	mohlahisi wa difilimi; 
filmmakers	bahlahisi ba difilimi; 
filmmaking	ho etsa filimi; 
films	difilimi; 
finalisation	qetello; 
finalise	qetella; 
finalised	qetelletswe; 
finalising	qetellang; 
finally	qetellong; 
finance	 taolo ya tjhelete; tsa tjhelete; 
financed	 taolo ya tjhelete; tsa tjhelete; 
finances	 taolo ya tjhelete; tsa tjhelete; 
financial	tsa ditjhelete; 
financially	 ka tjhelete; ya tjhelete; 
financing	 taolo ya tjhelete; tsa tjhelete; 
find	fumana; 
finding	tshibollo;  diphumano; 
findings	tshibollo;  diphumano; 
finds	fumana; 
fine	 le hlakile;  faene;  boreledi; pheletso; 
fines	 le hlakile;  pheletso; ditefiso;  faene;  boreledi; 
finest	 le hlakile;  faene;  boreledi; pheletso; 
fingerprints	mehlala ya menwana; 
fire	mollo; 
firearm	sethunya; 
firearms	 dithunya; sethunya; 
firm	e tsitsitseng;  -tiileng; 
firmly	ka botsitso; 
firms	e tsitsitseng;  -tiileng; 
first	pele; 
firstly	 tabeng ya pele; qalong; 
fiscal	ditjhelete tsa lekgetho; 
fish	 tlhapi; hlapi; 
fisheries	ditlhaping;  Tshwaso ya ditlhapi; botshwasi ba ditlhapi;  dihlaping; 
fishery	dihlaping; 
fit	e phelang hantle;  e kwenneng;  -shahlile; 
fitting	tshwanela; 
five	hlano; 
five-year	dilemo tse hlano; 
fixed	tsitsitseng;  tiileng; 
flag	folakga; 
flags	difolakga; 
flagship	sekepe sa folakga; 
flame	lelakabe; 
flexibility	temeko; 
flexible	e kobehang; 
flood	dikgohola; 
floods	dikgohola; 
floor	fatshe;  botlase;  mokato;  fuluru; 
flora	dimela; 
floral	dipalesa; 
flow	phallo; 
flower	palesa; 
flows	phallo; 
fly	fofa;  ntsintsi; 
flying	fofang; 
focus	-tsepamisa; 
focused	-tsepamisa; 
focuses	-tsepamisa; 
focusing	-tsepamisa; 
follow	latela; 
follow-up	tatello; 
followed	latetse; 
following	-latelang; 
follows	latela; 
food	dijo; 
foot	leoto; 
football	bolo; 
footsteps	mehlala ya maoto; 
for	bakeng sa; 
force	 ho qobella;  tshutumetso; matla; 
forced	hateletse;  qobeletse; tlameletse; 
forces	 ho qobella;  tshutumetso; matla; 
forebears	badimo; 
forefront	 ka pele; mosupatsela; 
foreign	ya ditjhaba; 
foreigner	molata; 
foreigners	melata; 
forensic	diphuputso tse tebileng; 
forestry	 tlhokomelo ya meru; temo ya meru; 
forests	moru; meru; 
forever	kamehla le mehla; 
forged	semethe;  tea; 
forget	lebala; 
form	 ho bopa;  foroma; sebopeho;  bopa;  banka; 
formally	ka molao; 
format	 lewa; lehlobo;  mofuta; mokgwa; 
formation	sebopeho;  popeho; 
formations	sehlopha sa ditjeki; dibopeho;  popeho; 
formed	 ho bopa;  foroma; sebopeho;  bopa;  banka; 
formerly	 ya pele; qalong; 
forms	 ho bopa;  foroma; dibopeho;  bopa;  banka; 
formula	fomula; 
formulation	kahong; 
forth	tswela pele; 
forthcoming	e tlang; 
forthwith	ho ya pele; 
forum	foramo; 
forums	diforamo; 
forward	ho ya pele; 
forwarded	fetiseditswe; 
foster	ho phahamisa; 
fostering	ho phahamisa; 
fought	ntwa; 
found	fumana; 
foundation	motheo; 
foundations	metheo; 
founder	mothei; 
four	nne; 
fourth	ya bone; 
frame	popeho;  foreimi; 
framework	moralo; 
frameworks	moralo; 
franchise	tokelo ya ho kgetha; 
fraud	bobodu; 
free	ka bolokolohi; 
freed	lokolotswe; 
freedom	tokoloho; 
freedoms	tokoloho; 
freely	ka bolokolohi; 
freight	morwalo; 
frequency	leqhubu; 
frequently	kgafetsa; 
fresh	Foreshe; 
friend	motswalle; 
friendly	ka thabo; 
friends	metswalle; 
friendship	setswalle; 
from	ho tswa; 
front	ka pele; 
fruit	 tholwana; ditholwana; 
fruitful	atlehile; 
fuel	dibeso; 
fuels	dibeso; 
fulfil	 tshepahalla; phethahatsa; 
fulfill	 tshepahalla; phethahatsa; 
fulfilling	tshepahalang;  phethahatsang; 
full-time	ka nako tsohle; 
fully	ka botlalo; 
function	 sebetsa;  mosebetsi wa ho itseng; tshebetso;  ho sebetsa;  disebediswa; 
functional	molemo wa tshebetso; 
functionality	ka molemo wa tshebetso; 
functioning	 sebetsa;  mosebetsi wa ho itseng; tshebetso;  ho sebetsa; kamano;  disebediswa; 
functions	sebetsa;  mosebetsi wa ho itseng;  ho sebetsa;  ditshebetso;  dikamano;  disebediswa; 
fund	letlole; 
fundamentally	hantlentle; 
funded	letlole; 
funding	letlole; 
funds	tjhelete;  matlole; 
funeral	lepato; 
furnish	nyehelana ; fana; 
furnished	fanne;  nyehelane; 
furniture	fenetjhara; 
further	ho feta mona; 
furthermore	ho feta mona; 
gain	 ho kotula; phaello; 
gained	 ho kotula; phaello; 
gains	 ho kotula; diphaello; 
gala	kgorolakoqo; 
galleries	 meaho ya bonono; dikalana; 
gallery	kalana;  moaho wa bonono; 
game	 diphoofolo tse hlaha; papadi; 
gap	sekgeo; 
gaps	dikgeo; 
garden	 tshingwana; serapa; 
gardens	dirapa; ditshingwana; 
garnishee	qobellang; 
gas	kgase; 
gateway	kgoro; 
gathering	kopano;  phutheho;  seboka; 
gave	fane; 
gazette	gazete; 
gear	gere; 
geared	gere; 
gender	bong; 
gender-based	ya bong; 
general	akaretsang; 
generally	ka kakaretso; 
generate	fehla; 
generated	fehla; 
generating	fehla; 
generation	 moloko; dithaka;  phehlo; 
generations	meloko; diphehlo;  dithaka; 
genre	mofuta; 
genres	mefuta; 
gentlemen	bahlomphehi; 
geographic	ya lefatshe; 
geography	 jeografi; thutalefatshe; 
get	fumana; 
gets	fumana; 
getting	fumana; 
giant	ledimo; 
gift	mpho;  neo; 
girl	ngwanana; 
girls	banana; 
give	fa; 
gives	fa; 
giving	 fang; fa; 
glad	 nyakaletse; thabile; 
glass	kgalase; 
globalisation	kananelo ya lefatshe lohle; 
globally	hohle lefatsheng; ka kakaretso; 
globe	 polokwe; lefatshe; 
glory	tlotliso; 
go	tsamaya; 
goal	 ntlha; sepheo; 
goals	 sepheo; dintlha; 
goes	ya;  tsamaya; 
going	ya; yang; 
gold	kgauta; 
golden	ya kgauta; 
gone	ile; 
good	ntle; 
goods	diphahlo;  phahlo; 
gore	madi; 
gospel	mmino wa sedumedi;  mmino wa bodumedi; 
got	fumane; 
govern	 -busa; busa; 
governance	puso; 
governed	 -busa; busa; 
governing	busang; 
government	mmuso; 
government's	ya mmuso; 
governments	mebuso; 
grace	mohau; 
grade	 hlopha; sehlopha;  mohato; 
grades	dihlopha;  hlopha; sehlopha;  mohato; 
grading	 hlopha; sehlopha;  mohato; 
gradually	butlebutle; 
graduate	-apara;  kerajueiti; 
graduates	-apara;  kerajueiti;  beng ba dikgau; 
grand	kgabane;  kgahleha;  lokile; 
grant	thuso; 
granted	thuso; nyehetse; 
granting	thuso; nyehelang; 
grants	dithuso;  nyehelo; 
graphic	ya setshwantsho; ya tshwantshiso;  ya kerafo; 
grassroots	 metheong; qalong; 
grateful	motlotlo;  thabile; 
gratitude	thabo;  motlotlo; 
grave	lebitla; 
graves	mabitla; 
great	 tsoteha; kgolo; 
greater	kgolwanyane; 
greatest	kgolo haholo; 
greatly	ka boholo; 
green	tala;  botala; 
greetings	madume; 
grew	 ho lema; hola;  ho mela; 
grind	 ho sila; sila; 
gross	koroso; 
ground	 ho sila; sila; 
ground-breaking	qalo;  tshimollo; 
groundbreaking	qalo;  tshimollo; 
grounds	mabala; 
group	 hlophisa; sehlopha; 
groups	dihlopha; hlophisa; 
grow	 ho lema; hola;  ho mela; 
growing	 ho lema; hola;  ho mela; 
grown	 ho lema; hola;  ho mela; 
growth	kgolo; 
guardian	mohlokomedi; 
guest	moeti; 
guests	baeti; 
guidance	tataiso; 
guide	tataiso;  ho tataisa;  tataisa; 
guided	tataiso;  ho tataisa;  tataisa; 
guideline	tataiso; 
guidelines	ditataiso; 
guides	 ho tataisa; ditataiso;  tataisa; 
guiding	tataiso;  ho tataisa;  tataisa; 
guilt	letswalo; 
guilty	molato; 
gun	sethunya; 
h	bophahamo; 
had	entse; 
hail	sefako; 
hailed	sefako; 
hails	sefako; 
half	hafo; 
hand	 seatla; letsoho;  lenaka la watjhe; 
handed	 seatla; letsoho;  lenaka la watjhe; 
handing	 seatla; letsoho;  lenaka la watjhe; 
handle	mohwele; 
handled	mohwele; 
handling	mohwele; 
handover	nehelano; 
hands	 manaka a watjhe;  diatla; matsoho; 
happen	etsahala; 
happened	etsahetse; 
happening	etsahalang; 
happens	etsahala; 
happy	 -thabo; -thabileng; 
harassment	tlhekefetso; 
hard	thata; 
hare	mmutlanyana; 
harm	kutlwisobohloko;  tematso; 
harmful	e kotsi;  -kotsi; 
harmony	kutlwano;  tumisano; 
has	o entse; 
hatred	lehloyo; 
have	ba entse; 
having	ba a etsa; 
he	o; 
headed	hlooho; 
heading	sehlooho; 
headline	ntlhakgolo; 
headlines	dintlhakgolo; 
heads	dihlooho; 
heal	ho fola; 
healing	fola; 
health	bophelo;  bophelo bo botle; 
healthcare	tlhokomelo ya bophelo; 
healthy	 phetseng hantle; ho phela hantle; 
hear	utlwa; 
heard	utlwile; 
hearing	kutlo; 
hearings	kutlo; 
hears	utlwa; 
heart	pelo;  setsi; 
heavy	boima; 
hectare	heketare; 
hectares	diheketare; 
height	bophahamo; 
heights	bolelele; bophahamo; 
held	mothamo; 
help	thusa; 
helped	thusitse; 
helps	thusa; 
hence	ke ka hona; 
her	yena; 
heraldry	bohale; sebete; 
here	mona; 
hereby	mona; 
hereinafter	ho tloha mona; 
heritage	lefa; 
hero	mohale; 
heroes	bahale; 
heroine	mohale; 
heroines	bahale; 
herself	ka boyena; 
hidden	lekoko; 
hide	lekoko; 
hierarchies	metsollope; 
high	phahame; 
high-level	boemo bo phahameng; 
higher	phahaphahame; 
highest	phahame; 
highlight	hlakisa; 
highlighted	hlakisitse; 
highlights	hlakisa; 
highly	ka bophahamo; 
hill	leralla; 
hills	leralla; 
him	yena; 
himself	ka boyena; 
his	ya hae; 
historian	 mohisitori; mongodi wa nalane; 
historians	bangodi ba nalane;  mohisitori; 
historic	ya nalane; 
historical	ya hisitori; 
historically	ya nalane; 
histories	nalane;  histori; 
history	nalane;  histori; 
hit	otla; 
hold	mothamo; 
holder	setshelo; 
holders	setshelo;  ditshelo; 
holding	tshwere; 
holdings	tshwarang; 
holds	mothamo; 
holiday	phomolo; 
holidays	phomolo; 
holistic	ka hohle; 
homage	pabatso; 
home	lehae; 
homelessness	tlhoko ya lehae; 
homepage	leqephe le qalang; 
homes	mahae; 
honorary	ya tlotlo; 
honour	tlotla; 
honourable	tlotlehang; 
honoured	tlotlisitse; 
honouring	tlotlisang; 
honours	tlotlisa; 
hope	tshepo; 
hoped	tshepile; 
hopefully	ka tshepo; 
hopes	tshepo; 
hospitality	mohau; 
hospitals	dipetlele; 
hotel	hotele; 
hotels	dihotele; 
hour	hora; 
hours	dihora; 
house	ntlo; 
housed	ntlo; 
household	lelapa;  tsa lelapa; 
households	lelapa;  malapa;  tsa lelapa; 
houses	ntlo; 
housing	 kaho ya matlo; bodulo; 
how	jwang; 
however	leha ho le jwalo; 
hub	bohare; 
huge	kgolo; 
human	 -botho;  ya batho;  ya motho; motho; 
humane	botho; 
humanities	tsa botho; 
humanity	botho; 
humankind	motho; 
humans	batho;  ya batho;  ya motho; 
humble	hlompha; 
humbled	hlomphile; 
humility	 boikokobetso; botho; 
hundreds	makgolo; 
husband	monna; 
iconic	ya seemela; 
icons	diaekhone; 
idea	kgopolo; 
ideal	phethahalo; 
ideals	diphethahalo; 
ideas	dikgopolo; 
identical	-tshwanang; 
identification	boitshupo; 
identities	boitsebiso; 
identity	boitsebiso; 
if	haeba; 
ill	kula; 
illegal	- seng molaong; 
illustrate	bontsha; 
illustrated	bontsha; 
images	ditshwantsho; 
imagination	kgakanyo; 
imbalances	ho hloka tekano; 
immediately	kapele; 
immense	-haholo; 
immensely	haholo; 
immigration	phallelo; 
imminent	bonahala; 
immovable	ha e tloswe;  e tsitsitse; 
immunisation	ente;  ho soutisa;  tshoutiso; 
impact	sekgahla; 
impacts	sekgahla; 
impaired	sitisehile; 
impediments	ditshitiso; 
implement	 -kenya tshebetsong; sesebediswa; 
implementation	ditshebediso; 
implemented	 -kenya tshebetsong; sesebediswa; 
implementing	 -kenya tshebetsong; sesebediswa; 
implements	 -kenya tshebetsong; sesebediswa; 
implications	mehopolo; 
implies	 tlisa mohopolo; bolela; 
import	kgwebiso;  hwebisa; 
importance	bohlokwa; 
important	-bohlokwa; 
importantly	 ka bohlokwa; molemo; 
imported	kgwebiso;  hwebisa; 
importer	moromelli wa ditswantle; 
imports	ditswantle; 
impose	tshohanyetsa;  qobella; hlahisa; 
imposed	hateletse;  qobeletse; tlameletse; 
imposing	 hatellang; qobellang; 
imposition	hloka botsitso; 
impressed	kgahlilwe; tsotile; 
impressive	 tsotehang; kgahlisang;  ratehang; 
imprison	kenya tjhankaneng; 
imprisoned	kenya tjhankaneng; 
improper	eo eseng ya nepo; 
improve	 -ntlafala; lokisa; 
improved	 -ntlafala; lokisa; 
improvement	tokiso; 
improvements	ditokiso; 
improving	 -ntlafala; lokisa; 
in	ka hare; 
inability	ho hloka bokgoni; 
inappropriate	e sa nepahalang; 
inaugural	ya kgakolo; 
inauguration	tlhomamiso; 
incapable	ka ho hloka bokgoni; 
incapacity	ka ho hloka bokgoni; 
incarceration	kgethollo; 
incentives	tshusumetsi; tshusumetsa; 
inception	qalo; 
incidence	ketsahalo tsa tshwaetso; 
incident	 sewelwa; ketsahalo; 
incidental	ka sewelo; 
incidents	diketsahalo;  sewelwa; 
include	kenya;  kenyeletsa; 
included	kenya;  kenyeletsa; 
includes	kenya;  kenyeletsa; 
including	balella; 
inclusion	palello; 
inclusive	kenyeletsang; 
inclusivity	kenyeletso;  kenyeletso; Kakaretso; 
income	kuno;  lekeno; 
incomes	 makeno; kuno;  lekeno; 
incomplete	 e sa fellang; e sa qetwang; 
inconsistent	-hlokang botsitso; 
incorporated	ho kopanya; 
incorporates	ho kopanya; 
incorporation	kakaretso; kenyeletso; 
incorrect	fosahetseng; 
increase	eketsa; 
increased	eketsa; 
increases	eketsa; 
increasing	eketsa; 
increasingly	keketso; 
inculcate	hatella;  toboketsa; 
indaba	seboka; 
indeed	ka nnete; 
independence	boikemelo; 
independent	ka boikemelo; 
independently	ka bolokolohi; 
index	tshupane; 
indicate	bontsha;  ho supa; 
indicated	bontsha;  ho supa; 
indicates	bontsha;  ho supa; 
indicating	bontsha;  ho supa; 
indication	pontsho; 
indications	dipontsho; 
indicative	bontsha; 
indicator	sesupi;  sesupisi; 
indicators	 ditshupo; ditshupiso; 
indices	 ditshupane; tshupane; 
indigenous	botala;  -botala; 
indirectly	eseng ka kotloloho; 
individual	bomong;  ka bonngwe; 
individually	motho ka mong; 
individuals	bomong;  ka bonngwe; 
industrial	tsa indastri; 
industries	 diindasteri; indasteri; 
industry	 indastri; indasteri; 
inequalities	ho hloka tekano; 
inequality	ho hloka tekano; 
infected	tshwaeditsweng; 
infection	tshwaetso; 
infections	bolwetse;  ditshwaetso; tshwaetso; 
inferior	tellehang; 
inflows	kenang; 
influence	seriti; 
influenced	seriti; tshusumetso; 
info	dintlha;  ditaba;  ditsebiso; 
inform	-tsebisa; 
information	tlhahisoleseding;  tsebiso; 
informed	tsebisitswe; bolelletswe; 
informing	-tsebisa; 
infrastructure	 moralo wa theknoloji; moralo; 
inherent	 ya sethatho; ya tlhaho; 
inherit	ho ja lefa; 
inherited	ho ja lefa; 
initial	pele; 
initially	qalong; 
initiative	boithaopo;  boiteko; 
initiatives	boithaopo;  boiteko; 
initiator	mosimolli; moqadi; 
injuries	 temalo;  leqeba; maqeba; 
injury	 leqeba; temalo; 
injustice	leeme;  tlhokatoka; 
injustices	leeme;  tlhokatoka; 
inmates	batshwaruwa; 
inner	ka harenyana; 
input	phepelo;  lehlahlelo;  hlahlela; 
inputs	diphehiso;  mahlahlelo;  diphepelo;  hlahlela; 
inquiry	patlisiso; 
inscribed	kenyeletsa; 
insert	kenya;  kenyeletsa; 
inserted	kenya;  kenyeletsa; 
insertion	kenyeletso; 
inserts	kenya;  kenyeletsa; 
inside	ka hare; 
insight	tsebo e tebileng; 
insights	tsebo e tebileng; 
insolvency	ho shota; phello ya tjhelete; 
insolvent	tjhonneng; 
inspect	hlahloba;  -hlahloba; 
inspection	hlahlobo; 
inspections	 ditlhahlobo; hlahlobo; 
inspector	mohlahlobi; 
inspectors	mohlahlobi; 
inspiration	kgothatso; 
inspire	kgothatsa; 
inspired	kgothaditse; 
inspiring	kgothatsang; 
install	ho hlomamisa;  kgwesa; 
installation	kgweso; 
installed	ho hlomamisa;  kgwesa; 
instalment	tefo ka hanyane; 
instalments	tefo ka hanyane; 
instance	lekgetlo; ketsahalo; 
instances	diketsahalo;  makgetlo; 
instead	ho na le; 
institute	ho hloma; 
instituted	ho hloma; 
institution	mokgatlo; 
institutional	ya tshebetso; ya institjushene; 
institutions	mekgatlo; 
instruction	taelo; 
instructional	ya thupello;  ya thuto; 
instructions	ditaelo; 
instrument	sesebediswa;  seletsa; 
instruments	disebediswa;  diletsa; 
insurance	inshorense; 
insurer	monga inshorense; 
intangible	e sa tshwaereheng; 
integrate	 kopanyeletsa; nyalanya; 
integrated	 kopanyeletsa; nyalanya; 
integrity	 tlhompho; seriti; 
intellectual	serutehi; 
intellectuals	barutehi; 
intended	ho ikemisetsa; 
intends	ho ikemisetsa; 
intensify	matlafatsa; 
intent	ikemisetsa; 
intention	boikemisetso; 
intentionally	ka boikemisetso; 
inter	ka hare; 
interact	-phedisana; 
interacting	-phedisanang; 
interaction	tshebedisano; 
interactive	tshebeletsano; 
interception	namola;  kena dipakeng; 
interdepartmental	mafapha a mabedi; 
interest	 kgahleho;  kekeletso; thahasello;  ho kgahla;  tswala; 
interested	thahaseletse; 
interesting	kgahlisang; 
interests	dikekeletso;  kgahleho;  ditswala; thahasello;  ho kgahla; 
interfaith	ditumelo tse pedi; 
interfere	 itshunyatshunya; ferekanya; 
interference	boitsunyatshunyo; boferekanyi; 
intergenerational	meloko e mmedi; 
intergovernmental	mebuso e mmedi; 
interim	bohare;  -sebakana; 
intermediaries	tse bohareng; 
intermediary	tse bohareng; 
intermediate	tse bohareng; 
internal	ya ka hara mmele;  ka hare; 
internationally	tsa matjhaba; 
internet	inthanete; 
interns	bomaithutwane; 
interpret	toloka;  -toloka; 
interpreted	ho hlalosa; toloka;  -toloka; 
interrogate	botsa; 
interval	 kgefutso;  phomolo; dipakeng; 
intervals	 kgefutso;  phomolo;  dikgefutso; dipakeng; 
intervene	kena dipakeng; 
intervention	kena dipakeng; 
interventions	kena dipakeng; 
interview	inthaviu; 
interviews	diinthaviu; 
intestate	ya se nang wili; 
into	ka hare; 
introduce	hlahisa;  tsebisa;  -tlisa; 
introduced	hlahisa;  tsebisa;  -tlisa; 
introducing	 -tlisang; hlahisang;  tsebisang;  tlisang; 
introduction	selelekela; 
invalid	e sa felleng; 
invest	boloka;  poloko; 
invested	boloka;  poloko; 
investigate	fuputsa;  hlohlomisa; 
investigated	fuputsa;  hlohlomisa; 
investigating	fuputsa;  hlohlomisa; 
investigation	phuputso;  patlisiso; 
investigations	 dipatlisiso; diphuputso; 
investigative	e batlisisang; 
investigator	mofuputsi;  mmatlisise; 
investigators	bafuputsi;  babatlisisi; 
investing	 bolokang; poloko; 
investment	poloko; 
investments	dipoloko; 
invitation	memo; 
involve	ama; kenya; 
involved	 amme; kentse; 
involvement	kakaretso; kenyeletso; 
involves	ama; 
involving	amang; 
iron	tshepe;  sidila;  tshepe e sidilang; 
irregularities	diphoso; 
irregularity	phoso; 
irrespective	ho sa natswe; 
irrigation	 nwesetso; nosetso; 
is	ke; 
isiXhosa	IsiXhosa; 
island	sehlekehleke; 
issue	taba; 
issued	tlhahiso; taba; 
issues	 ditlhahiso; ditaba; 
issuing	tlhahiso; taba; 
it	yona; 
it's	ke; 
item	ntho;  ntlha; 
items	dintlha;  dintho; 
its	ya yona; 
itself	ka boyona; 
jazz	jese; 
jewellery	mabenyane; 
job	mosebetsi; 
jobs	mesebetsi; 
joined	kopantse; 
joining	kopanya; 
joint	lenonyeletso;  makopanong; 
jointly	ka kopanelo; 
journalism	boithuti ba diphatlalatso; 
journalist	moqolotsi wa ditaba; 
journalists	baqolotsi ba ditaba; 
journey	eta; 
joy	thabo;  nyakallo; 
judge	 -ahlola;  ahlola; moahlodi; 
judgement	kahlolo; 
judges	 -ahlola;  ahlola; baahlodi; 
judgment	kahlolo; 
judgments	kahlolo;  dikahlolo; 
judiciary	tsa toka; 
junior	e monyenyane; 
jurisdiction	taolo; 
jurisdictions	ditaolo; 
juristic	ya molao; 
just	 ka molao; hona jwale; 
justice	toka; 
justified	netefaditswe; 
justify	netafatsa; 
k	k ; 
keen	kgothetse; thahaseletse; 
keep	boloka; 
keeping	bolokang; 
kept	bolokile; 
key	senotlolo;  konopo; 
keynote	puo ya sehlooho; 
kg	kilogramo (kg); 
kick	raha; 
kick-off	ho qala papadi; 
kill	bolaya; 
killed	bolaya; 
kilometre	kilometara; 
kilometres	dikilometara; 
kind	mosa;  -mosa; 
kindly	ka mohau; 
kinds	mosa;  -mosa; 
king	morena e moholo; 
kingdom	mmuso; 
kings	marena a maholo; 
km	kilomethara (km); 
knew	tsebile; 
know	tseba; 
knowing	tsebang; 
knowingly	ka tsebo; 
knowledge	tsebo; 
known	tsejwang;  tsebilweng; 
knows	tseba; 
laboratories	laboratri; 
labour	mosebetsi;  ho sebetsa;  ho pepa; 
lack	ho hloka; 
ladies	barwetsana;  basetsana; 
laid	behela; 
lake	letsha; 
land	 lefatshe;  mobu; naha;  tshimo;  tsorama; 
landfill	tlala naha; 
lands	 mafatshe; dinaha; 
landscape	popeho ya naha; 
language	 leleme; puo; 
languages	 maleme; dipuo; 
lapse	fela; 
large	kgolo; 
large-scale	haholo; 
largely	haholo; 
larger	 kgolwanyane; kgolo; 
largest	kgolo; 
last	qetela; 
lasting	tshwarellang; 
lastly	qetellang; 
late	morao; 
later	ha morao; 
latest	morao ka ho fetisisa; 
laughter	setsheho; 
launch	ho tlosa; 
launched	kgakotse; ho tlosa; 
launches	kgakola;  ho tlosa; 
launching	kgakola;  ho tlosa; 
laundering	tshenyo; 
laureate	motlotlehi; 
laureates	batlotlehi; 
law	 molawana; molao; 
law-making	ketsamolao; 
lawful	ka molao; 
lawfully	ka molao; 
laws	 melawana; melao; 
lawyer	 ramolao; mmuelli; 
lawyers	 babuelli;  ramolao; mmuelli; 
lay	behela; 
laying	behela; 
lead	 thapo ya motlakase; loto; 
leader	moetapele; 
leaders	baetapele; 
leadership	ketapele; 
leading	etellang pele; 
leads	dithapo tsa motlakase; diloto; 
leaflets	mahlomela; 
league	selekane;  liki; 
learn	ithuta; 
learned	ithutile; 
learning	ithutang; 
learnt	ithutile; 
lease	kadima; 
leased	kadimile; 
leasehold	kadimo; 
least	bonyane; 
leave	phomolo; 
leaves	phomolo; 
leaving	phomolo; 
lecture	ho ruta; 
led	 thapo ya motlakase; loto; 
left	leqele; 
leg	 leoto; mokgahlelo; 
legacies	lefa; 
legacy	lefa; 
legal	-molao; 
legally	ka molao; 
legend	tshomo; 
legendary	setumo se sa feleng;  ya sa lebalweng; 
legends	ditshomo; 
legislation	molao; 
legislative	ya molao; 
legislature	lekgotla la ketsamelao; 
legislatures	makgotla a ketsamelao; 
legitimacy	molao; 
legitimate	ya molao; 
less	ka tlase ho; 
lesser	mokadimani; 
lesson	thuto; 
lessons	dithuto; 
let	ha re; 
let's	ha re; 
letter	 tlhaku; lengolo; 
letters	mangolo; 
level	 thapallo;  bophahamo;  batalatsa; lekana; 
levels	 thapallo;  bophahamo; baterepase;  batalatsa; lekana; 
levied	lekgetho; 
levies	 makgetho; lekgetho; 
levy	lekgetho; 
liabilities	melato; 
liability	sekoloto; 
liable	tshwanela;  tshwaneleha; 
liaise	 hokelana; buisana; 
liaison	lehokela; 
liberalisation	bolokolohi; 
liberation	tokoloho; 
librarian	molaeborari; 
librarians	balaeborari;  modiskotheke;  radibuka; 
libraries	laeborari;  dibukeng;  diskotheke; 
library	laeborari;  dibukeng;  diskotheke; 
licence	laesense;  laksense; 
licences	dilaesense;  laksense; 
license	laesense;  laksense; 
licensed	 na le lengolo la bopaki; fumane laesense; 
licensee	 monnga lengolo la bopaki; monnga laesense; 
licensees	beng ba dilaesense;  beng ba mangolo a bopaki; 
licensing	fanang ka dilaesense;  fanang ka mangolo a bopaki; 
lie	tsela eo lesea le robetseng ka yona ka popelong; 
lies	 tsela eo lesea le robetseng ka yona ka popelong; robala; 
life	bophelo; 
lifetime	bophelo bohle; 
light	bobebe;  kganya;  hotetsa;  kganyang; 
lighting	lebone; 
like	jwaloka; 
likely	ho ka tshwana ho; 
limit	moedi; 
limitation	kgaello; 
limitations	dikgaello; 
limited	lekantsweng; 
limiting	moedi; 
limits	 moedi; meedi; 
line	 aletsa; mola;  motwa; 
line'	 aletsa; mola;  motwa; 
line-up	tatelano; 
lines	mela; 
linguistic	-puo; 
link	hokela;  hlaahlela;  lehlaahlela;  lehokela; 
linkage	neheletsano; 
linkages	neheletsano; 
linked	hokela; kamano;  hlaahlela;  lehlaahlela;  lehokela; 
linking	hokela;  amanyang;  hlaahlela;  lehlaahlela;  lehokela; 
links	mahokelo; 
liquid	sephalli; 
liquidator	molefi;  moqeti; mofedisi; 
liquidity	 bometsi; mokedikedi; 
liquor	jwala; 
list	 la theko; lenane; 
listed	 la theko; lenane; 
listen	mamela; 
listing	 la theko; lenane; 
lists	manane; 
literacy	tsebo ya ho bala le ho ngola; 
literally	ka nnete; 
literary	ka mantswe; 
literature	dingolwa; 
litigation	puisano;  tokiso; 
little	nyenyane;  haella;  fokola; 
live	 motlakase o phelang; phela; 
lived	 motlakase o phelang; phela; 
lives	bophelo; 
livestock	leruo la diphoofolo; 
living	phela; 
load	boima; 
load-shedding	phifalo ya motlakase; 
loan	kadimo; 
loans	dikadimo; 
local	mona; 
locally	lehae; 
locals	tsa lehae; 
located	beilwe sebakeng; 
location	lekeishene; 
lock-up	kwalla;  notlella; 
lodge	dula; 
lodged	dutse; 
lodging	bodulo; 
logistics	ditokisetso;  ditlhophisetso; 
long	lelele; 
long-term	nakotelele; 
longer	teletsana; 
look	sheba; 
looked	shebile; 
looking	shebahala; 
looks	tjhebahalo; 
lose	ho hlolwa; 
losses	 tahlehelo kgolong; tahlehelo; ditahlehelo; 
lost	ho hlolwa; 
love	-rata; 
loved	-rata; 
lovers	baratani; 
low	tlase; 
low-income	moputso o fokolang; 
lower	tlasenyana; 
lowest	tlase; 
lump	leqhutsu; 
mace	lere la puso; 
machine	motjhini;  matjhine; 
machinery	bomatjhine; 
machines	motjhini;  matjhine; metjhini; 
macro-economic	kgwebo e kgolo; 
macroeconomic	kgwebo e kgolo; 
made	etsa;  moetso; 
magazine	makasine; 
magazines	dimakasine; 
magisterial	 ya moahlodi; ya magistrata; 
magistrate	mmaseterata; 
magistrate's	 ya moahlodi; ya magistrata; 
magistrates	mmaseterata; 
magnificent	 tsotehang; babatsehang;  kgahlehang; 
magnitude	boholo; 
mail	 terene ya poso; poso;  posa; 
main	motheo;  kgolo; 
mainly	haholoholo; 
mainstream	ya bohle; 
mainstreaming	ya bohle; 
maintain	hlokomela;  tshehetsa; 
maintained	hlokomela;  tshehetsa; 
maintaining	hlokomela;  tshehetsa; 
maintains	hlokomela;  tshehetsa; 
maintenance	tlhokomelo;  phethiso; 
major	 majoro; kgolo;  -moholo; 
majority	 bongata; boholo; 
make	etsa;  moetso; 
makers	baetsi; 
makes	meetso; etsa; 
making	meetso; etsa; 
malaria	malariya; 
male	 botona; monna;  -tona; 
males	 botona; monna;  -tona;  motona; 
mall	lethathama la mabenkele; molo; 
man	monna; 
manage	ho atleha; 
managed	ho atleha; 
management	taolo; 
manages	ho atleha; 
managing	ho atleha; 
mandate	taelo; 
mandated	taelo;  laetse; 
mandates	ditaelo; 
mandatory	ka taelo; 
manifestations	ditlhahiso; 
manner	mokgwa; 
manual	 buka ya tataiso; ka letsoho; 
manufacture	 ho bopa; hlahisa; 
manufactured	 ho bopa; hlahisa; 
manufacturer	mohlahisi; 
manuscripts	dingolwa tse so phatlalatswe; 
many	ngata;  - ngata; 
map	mmapa; 
mapping	ho etsa mmapa; 
maps	dimmapa; 
march	mohwanto;  ho hwanta; 
marched	 mehwanto; ho hwanta; matjhe, hwantile; 
margin	moedi; 
marginal	ka thoko; 
marginalised	beheletswe thoko; 
marginalized	beheletswe thoko; 
marine	-lewatle; 
maritime	ya metsing; 
mark	 tshwaya;  ho tshwaya; letshwao; 
marked	hlwailwe; beheleditswe;  tshwailwe; 
market	 ho rekisa;  rekisa; mmaraka; 
marketing	thekiso; 
markets	makete;  ho rekisa;  rekisa; mmaraka; 
marking	ho maka; 
marks	matshwao;  tshwaya;  ho tshwaya; 
marriage	lenyalo; 
marriages	lenyalo; 
married	nyetswe; 
mass	bongata;  boima; 
massive	kgolo; 
master	monghadi; 
master's	ya monghadi; 
match	papadi;  thutswana ya mollo;  ho nyalanya;  -tsamaelana;  nyalanya; 
matches	metjhese; 
material	 sesebediswa;  masela; disebediswa; 
materially	ya thepa; 
materials	 sesebediswa;  masela; disebediswa; 
maternal	 bomme; boimana; 
mathematical	ya dipalo; 
mathematics	 bohlalepalo; mmetse; 
matric	metriki; 
matrimonial	ya lenyalo; 
matter	ntho;  boladu; 
matters	 boladu; dintho; 
maturity	ho butswa; 
maximum	hodimodimo; 
may	 Motsheanong; nka; 
maybe	mohlomong; 
mayor	majoro; 
mayors	bomajoro; 
me	nna; 
meaning	moelelo; 
meaningful	na le moelelo; 
meaningfully	ka moelelo; 
meanings	 meelelo; ditlhaloso; 
means	moelelo ke;  bolela hore; 
measurable	e methehang; 
measure	metha; 
measured	methile; lekantse; 
measurement	tekano;  mometho; 
measures	 metho; ditekanyi tsa nako;  tekanyi ya bonamo;  ditekanyi tsa mothamo; metha;  ditekanyi tsa boima;  tekanyi; 
measuring	ho metha; 
mechanical	-tlwaelo; 
mechanism	motjha wa tshebetso; 
mechanisms	metjha ya tshebetso; 
mediation	namola; 
medical	-bongaka; 
medicine	moriana; 
medicines	meriana; 
medium	puo eo ho rutwang ka yona; 
medium-term	nako e bohareng; 
meet	kopana;  teana; 
meeting	 kopano; lekgotla; 
meetings	 dikopano; makgotla; 
meets	kopana;  teana; 
member	setho; 
member's	ya setho; 
members	ditho; 
membership	botho; 
memorandum	memorandamo; 
memories	 kgopolo; mehopolo;  mohopolo; 
memory	mohopolo;  kgopolo; 
men	banna; 
mental	ya kelello; 
menu	menyu; 
merchant	mohwebi; 
mere	feela; 
merely	feela; 
merger	kopano; 
merit	 tshwanelo; tokelo; 
merits	 tshwanelo; tokelo; 
messages	melaetsa; 
messenger	morongwa; 
met	kopane; 
metal	tshepe; 
metals	tshepe;  dimetale / ditshepe; dimetale;  ditshepe; 
method	tsela;  mokgwa; 
methodology	thuto ya mokgwa; 
methods	tsela;  mekgwa;  mokgwa; 
micro	nyenyane; 
middle	bohareng; 
midst	hare; 
might	a ka; 
migration	phallo; 
milestone	matshwao a bophelong; 
milestones	phihlello ya bohlokwa; matshwao a bophelong; 
military	sesole;  sehlabani; 
milk	lebese; 
million	milione; 
millions	milione; 
mind	kelello; 
mindful	nahane; 
minds	kelello; 
mine	rafa;  mmaene;  morafo; 
mineral	 serashwa; minerale; 
minerals	 minerale; diminerale;  dirashwa; 
mines	merafo;  dimmaene;  rafa; 
minimum	minimamo; 
mining	rafa;  mmaene;  morafo; 
minister	letona;  moruti;  tona; 
minister's	ya moruti;  ya letona; 
ministers	 baruti; matona; 
ministry	 boruti; lefapha; 
minor	monyenyane;  nnyane; 
minority	bonyenyane; 
minutes	metsotso; 
misconduct	molato; 
misleading	 ferekanyang; kgelosang; 
mission	thomo; 
missions	thomo; 
mitigate	buisana; 
mitigation	ditherisano;  puisano; 
mix	tswaka; 
mixed	kopantse; 
mobile	e kgonang ho tsamaya; 
mobilisation	hlophisitse; 
mobilise	-thaotha; 
mobility	motsamao; 
model	malebela;  setshwano;  sekao;  motlolo;  supisa; 
models	malebela;  setshwano;  dimmotlolo;  sekao;  supisa; 
moderate	 e bohareng; bohareng; 
modern	sejwalejwale; 
modernisation	sejwalejwale; 
modified	ntlafatsa;  fetola; 
modify	ntlafatsa;  fetola; 
moment	nakwana;  motsotswana; 
moments	nakwana;  motsotswana; 
momentum	 mokoka; sekgahla; 
monetary	ya tjhelete; 
money	tjhelete; 
moneys	ditjhelete; 
monies	ditjhelete; 
monitor	 molebedi;  -disa; disa; 
monitored	 molebedi;  -disa; disa; 
monitoring	 molebedi;  -disa; disa; 
monitors	 molebedi;  -disa; disa;  balebedi; 
month	kgwedi; 
monthly	kgwedi le kgwedi; 
months	kgwedi; 
monument	sefika; 
monuments	difika / diemahale;  sefika; 
moral	thuto;  setho; 
more	ka hodima; 
moreover	hodima moo; 
morning	hoseng; 
mortality	mafu; 
mortgage	tumellano; 
most	-ngata; 
mostly	hangata; 
mother	mme; 
mothers	mme; 
motion	tshisinyo;  motsamao; 
motions	 ditlhahiso; ditshisinyo;  metsamao; 
motivation	kgothaletso; 
motor	mmotoro; 
motto	lepetjo; 
mountain	thaba; 
mountains	dithaba; 
mounted	palamisitsweng; 
mouth	molomo; 
movable	 tsamayang;  suthiswa; nkuwa; 
move	 suthisa; motsamao; 
moved	 suthisa; motsamao; 
movement	 motsamao; mokgatlo; 
movements	mekgatlo;  metsamao; 
moves	 suthisa; metsamao; 
moving	tsamayang; 
much	ngata; 
multi-party	meketjana e mengata; 
multilateral	mahlakore a mangata; 
multilingual	botemengata; 
multilingualism	botemengata; 
multimedia	kgobokano ya dikgokahano; 
multiparty	mekgamengata; 
multiple	ka katiso; 
municipal	 mmasepala; masepala; 
municipalities	bommasepala; 
municipality	 mmasepala; masepala; 
mural	motako leboteng; 
murals	metako leboteng; 
murder	polao; 
museum	misiamo; 
museums	dimosiamo; 
music	mmino; 
musician	sebini; 
musicians	dibini; 
must	lokela; 
mutual	ka tumellano; 
mutually	ka tumellano; 
my	ya ka; 
myself	nna; 
name	lebitso; 
named	lebitso; ho rea lebitso; 
namely	e bitswa;  e leng; 
names	ho rea lebitso; mabitso; 
narrow	 patisana; tshesane; 
natal	natala; 
nation	setjhaba; 
nation-building	kaho ya setjhaba; 
national	-naha;  ya setjhaba; 
nationality	setjhaba; 
nationally	ya setjhaba; 
nationals	melata;  -naha;  ya setjhaba; 
nations	ditjhaba; 
native	motala; 
natural	ka tlhaho;  ya tlhaho; 
nature	 semelo; tlhaho; 
near	haufi; 
nearest	haufi ka ho fetisisa; 
nearly	haufinyana;  e batlile; 
necessarily	hakaalo; 
necessary	hlokehang; 
need	tlhoko; 
needed	bohloki; tlhoko; 
needs	ditlhoko;  ditlhoko; bohloki; 
negative	hanyetsang; 
negatively	kgahlano; 
neglect	- se hlokomele;  ho hlokomoloha;  -hlokomoloha; 
neglected	- se hlokomele;  ho hlokomoloha;  -hlokomoloha;  ho se tsotelle; hlokomolohile; 
negligence	bohlaswa; 
negotiate	buisana;  thethesa; 
negotiated	 buisane; buisana;  thethesa; 
negotiating	buisana;  thethesa; 
negotiation	thetheso; 
negotiations	dipuisano; 
neighbouring	kahisanong;  ahisaneng; 
neither	ha ho e le nngwe; 
net	letanta;  letlowa; 
network	marangrang; 
networking	marangrang; 
networks	marangrang; 
never	le kgale; 
nevertheless	leha ho le jwalo; 
new	ntjha; 
newly	botjha; 
news	ditaba; 
newspaper	koranta; 
newspapers	dikoranta; 
newsroom	phaposi ya ditaba; 
next	e latelang; 
night	bosiu; 
nine	robong; 
no	tjhe; 
noble	hlomphehang; 
nominal	ya lebitso; 
nominate	 ikgethela; kgetha;  -thonya; 
nominated	 ikgethela;  thontse; kgetha;  -thonya; 
nomination	thonyo; 
nominations	dithonyo; 
non	ha se; 
non-compliance	ho se ikamahanye; 
non-governmental	eo eseng ya mmuso; 
non-profit	e sa etseng phaello; 
non-racial	eo eseng ya morabe; 
non-racialism	-se kgetholle ka morabe; 
non-refundable	e sa kgutlisetsweng tefo; 
non-sexism	eo eseng ya bong; 
non-sexist	eo eseng ya bong; 
non-tax	eo eseng ya lekgetho; 
none	ha ho le e nngwe; 
normal	e tlwaelehileng; 
normally	ka tlwaelo; 
north	 ya leboya; leboya; 
northern	ya leboya; 
not	eseng; 
notable	hlokomelehang; 
notably	ka tlhokomelo; 
note	 modumo;  noto;  hlokomela;  tjhelete ya pampiri;  lengolwana; ngola;  lemoha; 
noted	 modumo;  noto;  hlokomela;  tjhelete ya pampiri;  lengolwana; ngola;  lemoha; 
notes	dintlha; 
nothing	ha ho letho; 
notice	tsebiso; 
notices	ho elellwa; ditsebiso; 
notification	tsebiso; 
notified	tsebisitse; 
notify	tsebisa; 
noting	 modumo;  noto;  hlokomela;  tjhelete ya pampiri;  lengolwana; ngola;  lemoha;  ngolang; 
notion	mohopolo; 
notwithstanding	ho sa hananwe le; 
novel	pale; 
now	hona jwale; 
null	haho letho; 
number	palo;  nomoro;  bokaalo; 
numbers	dipalo; 
numerous	ngata;  - ngata; 
nurse	 -oka;  nese; mooki; 
nurses	 -oka;  nese; mooki;  baoki; manese; 
nursing	booki; 
nurture	 fepa;  hodisa; hlokomela; 
nurturing	 fepa;  hodisa; hlokomela; 
nutrition	kotlo;  phepo; 
oath	kano; 
object	ntho;  seetsuwa; 
objective	 sepheo; ntle; 
objectives	 sepheo; ntle; 
objects	dietsuwa;  seetsuwa; dintho; 
obligation	tlameho; 
obligations	ditlameho; 
observatory	boleping ba dinaledi; 
observe	shebisisa; 
observed	shebisisa; ela hloko; 
obsolete	hlobohilweng; 
obtain	fumana; 
obtainable	-fumanehang; 
obtained	fumana; 
obtaining	fumana; 
obvious	-totobetse; 
obviously	ho hlakile; 
occasion	ketsahalo; 
occasions	diketsahalo; 
occupation	mosebetsi;  kgapo; 
occupational	ya mosebetsi; 
occur	etsahala; 
occurred	etsahetse; 
occurrence	ketsahalo; 
occurring	etsahalang; 
occurs	etsahala; 
ocean	 lewatlehadi; lewatle; 
of	ya; 
offence	tlolo ya molao; 
offences	ditlolo tsa molao; 
offering	nyehelo;  sehlabelo; 
offerings	 dihlabelo; dinyehelo; 
office	ofisi; 
office-bearers	basebetsi ba diofising; 
officer	mohlanka wa mmusi; 
officers	baofisiri;  bahlanka wa mmuso; 
offices	diofisi; 
official	 ya mmuso; mohlanka wa mmuso; 
officially	ka molao; 
officials	ya mmuso;  bahlanka ba mmuso; 
offset	tima; 
offshore	ka thoko ho lebopo; 
often	hangata; 
oil	oli; 
on	hodima; 
on-going	tswelang pele; 
once	hang; 
once-off	hanngwe; 
one	nngwe; 
ones	bo-nngwe; nngwe; 
ongoing	tswelang pele; 
online	kgokelo;  e hoketsweng; 
only	feela; 
onto	hodima; 
open	bula; 
opened	 bulehile; butse; 
opening	lesoba; 
opens	bula; 
operate	ho seha; 
operated	ho seha; 
operates	ho seha; 
operating	ho seha; 
operation	 ho phunngwa; tshebetso;  tshebediso;  ho phungwa; 
operational	ya tshebetso; 
operations	 ho phunngwa;  ditshebediso; ditshebetso;  ho phungwa; 
opinion	maikutlo; 
opinions	maikutlo; 
opportunities	menyetla; 
opportunity	monyetla; 
oppose	hanana; 
opposed	hanana; 
opposite	shebaneng;  lelatodi; 
opposition	 mahanyetsapuso; bohanyetsi; 
oppressed	hateletse; 
oppression	kgatello; 
optimal	bohlokwa;  ka hodimodimo; 
optimism	 tebello; tshepo; 
option	kgetho;  boikgethelo; 
options	dikgetho;  boikgethelo; 
or	kapa; 
oral	ya molomo; 
orange	lamunu; 
orchestra	mminotetso; 
order	 hlophisa;  thomello;  tlhophiso;  hlohlomiso; taelo;  romella; 
ordered	 tlhohlomiso;  hlophisa; tatelano;  thomello;  hlophisitse;  tlhophiso;  hlohlomiso; taelo;  romella; 
orders	ditaelo; 
ordinance	molao; 
ordinarily	tlwaelehileng; 
ordinary	tlwaelehileng; 
organ	ditho;  thomo; 
organisation	mokgatlo; 
organisational	ya mokgatlo; 
organisations	mekgatlo; 
organised	hlophisitswe; 
organisers	bahlophisi; 
organising	hlophisang; 
organization	mokgatlo; 
organizations	mekgatlo; 
organized	hlophisitswe; 
organizers	bahlophisi; 
organs	ditho tsa puo; 
origin	mathomo; 
original	 -tlhaho; ya mantlha; 
originally	ka tlholeho; 
origins	sethatho;  mathomo; 
other	e nngwe; 
others	tse ding; 
otherwise	ha ho se jwalo; 
ought	lokela; 
our	ya rona; 
ours	tsa rona; 
ourselves	ka borona; 
out	ka ntle; 
outcome	sephetho;  ditlamorao; 
outcomes	 ditlamorao; diphetho; 
outdoor	 -ka ntle; ka ntle; 
outgoing	 tsamayang;  tlohelang; tswang; 
outline	 moedi; moralo; 
outlined	 moedi; ho otla dihlooho; moralo; 
outlines	 moedi;  meedi; ho otla dihlooho; moralo; 
outlook	sebopeho;  tjhebahalo; 
output	sephetho; 
outputs	diphetho; 
outreach	phihlello; 
outside	kantle;  ka ntle; 
outsourced	abetse ba bang; 
outstanding	ikgethileng; 
outward	ka ntle; 
oval	motopo;  e motopo; 
over	ka hodimo; 
overall	obarolo; 
overarching	okamela; 
overcome	hlola; 
overcrowding	kgobokano e fetang tekano; 
overseas	mose ho mawatle; 
oversee	hlokomela; 
overseeing	hlokomelang; 
oversight	ho se hlokomele;  ho fanya; ho se ele hloko; 
overview	tjhebokakaretso; 
overwhelming	ka bongata;  ka ho babatseha; 
owed	kolotile; 
owing	kolotang; 
own	rua;  ya hao; 
owned	ruile;  ya hao; 
owner	monnga; 
owners	beng ba; 
pace	sekgahla; 
package	sephuthelwana; 
packages	diphuthelwana; 
page	leqephe; 
pages	maqephe; 
paid	 lefile;  ho lefa; moputso; 
pain	lehlaba; 
painting	 moferefo; ho penta; 
paintings	 moferefo; ditshwantsho;  ho penta; 
palace	moreneng; 
panel	letsema;  phanele; 
paper	pampiri;  pampiri ya hlahlobo;  koranta; 
papers	 dikoranta;  dipampiri tsa hlahlobo; dipampiri; 
par	-lekana; 
paragraph	 serapa; tema; 
paragraphs	 serapa; tema;  dirapana; 
parent	motswadi; 
parental	ya botswadi; 
parenting	botswadi; 
parents	batswadi; 
park	paka;  phaka;  ho emisa; 
parking	paka;  phaka;  ho emisa; 
parks	 phaka; dipaka;  ho emisa; 
parliament	palamente;  kgotlakgolo; 
parliament's	ya palamente; 
parliamentary	ya palamente; 
parliaments	dipalamente; dikgotlakgolo; 
parole	boitsebelo ka diketso; 
part	karolo;  karolo ya puo;  karolwana; 
part-time	nakwana; 
partial	ikgethile; 
partially	ka ho ikgetha; 
participant	monkakarolo;  mokeni; 
participants	sebapadi; 
participate	nka karolo;  ho ba le seabo; 
participated	bile le seabo; nkile karolo; 
participates	 nka karolo; na le seabo; 
participating	nang le seabo;  nkang karolo; 
participation	 ho nka karolo; ho ba le seabo; 
participatory	nang le seabo;  nkang karolo; 
particular	yonayona; 
particularly	haholoholo; 
particulars	dintlha tsa hlakiso; 
partly	hanyenyane; 
partner	 mohwebisani; molekane;  mphato; 
partnered	 mohwebisani; molekane;  mphato; 
partners	 bomphato; balekane;  bahwebisani; 
partnership	kgwebisano; 
partnerships	dikgwebisano; 
parts	dikarolo; 
party	phathi; 
pass	 fetisetsa;  neheletsa; atleha;  neheletsano; 
passed	 fetisetsa;  neheletsa; atleha;  neheletsano; neheleditse; 
passenger	mopalami; 
passengers	bapalami;  mopalami; 
passes	 fetisetsa;  neheletsa; atleha;  neheletsano; 
passing	fetang; 
passport	phasepoto; 
past	ka mora; 
path	tsela; 
patient	mokudi; 
patients	mokudi; 
pattern	 mokgabiso; paterone; 
patterns	 mekgabiso; dipaterone; 
paved	butse;  thakgotse;  betlile; 
pavilion	letshwele;  phiphitha;  bashebelli; 
pay	lefa;  moputso;  ho lefa; 
payable	leshwang; 
paying	 lefang;  ho lefa; moputso; 
payment	tefo; 
payments	ditefo; 
pays	lefa;  ho lefa;  meputso; 
peace	kgotso; 
peaceful	ka kgotso; 
peak	tlhoro; 
peer	thaka; 
penalties	dipenele;  dikahlolo; 
pending	ha e so fele;  ha e so qete; 
pension	phenshene; 
pensions	 phenshene; dipenshene; 
people	batho; 
people's	ya batho; 
peoples	batho; 
per	ho ya ka; 
perceived	 nahanne;  amohetse; bone; 
percent	kgolong;  phesente; 
percentage	kgolong;  phesente; 
percentages	kgolong;  diphesente;  phesente; 
perception	mohopolo;  monahano; 
perceptions	mehopolo;  menahano; 
perform	 -bapala; bapala;  phethisa; 
performance	 ho bapala; papadi;  ketsahatso; 
performances	 ho bapala;  papadi;  diketsahatso; dipapadi; 
performed	 -bapala;  bapetse; bapala;  phethisa; 
performer	sebapadi; 
performers	dibapadi; 
performing	 -bapala; bapala;  phethisa; 
performs	 -bapala; bapala;  phethisa; 
perhaps	mohlomong; 
period	 pakathuto;  paka; nako; 
periodical	makasine;  dipaka;  lehlasedi; 
periods	dinako; 
permanent	 leruri; ruri; 
permanently	ruri; 
permission	tumello; 
permit	 ho dumella; tumello; 
permits	 ho dumella; tumello; 
permitted	 ho dumella;  dumeletse; tumello; 
perpetuate	boloka ka nako e sa feleng; 
person	 mmuiswa;  mmui;  mmuuwa; motho; 
person's	ya motho; 
personal	mong; 
personnel	basebetsi; 
persons	 babuuwa; batho;  babui;  babuiswa; 
perspective	ponalo; 
perspectives	 ponalo; ponahalo; 
pertaining	e loketseng; e amang; 
petition	 lengolo la ditletlebo; thapedi; 
petitions	lengolo la ditletlebo; dithapedi; 
petrol	peterole;  peterolo; 
petroleum	sepeterolo; 
pharmaceutical	ya dikhemisi; 
pharmacist	rakhemisi; 
pharmacy	 khemising; khemisi; 
phase	nako; 
phased	nako; 
phases	 dinako; nako; 
phenomenon	mohlolo;  ponahalo; 
philosophy	filosofi; 
phone	 founu; mohala; 
photo	setshwantsho; senepe; 
photograph	 -nka senepe; senepe; 
photographers	bankadinepe; 
photographic	ya setshwantsho; ka senepe; 
photographs	 -nka senepe; senepe; 
photos	 dinepe; ditshwantsho; 
physical	 ya mmele; sebopeho; 
physically	ka mmele; 
piano	 piano; tlase; 
pictures	ditshwantsho; 
piece	sekoto; 
pieces	dikarolwana;  ditlhokwa; 
pillar	tshiya; 
pillars	ditshiya; 
pilot	mofofisi; 
pivotal	ya bohlokwa; 
place	tulo; 
placed	 hlomile; beile; 
placement	mosebetsi;  peho; 
places	ditulo; 
placing	tulo; 
plain	hlakileng;  lehwatata nahathote; 
plains	hlakileng;  mahwatata nahathote; 
plaintiff	motseki; 
plaintiff's	moqosuwa; 
plan	 morero;  polane; moralo; 
planet	polanete; 
planned	 morero;  polane; moralo; 
planning	tekanyetso;  ho rala; 
plans	 meralo; merero;  polane; 
plant	 jala;  ho jala; thepa;  semela; 
plants	 jala;  ho jala; thepa;  semela; 
plastic	 setsopana; polasetiki; 
plate	poleiti; 
play	papadi;  papadiso; 
played	papadi;  bapetse;  papadiso; 
player	sebapadi; 
players	dibapadi; 
playhouse	ntlo ya papadi; 
playhouses	matlo a dipapadi; 
playing	papadi;  papadiso; 
plays	 papadiso; dipapadi; 
plea	kopo; 
pleading	 kopang; kopo; 
pleadings	dikopo; 
please	ka kopo; 
pleased	thabile; 
pleasure	thabo; 
pledge	itela; ikemisetsa; 
pledged	ikemiseditse;  iteletse; 
plenary	tlhophiso; 
plight	tshotleho; 
plus	ha e kopana le; 
poaching	ho tsoma ka ho ikutswa; 
poem	thothokiso; 
poet	 moroki; sethothokisi;  seroki; 
poetry	 bothothokisi; thothokiso; 
poets	diroki;  baroki;  dithothokisi; 
point	ntlha;  ntlhana;  kgutlo;  -supa; 
pointed	ntlha;  ntlhana;  supile;  kgutlo;  -supa; 
points	dintlha;  dintlhana;  -supa;  dikgutlo; 
police	sepolesa;  lepolesa; 
policies	 boitlamo ba inshorense; maano;  boikemisetso; 
policing	sepolesa;  lepolesa; 
policy	 boitlamo ba inshorense; leano;  boikemisetso; 
political	politiki; 
politics	politiki; 
pollution	tshilafatso; 
pool	letangwana; 
poor	bahloki; 
poorer	bohloki; bahloki; 
poorest	bohloki; bahloki; 
poorly	 ka thata;  ka bofokodi; ka boima; 
popular	-ratwang;  -ratwang ke bohle; 
population	baahi; 
pornography	bomaponapona; 
portal	kgoro; 
portfolio	 potefoliyo; lefapha;  potefolio; 
portion	karolo; 
portrayed	setshwantsho; 
position	 boemo; maemo; 
positions	maemo; 
positive	palo e kgolo ho noto; 
positively	ka kgothatso; 
possess	rua; 
possession	 taolo ya bolo; leruo; 
possibilities	kgonahalo; 
possibility	kgonahalo; 
possible	 kgoneha; fihlellwa; 
possibly	mohlomong; 
post	mosebetsi;  posa;  poso; 
post-apartheid	ka mora kgethollo; 
postal	ka poso;  ya poso; 
postgraduate	kamora kgau; 
postponed	fetotse letsatsi; thesitse; 
postponement	phetolo ya letsatsi;  ho thisa; 
posts	 diposo; mesebetsi;  posa; 
pot	pitsa; 
potential	bokgoni; 
potentially	ka bokgoni; 
poverty	bofuma; 
power	 matla;  tokelo; maemo; 
powers	 ditokelo;  matla; sekgahla sa tshebetso; maemo; 
practicable	-ka etswang; 
practical	ka etswang; 
practice	 kwetliso;  mesebetsi; mokgwa;  boitsharollo; 
practices	 mesebetsi; mokgwa; dikwetliso;  boitsharollo; 
practise	 -hlakisa; kwetlisa; 
practitioner	mosebedisi; 
practitioners	basebedisi; 
praise	ho rorisa; 
prayer	thapelo; 
pre-colonial	pele ho bokolone; 
pre-trial	teko ya pele; 
preamble	ketapele;  hlahiso; 
precede	etella pele; 
preceded	etella pele;  eteletse pele; 
preceding	etella pele; 
precinct	sephethephetheng;  sebaka se thibetsweng; 
precincts	 dibaka tse thibetsweng; sephethephetheng; 
precious	 tsoteha; rateha;  kgahleha; 
precisely	ka ho nepahala; 
preferential	e kgothaletswang; 
pregnancy	boimana; 
pregnant	 emere;  -imme; ho ima; 
prejudice	leeme;  tshekamelo; 
preliminary	qadisang; 
premier	tonakgolo; 
premised	theilwe; 
premises	metheo; 
preparation	 tokisetso; ditlhophiso; 
preparations	ditlhophiso;  ditokisetso; 
preparatory	tsa tokisetso; 
prepare	lokisa;  -lokisa; 
prepared	ikemiseditse;  hlophisitswe; 
preparing	lokisa;  lokisang;  -lokisa; 
prescribe	balla; 
prescribed	baletsweng; 
prescribing	balla; 
prescription	taelo;  moriana o laetsweng ke ngaka; 
prescripts	 tse kgothaletswang;  ditlamo; dikgothaletso; 
presence	boteng; 
presentations	ditlhahiso; 
presently	ha jwale; 
presents	 dimpho; dinyehelo; 
preservation	poloko; 
preserve	boloka; 
preserved	boloka; 
preserving	boloka;  bolokang; 
preside	dula setulo; 
presidency	Ofisi ya Presidente; 
president	poresidente; 
president's	ya Presidente; 
presidential	ya Presidente; 
presidents	mopresidente;  bapresidente; 
presiding	dula setulo; 
press	kgatiso;  ho sidila;  tobetsa;  hatella; 
pressing	hatellang; 
pressures	kgatello; dikgatello; 
prestigious	ka monyetla; 
presumed	nahanne; 
pretty	 tsoteha; rateha;  kgahleha; 
prevail	leng teng; 
prevailing	e leng teng; 
prevalence	ho ata ha tshwaetso; 
prevent	 ho thibela; thibela; 
prevented	 ho thibela; thibela; 
preventing	 ho thibela;  thibelang; thibela; 
prevention	thibelo; 
previous	fetileng; 
previously	pelenyana; 
price	theko;  poreisi; 
prices	theko;  ditheko;  poreisi; 
pricing	theko;  poreisi; 
pride	 boithoriso; boikgantsho; 
prima	ya bohlokwa; 
primarily	haholoholo; 
primary	 ya bohlokwa; haholo;  ya sehlooho;  ; 
prime	ya bohlokwa; 
principal	mosuwehlooho;  tlotloqalo; 
principals	tlotloqalo;  hlooho ya sekolo; basuwehlooho; 
principles	ditheo; ditumelo; 
print	kgatiso;  hatisa; 
printed	hatisa;  hatisitswe;  hatisitse;  ho hatisa; 
printing	kgatiso;  hatisa; ho hatisa;  kgatiso; 
prior	pele ho; 
priorities	bohlokwa; 
prioritised	hlophisitse ka bohlokwa ba tatelano; 
priority	bohlokwa; 
prison	tjhankane;  teronko; 
prisons	ditjhankane;  diteronko; 
privacy	lekunutu;  boinotshi; 
private	-eseng ya bohle; 
privilege	ho ba monyetla; 
privileged	bile le monyetla; 
privileges	tokelo; 
pro	tshehetso ya tshisinyo; tumellano le tlhahiso; 
proactive	thibelo ya pele; 
probably	mohlomong; 
probation	tlhokomelo ya nako e beilweng; 
probe	leka; 
problem	 marara; bothata; 
problems	 marara; tea; mathata; 
procedural	ho latela mokgwa wa tshebetso; 
procedure	tsamaiso;  mokgwatshebetso; 
procedures	ditsamaiso;  mekgwatshebetso; 
proceed	tswela pele; 
proceeding	tsamaiso ya lenane; 
proceedings	diketsahalo; 
proceeds	tswela pele; 
process	 sebetsa;  ketsahalo e tswellang; tshebetso; 
processed	 sebetsa;  ketsahalo e tswellang; tshebetso; 
processes	sebetsa;  ketsahalo e tswellang;  ditshebetso; 
processing	 sebetsa;  ketsahalo e tswellang; tshebetso; 
procession	mokoloko; 
proclamation	phatlalatso;  kgoeletso; 
procurement	phumantsho;  phumano; 
produce	hlahisa; 
produced	bea;  dibewa; hlahisa; 
producer	mohlahisi; 
producers	mohlahisi; 
produces	bea; hlahisa;  dibehwa; 
producing	bea;  dibewa; hlahisa; 
product	sehlahiswa; 
productions	ditlhahiso; 
productive	-hlahisang; 
products	 dibewa; diatiso;  dibehwa; dihlahiswa; 
professional	setsebi;  -profeshenale; 
professionals	 diprofeshenale; ditsebi; 
professor	moprofesara; 
profile	ponohlakore; nalane; 
profit	 peollo; phaello; 
profits	 peollo; phaello;  diphaello; 
profound	ya bohlokwa; 
program	lenaneo; 
programme	lenaneo; 
programmed	lenaneo; 
programmes	mananeo; 
programming	 tlhophiso ya mananeo; bongodi; 
programs	mananeo; 
progress	 ho tswela pele; tswelopele; 
progression	tatelano; tswelopele; 
progressive	-atlehileng; 
prohibit	thibela; 
prohibited	 thibetse; thibela; 
prohibition	thibelo; 
project	 ho porojekta; morero; 
projected	 ho porojekta; morero; 
projection	ho bontsha;  tahlelo; 
projections	ho bontsha;  tahlelo; 
projects	 ho porojekta; merero;  ho lepa; 
prominent	ya bohlokwa; 
promote	phahamisa;  -kgothalletsa; 
promoted	phahamisa;  -kgothalletsa;  phahamisitse; 
promotes	phahamisa;  -kgothalletsa; 
promoting	phahamisa;  -kgothalletsa;  kgothaletsang; 
promotion	phahamiso; 
promptly	ka potlako; 
promulgated	hlalositse;  qaqisetso; hlabolotse hore;  qaqisitse;  tlhaloso; 
proper	nepahetseng; 
properly	ka tshwanelo; 
properties	diphapantsho;  mabopi; maruo; 
property	 phapantsho;  lebopi; leruo; 
proportion	kabelo;  tekanyetso ya matla; 
proposals	ditlhahiso; 
propose	hlahisa;  sisinya; kgothaletsa; 
proposed	 kgothaleditse;  sisintse; hlahisa; 
proposes	hlahisa;  kgothaletsa;  sisinya; 
prosecute	qosa;  ahlola; 
prosecuted	qositse; 
prosecuting	qosang;  ahlolang; 
prosecution	qoso; 
prosecutions	 diqoso; qoso; 
prosecutor	motjhotjhisi; 
prosecutors	motjhotjhisi; 
prospect	ho batla dirashwa; 
prospecting	 ho batla dirashwa;  lebeletsang; lebeletseng; 
prospective	lebeletsweng; 
prospects	ditebello;  ho batla dirashwa; 
prospectus	bukana ya tlhahisoleseding; 
prosperity	tswelopele; 
prosperous	 tswetseng pele; atlehile; 
prostitution	bootswa; 
protect	 -sireletsa; sireletsa;  ho sireletsa; 
protected	 sireleditse;  -sireletsa; sireletsa;  ho sireletsa; 
protecting	 -sireletsa; sireletsa;  ho sireletsa; 
protection	tshireletso;  mosireletsi; 
protective	tshireletsang; sireletsang;  baballang; 
protector	Motshireletsi; 
protest	 kganyetso; boipelaetso;  hanyetsa; 
protests	boipelaetso;  dikganyetso;  hanyetsa; 
protocol	lenaneo la kalafo; 
protocols	mananeo a kalafo;  lenaneo la kalafo; 
proud	motlotlo; 
proudly	ka motlotlo; 
provided	hlokomela;  fane;  fepela; 
provident	ya tlhokomelo; 
provider	 mofani; mohlokomedi;  mofepedi; 
providers	 bafepedi;  bahlokomedi; bafani; 
province	karolo;  porovense; 
province's	ya provense; 
provinces	dikarolo; diprovense; 
provincial	ya provense; 
provisional	nakwana; ya nakwana; 
proviso	ka dipehelo;  ka ditaelo; 
proxy	moemedi;  mokgethwa; 
prudent	bohlokwa; 
prudential	ka bohlokwa;  ka tlhokomelo; 
public	tjekelele;  batho bohle; 
publication	phatlalatso; 
publications	diphatlalatso; 
publicly	phatlalatso; 
publish	phatlalatsa; 
published	phatlalatsa; 
publisher	 mophatlalatsi; mohatisi; 
publishers	 bahatisi; baphatlalatsi; 
publishes	phatlalatsa; 
publishing	phatlalatsa; 
punishment	kotlo; 
purchase	reka; 
purchased	reka; 
purchases	reka; 
purporting	kgothaletsang; 
purpose	tebo; 
purposes	tebo; 
pursuant	qobellang; 
pursue	qobella; 
pursued	qobeletse; 
pursuing	qobellang; 
pursuit	qobello; 
push	sututsa; 
put	beha; 
puts	beha; 
putting	behang; 
qualification	 boithutelo; lengolo la thuto; 
qualifications	lengolo (mangolo) a thuto; 
qualified	rutehile; 
qualify	 ho tshwanela;  ho phunyeletsa;  kgetha; boleng; 
qualifying	 ho tshwanela;  ho phunyeletsa;  kgetha; boleng; 
qualitative	hlalosang kapa le kgethang; 
qualities	boleng; 
quality	boleng; 
quantity	bokakang;  bokaakang; 
quarter	kotara;  kgwedi-tharo; 
quarterly	ka kotara le kotara; 
quarters	dikotara; 
queen	mofumahadi; 
queries	boipelaetso; 
quest	ho batla ka thata; 
question	potso; 
questioned	 botsitse; potso; 
questionnaire	lenane la dipotso; 
questionnaires	lenane la dipotso; 
questions	potso; 
quickly	ka potlako; 
quinine	kwinine; 
quite	 tiiso; toboketso; 
quorum	khoramo; 
quotation	qotso; 
quotations	qotso; 
quote	khouta; 
race	 lebelo;  peiso;  morabe;  ho beisa; mofuta; 
races	merabe; 
racial	semorabe; 
racism	kgethollo ya morabe; 
radio	 selaolamaqhubu;  radiyo;  seyalemoya; radio; 
raid	tlhaselo; 
rail	sefole; 
railway	 ditereneng; seporo; 
rain	 ho na; pula;  pula e a na; 
rainbow	mookodi; 
rainfall	pula; 
raise	phahamisa; 
raised	phahamisa; 
raises	phahamisa; 
raising	phahamisa;  phahamisang; 
rally	pitso; 
rand	ranta; 
range	paka;  ho ka fihlelwang; 
ranges	paka; tekanyo;  ho ka fihlelwang; 
ranging	paka; tekanyo;  ho ka fihlelwang; 
rank	 hlahlamisa ka maemo; maemo; 
ranks	 dikgato;  mehato; maemo; 
rape	 beta;  ho beta;  -beta; peto; 
rapid	 phorohlo;  phororo; potlakang; 
rapidly	potlako; 
rare	ke ya sewelo;  ha e fumane; 
rate	lebelo;  lebelo la tswelopele; 
rates	sekepele; 
rather	mpa; 
ratification	netefatsa;  tiisa; 
ratified	tiisitse;  netefaditse; 
rating	beha boemong bo itseng; 
ratings	beha boemong bo itseng; 
ratio	kabo;  reshio; 
rationalisation	mohopolo;  monahano; 
raw	tala; 
re	malebana le; 
reach	fihlella; 
reached	fihleletse; 
reaching	fihlellang; 
read	bala; 
reader	mmadi; 
readers	mmadi; 
readily	lokile; 
readiness	ho loka; 
reading	palo;  ho bala; 
ready	lokile; 
reaffirm	netefatsa;  dumela;  tiisa;  amohela hape; 
real	ya nnete; 
realise	fumana; 
realised	hlokometse; 
realising	hlokomelang; 
realities	 bojwalo; tlhaho;  dinnete; 
reality	 bojwalo;  tlhaho; nnete; 
realization	tlhokomelo; 
realize	hlokomela; 
really	ka nnete; 
reason	 ho hlahisa lebaka; lebaka; 
reasonable	utlwahala; 
reasonably	ka kutlwisiso; 
reasons	 ho hlahisa lebaka; mabaka; 
reburial	polokopoeletso; 
recall	ho tlosa setulong; 
recapitalisation	thuso ya tefello; 
receipt	 resiti; rasiti; 
receipts	 resiti; rasiti; 
receive	amohela; 
received	 amohetse; amohela; 
receives	amohela; 
receiving	amohela; 
recent	ya jwale; 
recently	ha jwale; 
reception	kamohelo; 
recession	 mathata a kgwebo; kgaello ya kgwebo;  phokolo ya kgwebo; 
recipient	moamohedi; 
recipients	baamohedi; 
reclaim	buseletsa;  qosa hape; 
recognise	 dumela; amohela; 
recognised	ananetse; 
recognises	ananela; 
recognising	ananelang; 
recognition	kelello;  temoho; 
recognize	hlokomela; 
recognized	hlokometse; 
recommend	kgothaletsa; 
recommendation	kgothaletso; 
recommendations	dikgothaletso; dipabatso; 
recommended	 kgothaleditse; kgothaletsa; 
recommends	kgothaletsa; 
reconciliation	poelano; 
reconstruction	kahobotjha; 
record	 ho beha; rekoto;  bukaphahlo;  -ngola; 
recorded	 ho beha;  ngotse; rekoto;  bukaphahlo;  -ngola; 
recording	kgatiso; 
records	 ho beha; direkoto;  direkoto; Dibukaphahlo;  -ngola; 
recover	kgutlisa; 
recovered	 kgutlisitse;  hlaphohetswe; kgutlisa; hlaphohelwa; 
recovery	 ho fola; nyoloha; 
recreation	phomolo;  ntjhafatso;  boithabiso; 
recreational	ya boithapollo; 
recruitment	patlisiso;  thaotho; 
rectify	lokisa; 
recycling	 tshebedisopheto ya metsi; tshebedisopheto; 
red	kgubedu; 
redistribution	kabobotjha; 
redress	tokisobotjha; lokisa; 
reduce	 fetolela; fokotsa; 
reduced	 fetolela;  fetoletse; fokotsa; 
reducing	 fokotsang;  fetolela; fokotsa; 
reduction	phokotseho; 
reductions	phokotseho; diphokotseho; 
refer	fetisetsa; 
reference	phetisetso; 
references	 phetisetso; mehlodi; 
referral	phetisetso; 
referred	fetiseditse; 
referring	fetisetsang; 
refers	fetisa; 
refined	hlwekiswang; 
reflect	bontsha; 
reflected	 bontshitse; bontsha; 
reflecting	bontsha; 
reflection	sesupo;  kgutliso; 
reflective	 senola; bontsha; 
reflects	bontsha; 
reform	 ho ntjhafatsa;  phetolo; ntjhafatso; 
reforms	 dintjhafatso;  ho ntjhafatsa;  phetolo; ntjhafatso; 
refund	kgutlisetsa;  busetsa; 
refurbishment	 ntjhafatso;  tlhabollo; ntlafatso; 
refusal	kgano; 
refuse	 ho hana; tshila; 
refused	 ho hana;  hanne; tshila; 
refuses	 ditshila / matlakala;  ho hana; tshila; 
regard	ananela;  tsotella; 
regarded	 tsoteletse; ananetse; 
regarding	malebana; 
regardless	ho sa tsotellwe; 
regards	ananela;  tsotella; 
regeneration	tlhabollo ya moloko; 
regime	mmuso; 
region	lebatowa; 
regional	setereke;  - lebatowa; 
regions	mabatowa; 
register	rejisetara; 
registered	Rejistara; rejisetara;  ngodisitse; 
registering	Rejistara;  ngodisang; rejisetara; 
registers	rejisetara; rejistara; 
registrar	mongodisi; 
registration	boingodiso; 
registries	bongodisi; 
registry	bongodisi; 
regular	tlwaelehileng;  ka molao;  ka mehla; 
regularly	 tsepamo; kgafetsa; 
regulate	 ho laola; laola; 
regulated	 ho laola; laola; 
regulates	 ho laola; laola; 
regulating	 laolang;  ho laola; laola; 
regulation	molao; 
regulations	molao; 
regulator	 selaodi; molaodi; 
regulators	balaodi;  dilaodi; 
regulatory	e tsamaisang;  e laolang; 
rehabilitation	tsoso; 
rehearsal	boitokiso; 
rehearsals	boitokiso; 
reinforce	matlafatsa; 
reintegration	kenyeletsobotjha; 
reiterate	hlakisa;  toboketsa;  hatella; 
reiterated	 tobokeditse; hlakisitse;  hateletse; 
reject	 sehlahiswa se phoso; hana; 
rejected	 sehlahiswa se phoso; hana;  hanne; 
relate	amana; 
related	tswalana;  ho tswalana;  -amanang; 
relates	amana; 
relating	amanang; 
relations	dikamano; 
relationship	 ho ratana; leloko; 
relationships	dikamano;  maloko;  ho ratana; kamano; 
relative	 babo; leloko; 
relatively	ka palohare; 
relatives	 ba leloko;  babo; leloko; 
release	phatlalatsa; 
released	phatlalatsa; lokolla;  lokolotse; 
releases	phatlalatsa; lokolla; 
relevance	tshwaneleho; 
relevant	nepaneng; 
reliable	tshepahala;  e tshepahalang; 
relief	popeho;  hlaphohelo; 
religion	bodumedi; 
religions	 ditumelo; bodumedi; 
religious	bodumedi;  sedumedi; 
rely	itshetleha;  tshepa; 
remain	sala; 
remainder	ho setseng;  - setseng; 
remained	sala;  setse; 
remaining	sala; 
remains	masalla; 
remand	 ho kgutlisetsa; ho busetsa; 
remarkable	 tsotehang;  kgahlehang; bohehang;  ratehang; 
remarks	dipuo; 
remedies	pheko;  dipheko; 
remedy	pheko; 
remember	hopola;  -hopola; 
remembered	hopola;  hopotse;  -hopola; 
remembrance	mohopolo;  kgopolo;  monahano; 
reminder	kgopotso; 
reminders	dikgopotso; 
remote	hole; 
remove	tlosa; 
removed	tlositse; 
removing	tlosang; 
remuneration	putso; 
rename	reha botjha; 
renamed	reha botjha; 
renaming	reha botjha; 
render	etsa; phethahatsa; fana; 
rendered	entse;  phethahaditse;  fane; 
rendering	 phethahatsang;  fanang; etsang; 
renew	ntjhafatsa; 
renewable	e ntjhafatsehang; 
renewal	ntjhafatso; 
renewed	ntjhafatsa; 
renovations	 ditlhabollo; ditokiso; 
renowned	tummeng;  tsebisahalang; 
rent	rente;  ho hira; 
rental	ya rente; 
repair	lokisa;  tokiso; 
repairs	 ditokiso; lokisa;  tokiso; 
repatriation	kgutlisa;  busetsa;  kgutliso; 
repeat	pheta; 
replace	nkela sebaka; 
replaced	nkela sebaka; kenela; 
replacement	ho nkela sebaka; 
report	pehelo;  tlaleha;  tlaleho;  peho; 
report-back	pehelo;  tlaleho; 
reported	pehelo;  tlaleha;  tlaleho;  peho; 
reporting	pehelo;  tlaleha;  tlaleho;  peho; 
reports	 tlaleha; dipehelo;  peho;  ditlaleho; 
reposition	phetolo ya boemo; 
repositioning	phetolo ya boemo; 
repository	 polokelong; tshireletsong; 
represent	emela;  -emela; 
representation	kemedi;  kemelo; 
representations	dikemedi; dikemelo; 
representative	moemedi; 
representatives	baemedi; 
represented	emela;  -emela; 
representing	emela;  -emela; 
represents	emela;  -emela; 
repressive	kgatello; 
republic	repaboliki; 
republics	direphaboliki; 
request	kopo; 
requested	kopo; 
requester	mokopi; 
requesting	 kopang; kopo; 
requests	dikopo; 
require	batla; 
required	batla; 
requirement	tlhoko; 
requires	batla; 
requiring	batla; 
requisite	 e hlokehang; e batlehang; 
rescue	 -pholosa;  ho pholosa; pholosa; 
research	patlisiso; 
researcher	mofuputsi; 
researchers	bafuputsi; 
reserve	 risefe; boloka; 
reserved	babaletswe;  diresefe; boloketswe;  reseve;  beheleditswe; 
reserves	boloka; 
resident	moahi; 
residents	 moahi; baahi; 
resides	 ahile; dula; 
residing	 ahang; dulang; 
resignation	boitlamollo; 
resilience	 kganano; thibelo; 
resistance	 kganyetso;  ho hanana le moriana; matla; 
resolution	tharollo;  phetho; 
resolutions	 ditharollo; diphetho; 
resolved	rarolla;  rarolotse; 
resolving	rarollang; rarabolla; 
resounding	ya bohlokwa; 
resources	mehlodi; 
respect	 tlhompho; hlompha;  -hlompha; 
respected	 tlhompho; hlompha;  hlomphile;  -hlompha; 
respective	 ya pele; hlomphehang; 
respects	 tlhompho; hlompha;  -hlompha; 
respond	araba; 
responded	araba; 
respondent	moarabi; moikarabelli; 
respondents	baarabi; baikarabelli; 
responding	araba; 
responds	araba; 
responsibilities	boikarabelo; 
responsibility	boikarabelo; 
responsible	ikarabela; 
responsive	 arabang; arabelang; 
rest	phomolo;  letshwao la kgefutso;  -phomola; 
restitution	kgutlisetso ya ditshwanelo tsa lenyalo; 
restoration	polokobotjha; 
restorative	polokobotjha; 
restraint	thibetswe; 
restricted	 haellang; thibetswe; 
restriction	thibelo; 
restrictions	dithibelo; 
restructuring	tlhophisobotjha; 
result	 searolo;  sephetho; karabo;  sepheto; 
resulted	 searolo;  sephetho; karabo; seatiso;  sepheto; 
resulting	 searolo;  sephetho; karabo; seatiso;  sepheto; 
results	 dikarabo;  searolo; seatiso; diphetho; 
retail	thekiso ka bonnyane; 
retain	baballa; 
retained	babaletse; 
retention	paballo; 
retirement	phomolo; 
retrieval	phumano; 
return	kgutlisa;  kgutliso; 
returned	kgutlisitse; 
returns	kgutlisa; 
reveal	senola; 
revealed	senolotse; 
revenue	lekgetho; 
revenues	lekgetho; 
reverse	fapaneng; 
revise	pheta; 
revised	 phetile; pheta; 
revision	 pheto; poeletso; 
revisions	dipoeletso;  pheto; poeletso; 
revitalisation	tsoseletso;  tsosoloso; 
revoke	tsoseletso;  tsosoloso; 
revolution	 revolushene;  phetohelo; potoloho; 
revolutionary	-fetolang;  morevolushenari; 
rhino	kubu; 
rich	ruile; 
right	toka;  le letona;  ka nepo;  tona; 
rightful	nepahetseng; 
rights	ditokelo; 
rise	nyoloha;  ho phahama; 
rising	tsohang; 
risk	kotsi; 
risks	kotsi;  dikotsi; 
river	noka; 
rivers	dinoka; 
road	tsela;  mmila; 
roads	tsela;  mebila; 
robust	matlafetseng; 
rock	lefika; 
rod	 lere; thupa; 
role	seabo; 
role-players	 bankakarolo; baamehi; 
roles	diabo; 
roll	palo;  rolo ya lesela; 
roll-out	tshebetso; 
rolled	palo;  rolo ya lesela; 
rolling	sebetsang;  thetehang;  tswelang pele; 
rollout	tshebetso; 
rolls	theteha; 
room	phaposi; 
rooms	phaposi;  diphaposi; 
root	motso; 
rooted	 tsheheditswe; theilwe;  hlometswe; 
roots	metso;  methapo; 
rose	nyoloha;  ho phahama; 
round	 potetsa;  pinatatelano; tjhitja;  e kgedikwe;  kgedikwe; 
rounded	 potetsa;  pinatatelano; tjhitja;  e kgedikwe;  kgedikwe; 
roundtable	tafole e sedikadikwe; 
route	 ditsela; tsela; 
routes	ditsela; 
routine	tlwaelo;  setepe; 
royalties	ditsiane; 
royalty	tsiane; 
rugby	ragbi; 
rule	 molawana; molao;  rula; 
rules	 melawana; melao;  rula; 
ruling	qeto; 
rulings	qeto; 
run	matha; 
runs	matha; 
rural	naheng;  mahae;  -mahaeng; 
sacred	 -halalelang; halalelang; 
sacrifice	 setjheso; -nehela;  ho intsha sehlabelo; 
sacrifices	ho intsha sehlabelo;  ditjheso;  -nehela; 
sad	-swabileng;  sulafaletswe; 
saddened	halefile; 
sadness	tlhonamo; 
safe	boloka;  bolokehile;  -bolokehileng;  polokelo; 
safeguard	tshireletso; 
safeguarding	tshireletso; 
safety	 boiphemelo; boipaballo; 
said	o itse; 
salaries	 mekgolo; meputso; 
salary	moputso;  mokgolo; 
sale	thekiso; 
sales	dithekiso; 
same	tshwanang; 
sample	 sesupo; sampole; 
samples	 sesupo; disampole;  sampole; 
sampling	 sesupo; sampole; 
sanctions	dikotloqobello; 
sanitation	tshireletso ya setjhaba mafung; 
sap	lero; 
saps	 maro; lero; 
satellite	 sepotapoti; sathalaete; 
satisfaction	kgotsofatso; 
satisfactory	kgotsofatsang; 
satisfied	kgotsofatsa; 
satisfies	kgotsofatsa; 
satisfy	kgotsofatsa; 
save	 -boloka; thiba; 
saving	bolokang;  -boloka;  thiba; 
saw	sakga; 
say	e re; 
saying	e reng; 
says	o re;  e re; 
scale	lekgapetla;  lekgekge;  lekgakgapa;  sekala; 
scarce	qabileng; 
scene	 pono; sebaka;  tema; 
scenes	sebaka;  dibaka;  ditema;  dipono; 
schedule	shejule; 
scheduled	shejule; 
schedules	dishejulo; shejule; 
scheduling	shejule; 
scheme	 ho rera;  moralo wa mosebetsi; tlhohlomiso; 
schemes	 ho rera;  moralo wa mosebetsi; tlhohlomiso; 
scholar	moithuti; 
scholars	baithuti; 
scholarship	thuso ya tjhelete; 
school	sekolo; 
schooling	ho kena sekolo; 
schools	dikolo; 
science	saense; 
sciences	 disaense; saense; 
scientific	-saense; 
scope	bonamo; 
score	dintlha;  hlaba;  ho tshwaya;  sekoro;  pinanangolwa;  ngwapa; 
scorecard	karete ya sephetho; 
scoring	dintlha;  hlaba;  ho tshwaya;  sekoro;  pinanangolwa; nthapapading;  ngwapa; 
scourge	masisapelo; 
screen	 -hlahloba;  fesetere; tshireletso; 
screening	tlhahlobo; 
script	 sebalwa; mohatiso; 
scrutinise	hlokomedisisa; 
scrutinize	hlokomedisisa; 
scrutiny	tekolo;  tjhebisiso; tadimiso;  tlhahlobo; 
sculpture	ho betla; 
sea	lewatlana; 
seal	kwahela; 
sealed	kwahela; sili;  kwahetse; 
search	fuputsa;  batlisisa; 
searched	fupuditse; batlisitse; 
season	sehla; 
seasons	sehla; 
seat	 boreneng; setulo; 
seats	 boreneng;  setulo; ditulo; 
second	tlatsa;  motsotswana;  bobeding; 
secondary	phahameng; 
secondly	ya bobedi; 
secretariat	sekrethariate; 
secretary	 ralefapha; mongodi; 
secretary-general	mongodi-kakaretso; 
section	 karolo ya mosebetsi; karolo; 
sectional	ya karolo; 
sections	karolo;  dikarolo;  dikarolo tsa mosebetsi; 
secure	sireletsa;  bolokehileng; 
secured	sireletsa;  bolokehileng; 
securing	 sireletsang; sireletsa;  bolokehileng; 
securities	 tshireletseho; polokeho;  ditshireletso; 
security	 tshireletseho; polokeho; 
see	bona; 
seeing	bonang; 
seek	batla; 
seeking	batlang; 
seeks	batla; 
seem	bonahala; 
seems	bonahala; 
seen	bone; 
segment	 sekmente; karolwana; 
seizure	kemiso; 
select	kgetha; 
selected	kgethile; 
selection	hlopho; 
self	wena ka bowena; 
self-sufficiency	bowena; 
selfless	ho hloka bowena; 
sell	rekisa; 
selling	rekisa; 
seminar	 seminara; thupello; 
seminars	dithupello;  diseminara; 
send	romela; 
sending	romelang; 
sends	romela; 
senior	e moholo; 
sense	kutlo; 
sensitive	pelohlomohi;  -utlwelang; 
sent	rometse; 
sentence	polelo;  kahlolo;  ahlola;  kotlo; 
sentenced	polelo;  kahlolo;  ahlola;  kotlo; 
sentences	 dikotlo;  polelo;  kahlolo; dipolelo;  dikahlolo;  ahlola;  kotlo; 
sentencing	polelo;  kahlolo;  ahlola;  kotlo; 
separate	 arohanya;  arohane; arola;  arohaneng; 
separated	 arohanya;  arohane; arola;  arohaneng; 
separately	ka ho kgetha; 
separation	kgethollo; 
sequestration	kgapo; 
series	tlhahlamano;  kgokahanyo ya motlakase ka tlhahlamano; 
serious	thohothelo; kotsi;  hlokofetse;  hlokolotsi;  ; 
seriously	ka ho hlokofala;  ka hloko; ka bohlokolotsi; 
serve	 fepa;  -romela;  tsholang; thusa; 
served	 fepile;  rometse;  -romela;  tsholang; thusa; 
serves	 fepa;  -romela; romela;  thusang;  tsholang; 
serving	 fepa;  -romela;  tsholang; thusa; 
set	teka;  sete;  tjheha; 
sets	teka;  sete;  tjheha; 
setting	dikenkeboroto; 
settle	aha;  ahela; 
settled	 lefile;  lokisitse;  rarolotse; hlophisitse; 
settlements	bothibello; bodulo; 
settler	mojaki; 
settlers	bajaki; 
seven	supa; 
several	mmalwa; 
severe	 e matla; ho mpefala; 
sew	 -roka; roka; 
sewing	 moroko;  -roka; roka; 
sex	bong; 
sexual	 ya bong; -ya thobalano; 
sexually	 ka thobalano; ka motabo; 
shall	o tla; 
shape	sebopeho;  bopa; 
shaped	file sebopeho;  fetotse sebopeho; fetotse tjhebahalo; 
shapes	dibopeho;  bopa; 
shaping	popo; 
share	 seabo; karolo;  adimana;  aba; 
shared	 seabo; karolo;  adimana;  aba; 
shareholding	ho ba le seabo; 
shares	dikarolo;  adimana;  diabo;  aba; 
sharing	 seabo; karolo;  adimana;  aba; 
sharks	dishaka; 
sharp	motsu;  sefapano; 
she	yena; 
shed	sola;  sekiri;  mokgorwana; 
shedding	sola;  sekiri;  mokgorwana; 
sheet	 lakane; leqephe;  lekapa; 
sheets	 makapa; maqephe;  dilakane; 
shelter	setshirelo; 
sheriff	mophethahatsi wa tsa lekgotla; 
sheriffs	baphethahatsi ba tsa lekgotla;  mophethahatsi wa tsa lekgotla; 
shifted	thifi; 
shifting	thifi; 
shifts	 thifi; ditjhafo; 
ship	sekepe; 
shipping	diketswaneng; 
ships	sekepe;  diketswana; 
shock	letswalo;  letshoho; 
shocked	letswalo;  letshoho; 
shocks	letswalo;  letshoho; 
shop	lebenkele; 
shopping	theko mabenkeleng; 
shops	mabenkele; 
shore	lebopo; 
shores	mabopo; 
short	kgutshwane; 
shorter	kgutshwane; 
shortly	haufinyana; 
shot	letolo; 
should	o lokela; 
shoulders	mahetla; 
show	bontsha; 
showcase	 senola; bontsha; 
showcasing	pontsho;  tshenolo; 
showed	 bontshitse; bontsha; 
showing	bontshang; 
shown	bontsha; 
shows	bontsha; 
side	letswapo; 
sign	 tshupo;  saena; letshwao; 
signal	 leqhubu; tlhokomediso;  hlokomedisa;  ho bontsha; 
signals	 maqhubu;  leqhubu; tlhokomediso;  hlokomedisa;  ho bontsha; temosi; 
signature	tshaeno; 
signed	 tshupo;  saena; letshwao; 
significance	bohlokwa; 
significant	ya bohlokwa; 
significantly	ka bohlokwa; 
signifies	bontsha; 
signing	matshwao;  tshupo;  saena; 
signs	matshwao;  tshupo;  saena; 
silver	silivera; 
similar	 tshwana; tshwanang; 
similarly	ka ho tshwana; 
simple	bonolo;  nolo; 
simply	ka bobebe; 
simultaneously	ka nako e le nngwe; 
since	esale; 
sincere	 e hlomphehang; e tshepehang; 
sincerely	ka botshepehi; 
sing	-bina; 
singer	sebini; 
singing	binang; 
single	nngwe; 
sit	dula; 
site	setsha; 
sites	ditsha; 
sitting	kopano; 
sittings	dikopano; 
situated	ho bea; beile; 
situation	 bodulo; maemo; 
situations	 madulo; maemo; 
six	tshelela; 
sixth	karolo ya botshelela; 
size	 saese; boholo; 
skill	 boitsebelo;  botsebi; bokgoni; 
skilled	nang le boitsebelo; 
skills	 boitsebelo;  botsebi; bokgoni; 
slave	lekgoba; 
slavery	bokgoba; 
slaves	makgoba; 
slightly	hanyenyane; 
slip	tjhophoha;  -thella; 
small	nyenyane; 
small-scale	hanyenyane;  tekanyetso e nyenyane; 
smaller	nyenyane; 
so	ka tsela e jwalo; 
so-called	 e tsejwang e le; e bitswang;  eo ba reng ke; 
soccer	sokha;  bolo ya maoto; 
social	ya setjhaba; 
socially	ka setjhaba; 
societal	ya setjhaba; 
societies	 phedisano;  ditjhaba;  diphedisano; mekgatlo; 
society	 phedisano;  mokgatlo; setjhaba; 
socioeconomic	ya moruo wa setjhaba; 
soil	mobu; 
solar	-letsatsi; 
sold	rekisa; 
soldiers	masole; 
sole	bohato; 
solely	ka ho qolleha; 
solid	 sesahlaphoheng; e thata;  bokaqa;  sekaqa; 
solution	tharollo;  motswako;  mokedikedi; 
solutions	ditharollo; qhibidihi;  metswako;  mekedikedi; 
some	ba bang; 
someone	e mong; 
something	e nngwe; 
sometimes	ka nako e nngwe; 
somewhat	ekaba; 
son	mora; 
song	pina; 
songs	dipina; 
soon	 haufinyana; kapele;  ka potlako; 
sophisticated	e maranrang; e rarahaneng;  e tswakaneng; 
sort	kgetha; 
sought	fumane; 
soul	moya; 
souls	moya; 
sound	 phetseng; modumo; 
sounds	phetseng;  medumo; 
sources	mehlodi; 
sourcing	mohlodi; 
south	 ya borwa; borwa; 
southern	ya Borwa; 
space	sebaka;  sepakapaka; 
spaces	sebakana; 
spatial	ya sebaka; 
speak	bua; 
speaker	sepikara; 
speakers	dipikara; 
speaking	bua; 
speaks	bua; 
spear	lerumo; 
special	 kgethehileng; itseng;  -ikgethang; 
specialised	e ikgethileng; 
specialist	setsebi; 
specially	ka ho qolleha; 
species	leloko; 
specific	toboketsang; 
specifically	 ka ho qolleha; ka ho ikgetha; 
specification	pehelo; 
specifications	pehelo; 
specified	totobatsa; 
specify	totobatsa; 
specimen	 sesupiso; tshupiso; 
specimens	ditshupiso; 
spectacular	 kgabane; babatsehang; 
spectrum	ponahalo yohle; 
speech	puo;  polelo; 
speeches	 polelo; dipuo; 
speed	lebelo;  sekaja; 
speedy	kapele;  ka potlako; 
spend	sebedisa; 
spending	sebedisa; 
spent	 rekile ka; senyehetswe; 
sphere	 kgidikwe; bolo; 
spheres	kgidikwe;  dibolo; 
spirit	moya; 
spiritual	 -moya; moya;  semoya; 
split	 petsola; arola; 
spoken	bua;  buile; 
sports	dipapadi; 
spouse	molekane; 
spouses	balekane; 
spread	phatlalla;  hasanya; 
square	 matleng a bobedi;  arola ka dikwere; lebala;  sekwere; 
stabilise	tsitsisa; 
stability	botsitso; 
stable	lesaka; 
stadium	setadamo; 
stadiums	ditadiamo; 
staff	melangwana; 
stage	 kalana;  sethala; mohato; 
stages	 dikalana;  sethala; mehato; 
staging	boemo ba lefu ho ya ka mekgahlelo; 
stakeholder	moamehi;  mothahaselli; 
stakeholders	 mothahaselli; baamehi; 
stalwart	motshepuwa; 
stalwarts	batshepuwa; 
stamp	setempe; 
stance	ntlhakemo; 
stand	setshehetsi;  methati; 
standard	 kemo; sehlopha; 
standardised	ya tlwaelo; 
standardization	tlwaelo; 
standards	dihlopha; kemo; 
standing	setshehetsi;  methati; 
stands	ditshehetsi; methati; 
stanza	temana; 
star	naledi; 
stars	dinaledi; 
start	qala; 
started	qala; 
starting	qala; 
starts	qala; 
state	 boemo;  mmuso; naha; 
state-owned	ruilwe ke mmuso;  laolwa ke mmuso; 
stated	 boemo;  mmuso; naha; 
statement	 tokodiso; polelo; 
statements	hlohlomiso; 
states	 dinaha;  mebuso; boemo; 
stating	 boemo;  mmuso; naha; 
station	seteishene; 
stations	diteishene; 
statistical	ya dipalopalo; 
statistician-general	radipalopalokakaretso; 
statistics	dipalopalo;  palopalo; 
statue	seemahale; 
stature	 boemo;  seemo; maemo; 
status	 boemo;  seemo; maemo; 
statute	molao; 
statutes	molao;  melao; 
statutory	ya molao; 
steadily	butlebutle; 
steady	-tsepameng; 
steal	-utswa; 
steel	tshepe;  tshepe ya setala; 
steer	ho kganna; 
steering	ho kganna; 
step	 setepe; mehato;  mohato; 
steps	 ditepe; mehato; 
sterling	 e ipabotseng; e babatsehang;  e kgahlehang; 
still	ho kokobetsa; 
stimulate	tsosa; 
stimulating	tsosa; 
stipulate	hloma; 
stipulated	hloma; 
stock	 phahlo;  mehlape; mofuta; 
stolen	utswitse;  -utswa; 
stone	tholwana; 
stood	setshehetsi;  methati; 
storage	polokelo; 
store	boloka;  ho boloka;  polokelo; 
stored	boloka;  bolokile;  ho boloka;  polokelo; 
stories	dipale; 
storm	sefefo; 
story	pale; 
storyteller	mophetapale; 
storytellers	baphetapale; 
storytelling	ho etsa tshomo; 
strategic	ka bohlale; 
strategies	mekgwa;  mawa; 
strategy	lewa; 
stream	molatswana; 
streams	melatswana; 
street	tsela;  seterata; 
streets	tsela;  diterata; tobeketso; 
strength	matla; 
strengthen	matlafatsa; 
strengthened	matlafaditse; 
strengthening	 matlafatsang; tiisang; 
stress	 ho sithabela; ho toboketsa; 
strict	qophellang; 
strides	mekutu; 
strike	seteraeke; 
string	 senare; thapo; 
strip	 hlobodisa; sekgetjhana;  motjeketlana; 
strips	 sekgetjhana; motjeketlana;  hlobodisa; 
strive	leka; 
striving	leka; 
strong	matla; 
stronger	matla haholwanyane; 
strongly	ka matla; 
struck	 otla ka nepo; seteraeka; seteraeke; 
structural	ya sebopeho; 
structure	 sebopeho;  popeho; moralo; 
structured	 sebopeho;  popeho; radile; moralo; 
structures	 popeho;  dibopeho; moralo; 
struggle	ntwa;  -hula ka thata;  ho raharaha; 
struggles	dintwa;  -hula ka thata;  ho raharaha; 
struggling	ntwa;  -hula ka thata;  lwana;  ho raharaha; 
student	moithuti;  morutwana; 
students	baithuti;  barutwana; 
studies	boithuto; 
studios	diphaposi-kgasetso ditudiyo; 
study	boithuto; 
style	 setaele; mokgwa;  lenono la mmamodula; 
sub	nyenyane; 
sub-item	 kutwana; kutunyana; 
sub-programme	lenaneo le lenyenyane; 
sub-regulation	molawana; 
subject	 serutwa; mofo; 
subjected	 serutwa; mofo; ipea tlasa molao;  ikobetse molao; 
subjects	bafo;  ipea tlasa molao; dirutwa; 
submission	kgothaletso; 
submissions	 dikgothaletso; kgothaletso; 
submit	 dumela; romela;  inehela;  nyehela; 
submitted	 nyehetse;  inehetse;  rometse; dumetse; 
submitting	 romelang; dumelang;  nyehelang;  inehelang; 
subparagraph	seratswana; 
subpoenaed	 taelo ya lekgotla; tagafara; pitso ya kgotla; 
subscribe	ingodisa; 
subscribed	ingodisitse; 
subsection	temana; 
subsections	temana; 
subsequent	latelang; 
subsequently	hamorao; 
subsidiary	fokolang;  nyenyane; 
subsidies	 seabo; thuso;  diabo; 
subsidy	 seabo; thuso; 
subsistence	tshehetso; 
substance	 ka eng; ntho;  nthwana; 
substances	 ka eng;  nthwana; dintho; 
substantial	kgolo;  ngata; 
substantially	kgolo;  ngata; 
substitute	 kemedi;  ho emela; emela; 
substituted	mothibasekgeo;  kemedi;  ho emela; emela; 
substitutes	 emela; mothibasekgeo;  kemedi;  ho emela; baemedi; 
substituting	mothibasekgeo;  kemedi;  ho emela; emela; 
substitution	ho thiba sekgeo; 
subtropical	sekateropiki; 
succeed	-hlahlama; 
succeeded	-hlahlama; 
success	katleho; 
successes	dikatleho; 
successful	atleha; 
successfully	ka katleho; 
succession	tatelano; 
successor	mohlahlami; 
such	jwalo; 
suffer	sokola; 
suffered	sokotse; 
suffering	tshotleho; 
sufficient	-lekaneng; 
sufficiently	ka tekano; 
sugar	tswekere; 
suggest	ho hlahisa; 
suggested	hlahisitse;  ho hlahisa; 
suggestion	mohopolo;  kakanyetso; 
suggestions	mohopolo;  ditshisinyo;  kakanyetso; 
suggests	ho hlahisa; 
suitable	tshwanetseng; 
suitably	ka ho tshwaneleha; 
sum	 karabo; kopano; 
summary	kgutsufatso; 
summer	hlabula;  lehlabula; 
summit	 tlhoro; samiti; 
summits	 samiti; ditlhoro; 
summoned	bitsitse; 
summons	samane; 
sun	letsatsi; 
sung	binne; 
superior	phahametseng; 
supervisees	balebelwa; 
supervision	tlhokomelo; 
supervisory	ya tebelo;  ya bolebedi; 
supplement	tlatsetso;  setlatsetso; 
supplementary	tlatseletsang; 
supplied	dihlokwa;  fepetse;  thepa; fana;  fepela; 
supply	 thepa; fana;  fepela; 
support	 -tshehetsa;  setshehetsi;  -hlokomela; tshehetsa; 
supported	 -tshehetsa;  setshehetsi;  -hlokomela; tshehetsa; 
supporting	 -tshehetsa;  tshehetsang;  setshehetsi;  -hlokomela; tshehetsa; 
supportive	 thusang; tshehetsang; 
supports	ditshehetsi;  -tshehetsa;  -hlokomela; tshehetsa; 
supposed	loketse; 
supreme	kgolo;  phahame; 
sure	ya nnete; 
surely	ka nnete; 
surface	bokahodimo;  ho fala; 
surplus	masalla; 
surrounding	ho potoloha; 
surveillance	tekanyo; tekolo;  tlhahlobiso; 
survey	phuputso; 
surveys	dipatlisiso;  phuputso; 
survival	ho phela; 
survive	phela;  -phela; 
surviving	phela;  -phela;  phelang; 
suspect	 mmelaellwa; belaela; 
suspected	belaelletswe; belaetse; 
suspects	babelaellwa, belaela; 
suspend	emisa;  leketlisa;  -emisa; 
suspended	emisa;  leketlisa;  emisitse;  -emisa; 
suspension	dileketli;  kemiso;  tshwarello;  mokedikedi o hlokohlwang;  teketliso; 
suspensions	ditshwarello; dikemiso;  tshwarello;  dileketli;  mokedikedi o hlokohlwang;  teketliso; 
sustain	tshwarella; 
sustained	tshwarella; 
sustaining	tshwarella; 
swear	ikana;  hlapaola; 
swearing	ikana;  hlapaola; 
switch	-switjha;  switjhi; 
sworn	 hlapantse; kano;  ikanne; 
symbol	sesupo; 
symbolic	ya seemela; 
symbolically	ka seemela; 
symbolises	emela; 
symbolism	kemelo; 
symbols	ditshupo; disupo; 
symposium	dipuisano; 
symptom	 letshwao la tshwaetso; letshwao; 
symptoms	matshwao;  letshwao la tshwaetso;  letshwao; 
system	tsela;  hlohlomelo;  mokgwa; 
systematically	ka hlohlomiso; 
systemic	ya tshebetso; 
systems	tsela;  hlohlomelo;  mekgwa; 
table	 tafole;  theibole; lenane; 
tabled	 tekile tafole/entse theibole;  tafole;  theibole; lenane; 
tables	 tafole;  theibole;  ditheibole; lenane; 
tabling	ho teka; 
tackle	ho lwanela bolo; 
tags	ditheke; 
takeover	 okamela; feta; 
taking	nkang; 
tale	pale; 
talent	 talenta;  neo; talente; 
talented	-nang le talente; 
talents	dineo;  ditalente; 
tales	dipale; 
talk	bua; 
talking	buang; 
talks	bua; 
tall	lelele; 
tap	 ho kokota; pompo; 
tape	theipi; 
target	tabatabelo; 
targeted	tabatabelo; 
targeting	tabatabelo; 
targets	ditabatabelo;  tabatabelo; 
tariff	tharifi; 
tariffs	tharifi; 
task	mosebetsi; 
tasked	mosebetsi; 
tasks	mesebetsi; 
taught	ho ruta; 
tax	lekgetho; 
taxable	 e ka lefiswa lekgetho; ya lekgetho; 
taxation	lekgetho; 
taxed	lekgetho; 
taxes	 makgetho; lekgetho; 
taxi	tekesi;  tekisi; 
taxpayer	molefi wa lekgetho; 
taxpayers	balefi ba lekgetho; 
teach	ho ruta; 
teacher	mosuwe; 
teachers	mesuwe; 
teaching	thuto; 
team	sehlopha; 
teams	dihlopha; 
teaser	motloki; 
technical	-tekgeniki; 
technicians	mothekeniki; 
technique	 mokgwa botsebi;  bokgoni bo ikgethang; botsebi; 
techniques	 mokgwa botsebi;  bokgoni bo ikgethang; botsebi; 
technological	-thekenoloji; 
technologies	theknoloji; 
technology	theknoloji; 
telecommunication	dipuisano tsa dikgokahano; 
telecommunications	dikgokahano tsa mehala;  dikgokahanyo tsa mehala; 
telephone	 fonofono;  thelefounu; mohala;  ho otla mohala; 
tell	bolella; 
telling	phetelo; 
tells	 phetela; tsebisa;  bolella;  jwetsa; 
temporarily	nakwana; 
temporary	nakwana; 
ten	leshome; 
tend	o tlwaetse; 
tendered	thentare; 
tenders	dithendara; 
tension	 ho menya;  ho tiya; tsitsipano; 
tenure	nako; 
term	 lereo; nako;  kotara; 
terminate	qetella; fedisa; 
terminated	 qeteletse; fedisitse; 
termination	phediso; qetello; 
terminology	mareo; 
terms	melawana; 
terrestrial	lefatsheng; 
territorial	ya taolo ya sebaka; 
territories	 dinaha; naha;  haha; 
territory	naha;  haha; 
terrorism	boferekanyi; 
terrorist	moferekanyi; 
tertiary	thuto e phahameng; 
test	 hlahlobo;  teko; leka;  ho hlahloba;  -etsa teko; 
tested	 hlahlobo;  teko; leka;  ho hlahloba;  entse teko;  -etsa teko; 
testimony	bopaki; 
testing	 hlahlobo;  teko; leka;  ho hlahloba;  -etsa teko; 
tests	 hlahlobo;  teko;  diteko; leka;  ho hlahloba;  -etsa teko; 
text	temana;  tse ka hare; 
than	ho feta; 
thank	leboha; 
thanks	diteboho; 
that	eo; 
that's	e leng; 
the	ke; 
theater	 sethala;  theyetha; thiyetha; 
theatres	 thiyetha; theyetha; 
theft	boshodu; 
their	ya bona; 
them	bona; 
theme	pina ya mokotaba; 
themes	dipina tsa mookotaba; 
themselves	ka bobona; 
then	jwale; 
theory	tsebo; 
therapy	kalafo; 
there	moo; 
thereafter	kamora; 
thereby	e le hore; 
therefore	ka hoo; 
therein	moo; 
thereof	ya yona; 
thereon	hodima moo; 
thereto	moo; 
thereupon	hodima moo; 
therewith	ka moo; 
these	tsena; 
they	bona ba; 
thing	ntho; 
things	dintho; 
think	nahana; 
thinking	nahanang; 
third	nngwe borarong; 
thirdly	ya boraro; 
thirds	nngwe borarong; 
this	hona; 
thorough	nepisisa; 
those	bao; 
though	leha; 
thought	nahana; 
thoughts	 dikgopolo; mehopolo;  menahano; 
thousand	sekete; 
thousands	dikete; 
threat	tshoso; 
threaten	tshosa; 
threatened	tshosa;  tshositse; 
threats	ditshoso; 
three	tharo; 
three-day	letsatsi la boraro; 
three-year	dilemo tse tharo; 
threshold	bonnyane tshehetsong; 
thriving	ipabolang; 
through	kenya; 
throughout	ka hohlehohle; 
thus	ka hona; 
ticket	tekete; 
ticketing	 fana ka ditekete; tekete; 
tickets	ditekete; 
tie	 lekana; kopano; 
tiers	tatelano ka bophahamo; 
ties	 lekana; dikopano; 
till	ho fihlela; 
time	nako; 
timeframes	dinako; 
timely	ka nako; 
times	atisa; 
tirelessly	ka nako tsohle;  ka ntle ho phomolo; 
title	thaetlele; 
titled	filwe sehlooho; 
titles	dithaetlele; 
to	ho; 
tobacco	kwae; 
together	hammoho; 
toilet	 pitsana; ntlwana; 
toilets	 pitsana; ntlwana; 
told	 boleletse;  jwetsitse; tsebisitse; 
tolerance	mamello; 
tomorrow	hosane; 
tonight	bosiu bona; 
tonnage	ditone tse ka jarwang; 
tons	tone; 
too	le bona; 
tool	sesebediswa; 
toolkit	mokotlana wa disebediswana; 
tools	dithulu;  sesebediswa; disebediswa; 
top	 kgahla; hodimo; 
topic	sehlooho; 
topics	dihlooho; 
total	yohle; 
totalled	kaofela; yohle; 
touch	thetso; 
tough	matla; 
tour	bohahlaudi; 
touring	hahlaulang; 
tourism	bohahlaudi; 
tourist	motsamai;  mohahlaudi; 
tourists	bahahlaudi;  motsamai;  mohahlaudi; 
tournament	tlhodisano;  thonamente; 
tournaments	 dithonamente; ditlhodisano; 
tours	bohahlaudi;  maeto; 
toward	malebana le; 
towards	malebana le; 
town	toropo; 
towns	ditoropo; 
township	lekeishene; 
townships	makeishene; 
toy	sebapadiswa; 
trace	 sesupo; fumana;  ho latela mohlala;  batlisisa;  sehella; 
track	tsela;  mohlala;  seporo; 
trade	mosebetsi;  -hweba;  ho sebetsa;  kgwebo; 
trading	ho hweba; 
tradition	 moetlo; setso;  neanotaba; 
traditional	-moetlo;  tsa baholoholo; 
traditionally	ka setso; 
traditions	 meetlo; setso;  neanotaba; 
traffic	sephethephethe; 
trafficking	sephethephethe; 
tragedy	terama ya masisapelo; 
tragic	mahlomola; 
train	terene;  tataisa; 
trained	 tataisitse; terene; 
training	tataiso; 
transaction	kgwebo; 
transactions	 kgwebisano; kgwebo; 
transfer	 phetisetso;  suthisa; fetisetsa;  paterone e hatisetswang; 
transferred	tshutiso;  phetisetso;  suthisa; fetisetsa;  paterone e hatisetswang; 
transferring	tshutiso;  phetisetso;  suthisa; fetisetsa;  fetisetsang;  paterone e hatisetswang; 
transfers	 phetisetso;  suthisa; fetisetsa; diphetisetso;  tshutiso;  paterone e hatisetswang; 
transform	fetola; 
transformation	phetoho; 
transformed	fetotse; 
transforming	fetolang; 
transition	phetoho; 
transitional	fetohelang ho; 
translate	fetolela; 
translated	fetoletse; 
translation	phetolelo; 
translator	mofetoledi; 
translators	mofetoledi; 
transmission	tshwaetso;  phethiso ya matla a letsatsi;  phetiso; 
transmit	 ho fetisa lefu; fetisa;  hasa; 
transmitted	tshwaetsa;  tshwaeditse;  ho fetisa lefu; fetisa;  hasa;  fetisitse; 
transparency	ponaletso; 
transparent	bonaletsa;  -bonaletsang; 
transport	 sepalangwang; tsamaisa; 
transportation	thotho; 
travel	-eta; 
travelled	hahlautse; 
travelling	hahlaulang; 
treasure	letlotlo; 
treasures	matlotlo; 
treasuries	matlotlo; 
treasury	matlotlo; 
treat	tshwara;  -alafa; 
treated	tshwara;  -alafa; 
treaties	 phomosetsa; ditumellano; 
treatment	kalafo; 
treaty	 phomosetsa; tumellano; 
tree	sefate; 
trees	difate;  sefate; 
trend	ka tlwaelo; 
trends	ka tlwaelo; 
trial	 teko; nyewe; 
trials	 teko; dinyewe;  nyewe; 
tried	lekile; 
triple	menahanya hararo; 
trophy	mohope; 
truly	ka nnete; 
trust	 -tshepa; tshepa; 
trustee	mmoloko wa matlotlo; 
trustees	baboloki ba matlotlo; 
trusts	 -tshepa; tshepa; trust; 
truth	nnete; 
try	leka; 
trying	lekang; 
turfs	jwang; 
turnaround	fetoha; 
turning	ho kenya; 
turnover	fetola; 
twelve	leshome le metso e mmedi; 
twentieth	ya mashome a mabedi; 
twice	habedi; 
two	pedi; 
two-day	matsatsi a mabedi; 
two-thirds	bobedi borarong; 
type	 tlanya; mofuta; 
types	 tlanya; mefuta; 
typically	ka botebo;  e le ka nnete; 
ultimate	qetello; 
ultimately	qetellong; 
unable	ha o kgone; 
unacceptable	ha e amohelehe;  ha e amohelwe; 
unauthorised	e sa dumellwang; 
uncertainty	ho hloka tshepo;  ho hloka bonnete; 
unconstitutional	-seng molaong wa motheo; 
under	tlasa; 
underdevelopment	tswelopele e fokolang; 
undergo	nyahamisa; 
undermine	 nyedisa; nyefola;  halala; 
underpin	 matlafatsang; tiisang; 
understand	utlwisisa; 
understood	utlwisisa; 
undertake	feta; 
undertaken	 amohetse; phetahaditse; fetile; 
undertaking	boikarabelo;  mosebetsi; 
undertook	nkile; itjarisitse; 
underwater	tlasa metsi; 
underway	tlasa tsela; 
undue	e sa tshwanelang; 
unfair	e sa kgotsofatseng; 
unfortunately	ka bomadimabe; 
unhappy	hloname; 
unified	kopanya; 
uniform	 seaparo se tshwanang;  yunifomo; tshwanang; 
union	kopano;  kapano; 
unions	kopano;  dikopano; 
unique	ikgethile;  -ikgethileng; 
unit	 motso; bonngwe; 
unitary	bonngwe; 
unite	bonngwe; 
united	-kopaneng; 
units	 diyuniti; bonngwe; 
unity	kopano; 
universal	ya hohle; ya kakaretso;  ka lefatshe lohle; 
universe	lefatshe lohle; 
universities	diyunivesithi; diyunebesiti; 
university	yunivesithi; 
unknown	e sa tsejweng; 
unleash	lokolla;  ; 
unless	haese; 
unlike	ka ntle ho; 
unlikely	e ke ke ya etsahala;  ha ho bonahale e ka; 
unnecessary	e sa hlokeheng; 
unprecedented	e sa lebellwang; 
unqualified	e sa tshwaneleng; 
unreasonable	e sa kgotsofatseng; 
unregistered	e sa ngodiswang; 
unsafe	e sa bolokehang; 
until	ho fihlela; 
untold	e sa bolelwang; 
unusual	e sa tlwaelehang; 
unveil	 ho sibolla; ho pepesa; 
unveiled	pepesitse; 
unveiling	pepesang; 
up	hodimo; 
upcoming	e tlang; 
update	tsebisa;  beha leseding; 
updated	tsebisa;  behile leseding; 
updates	ditsebiso; 
upgrade	ntlafatsa; 
upgraded	ntlafatsa; 
upgrades	ntlafatsa; 
upgrading	ntlafatsa; 
uphold	tshwara; 
uploading	phetisetso; 
upon	ka nako eo; 
urban	 -toropong; toropo; 
urge	ho tjheseha; 
urged	ho tjheseha; 
urgency	bohlokwa; 
urgent	ya bohlokwa; 
urgently	ka bohlokwa; 
urges	ho tjheseha; 
us	rona; 
usage	tshebediso; 
use	sebedisa;  tshebediso ya nale;  tshebediso ya sekere; 
used	sebeditse; 
useful	molemo; 
user	mosebedisi; 
users	basebedisi; 
uses	sebedisa;  ditshebediso tsa nale;  tshebediso ya sekere; 
using	sebedisa;  ditshebediso tsa sekere;  tshebediso ya nale; 
usually	ka mehla; 
utilisation	tshebediso; 
utilise	sebedisa; 
utilised	sebedisitse; 
vacancies	dikgeo; 
vacancy	sekgeo; 
vacant	 ha e na letho; feela; 
valid	tshwanelehang;  amohelwang; 
validity	 ho ba molaong; matla-; 
valley	kgohlo; 
valuable	e bohlokwa; 
valuation	bohlokwa; 
value	 molemo; boleng; 
valued	 molemo; boleng; 
values	metheo ya boitshwaro; 
van	vene; 
variation	phapano; 
varied	fapane; 
varies	fapanya; 
variety	mefutafuta; 
various	fapaneng; 
vary	fapanya; 
varying	fapanya;  fapanyang; 
vast	kgolohadi; 
vat	lekgetho; 
vehicle	koloi;  sepalangwang; 
vehicles	 dipalangwang;  dikoloi; dikoloi; makoloi; 
venture	malepa; 
ventures	malepa; 
venue	sebaka; 
venues	dibaka; 
version	 mofuta o mong; mokgwa o mong; 
very	yonayona; 
vessel	 setshelo; sekepe;  mothatswana; 
vested	 thahasellang; thabelang; 
veterans	diqhoku; 
via	ka ho feta; 
viability	ka sebediswa; 
viable	ka sebediswa; 
vibrant	sebediseha; 
vice	 setshwarelli; setlami; 
vice-chairperson	motlatsa-modulasetulo; 
victim	phofu; 
victims	 phofu; diphofu; 
victor	mohlodi; 
video	vidiyo; 
videos	divideo; 
view	pono; 
viewed	pono; 
viewing	pono; 
views	dipono; 
village	motse;  motsana; 
villages	metse;  metsana; 
violation	ho tlola molao; 
violations	ho tlola molao; 
violence	dikgoka;  morusu; 
violent	 ka ntwa; ka kgalefo;  ka disuwa;  ka mosito; 
virtual	sekannete; 
virtually	bonahalang; 
virtue	bohlokwa; 
visa	tokomane ya ho hahlaula; 
visible	e bonahalang; 
vision	pono; 
visionary	tjhebelopele; 
visiting	 tjhakelang; etelang; 
visitor	moeti; 
visitors	baeti; 
visual	-bonwang; 
visually	bonahalang; 
vital	ya bohlokwa; 
vocational	-boiphediso; 
voice	kodu; 
voices	dikodu; 
void	sekgeo;  sebaka se feela; 
volatility	 tubakano; pherekano; 
volume	mothamo;  volumo;  matla a modumo; 
voluntarily	ka boithaopo; 
voluntary	boithaopo; 
volunteer	moithaopi; 
volunteers	baithaopi; 
vote	 -kgetha; kgetho; 
voted	 -kgetha; bouta;  kgethile;  vouto; kgetho; bouto;  vouta; 
voter	 movouti; mokgethi; 
voters	 bavouti; bakgethi; 
votes	 -kgetha; bouta;  divouto; kgetho;  dikgetho; 
voting	ho kgetha; 
vulnerability	ho hloka tshireletso; 
wage	moputso; 
wages	meputso; 
waiting	emetse; 
walk	-tsamaya; 
walks	-tsamaya; 
wall	lebota; 
walls	lebota; 
want	ho batla; 
wanted	batlile;  ho batla; 
wants	batla; 
war	ntwa; 
ward	 phaposi ya bakudi; wate; 
wards	mabatowa;  wate;  phaposi ya bakudi;  diphaposi tsa bakudi; 
warm	futhumetse;  ho futhumetse; 
warmth	mofuthu; 
warning	temoso;  kgalemelo; 
warrant	batla; 
warrants	batla; 
wars	dintwa; 
was	e ne e le; 
waste	 matlakala; ditshila; 
watch	 watjhe; tshupanako; 
water	 ho nosetsa;  nwesa; metsi;  nosetsa; 
waters	 ho nosetsa;  nwesa; metsi;  nosetsa; 
wax	boka; 
way	tsela;  mokgwa; 
ways	mekgwa;  ditsela; 
we	rona; 
we've	 re ne re; re na le; 
weak	-fokolang; 
weakness	bofokodi;  ho fokola; 
weaknesses	bofokodi;  ho fokola;  mefokolo; 
wealth	letlotlo; 
weapon	sebetsa; 
weapons	sebetsa;  dibetsa; 
weather	bolepi;  boemo ba lehodimo; 
web	bolepo ba sekgo; 
websites	diwebosaete; 
week	beke; 
week-long	bolelele ba veke; 
weekend	mafelo a beke; 
weeks	beke; 
weight	 sekadi; boima;  ho kala; 
welcome	amohetswe; 
welcomed	amohetswe; 
welcomes	amohela; 
welcoming	amohelang; 
welfare	paballo ya setjhaba; 
well	sediba; 
well-known	tsebahala haholo; 
wellbeing	boiketlo; 
went	tsamaile; 
were	o ne;  ba ne; 
western	ya bophirimela; 
wetland	sebaka se mongobo; 
wetlands	sebaka se mongobo; 
what	eng; 
what's	ke eng; 
whatever	eng kapa eng; 
whatsoever	ka mokgwa ofe kapa ofe; 
when	neng; 
whenever	ka nako eo; 
where	kae; 
whereas	leha; 
whereby	moo; 
whereupon	moo teng; 
wherever	hohle moo; 
whether	hore na; 
which	efe; 
whichever	efe kapa efe; 
while	ka nako eo; 
whilst	ka nako eo; 
whip	sephadi; 
whips	diphadi; 
white	tshweu; 
whites	tse tshweu; 
who	mang; 
whole	e tletseng; 
wholly	ka hohle; 
whom	motho eo; 
whose	motho eo; 
why	hobaneng; 
wide	batsi;  mohlolohadi; 
widely	ka ho phatlalla;  ka bophara; 
wider	batsi;  mohlolohadi; 
widespread	 namme; hohlehohle;  tletsetletse; 
wife	mosadi; 
wild	hlaha; 
wildlife	diphedi tsa naheng; 
will	o tla; 
willing	 thahasella;  kgothaletse; rata; 
willingness	 tsotello; thahasello; 
win	 -hlola; hlola; 
wind	moya; 
winding-up	 ho ntshetsa pele;  ho thaotha; futhumala; 
window	 fenstere; fensetere; 
wine	beine; 
winners	mohlodi; 
winning	ho hlola; 
winter	mariha; 
wish	takatso; 
wishes	ditakatso; 
wishing	lakatsang; 
with	ka; 
withdraw	hula; 
withdrawal	boikgulo; kgulo; 
withdrawn	hula; 
within	ka hare; 
without	ho sa natswe; ka ntle ho; 
witness	paki; 
witnessed	paki;  pakile; 
witnesses	dipaki; 
woman	mosadi; 
women	basadi; 
women's	ya basadi; 
won	 hlotse;  -hlola; hlola; 
wonderful	 kgahlehang; ratehang; 
wood	 lehong;  lehong la bobetli; patsi; 
word	lentswe; 
words	mantswe; 
work	mosebetsi;  mosebetsi wa bokgabo;  ho sebetsa; 
worked	mosebetsi;  mosebetsi wa bokgabo;  ho sebetsa; 
worker	mosebeletsi; 
workers	basebeletsi; 
workforce	basebetsi; 
working	sebetsang; 
works	mesebetsi;  mosebetsi wa bokgabo;  ho sebetsa; 
workshop	ntlo ya ho sebeletsa; 
workshops	dithupello;  ntlo ya ho sebeletsa; 
workspace	sebaka sa tshebetso; 
world	lefatshe; 
world's	ya lefatshe; 
world-class	boemo ba lefatshe; 
worlds	mafatshe; 
worldwide	ka bophara ba lefatshe; 
worrying	tshwenyang;  kgathatsang; 
worse	mpe haholo; 
worst	mpe ka ho fetisisa; 
worth	 loketse; tshwanela; 
worthy	 loketse; tshwanela; 
would	o tla; 
wound	 ho ntsha madi; leqeba; 
wounds	 ho ntsha madi; maqeba; 
write	ngola; 
writer	mongodi;  sengodi; 
writers	bangodi; 
writers'	ya bangodi; 
writing	 ho ngola; mongolo; 
writings	mengolo;  ho ngola; 
written	 ngodilwe; ngola; 
wrong	fosahetseng; 
wrote	 ngotse; ngola; 
xenophobia	tlhoriso ya melata; 
xenophobic	tlhoriso ya melata; 
year	selemo;  ngwaha; 
year's	ya selemo; 
year-on-year	selemo ka selemo; 
years	dilemo; 
yes	e; 
yesterday	maobane; 
yet	empa; 
you	wena; 
young	ledinyane; 
younger	nyenyane;  ledinyane; 
your	ya hao; 
youth	batjha; 
zero	 zero; noto; 
zone	kgaolo; 
zones	dikgaolo; 
zoo	diphoofolong; 
