Act of Parliament	Molao wa Palamente
Adult Basic Education and Training	Thuto le Thupello ya Motheo ya Batho ba baholo
Africa Institute of South Africa	Africa Institute of South Africa
African American	Moamerika wa Moafrika
African Christian Democratic Party	African Christian Democratic Party
African Cup of Nations	Mohope wa Dinaha tsa Aforika
African Development Bank	African Development Bank
African Diaspora	Baahi ba bang ba Afrika
African Economic Community	Setjhaba sa Kgwebo ya Afrika
African National Congress	ANC
African National Congress Youth League	African National Congress Youth League
African Union	Kopano ya Afrika
African country	Naha ya Afrika
African language	Puo ya Afrika
African nationalist	Moahi wa Afrika
African people	Batho ba Afrika
African renaissance	Ntjhafatso ya Afrika
African state	Puso ya Afrika
African wild cat	qwabi
Agricultural Research Council	Lekgotla la Diphuputso tsa Temo
Ambassador of	Leqosa la
Arts and Culture Trust	Letlole la Bonono le Setho
Bantu Authorities Act	Molao wa Bolaodi ba Batho
Basic Conditions of Employment Act	Molao wa Maemo a Tshebetso
Black Consciousness Movement	BCM
Black Economic Empowerment	Matlafatso ya Kgwebo ya Batho ba Batsho
Board of Directors	Lekgotla la Balaodi
British High Commissioner	Mokomishenare ya Phahameng wa Borithane
Broad-based Black Economic Empowerment Act	Molao wa Matlafatso ya Broad-based ya Kgwebo ya Batho ba Batsho 
Bureau of Heraldry	Bureau of Heraldry
Call of South Africa	Pitso ya Afrika Borwa
Central Energy Fund	Letlole la Bohareng la Matla
Chamber of Mines	Lekgotla la Merafo
Chief Executive Officer	Moofisiri e Moholo wa Phethahatso
Chief Justice	Ratoka e Moholo
Christian Democratic Party	Christian Democratic Party
Civil Rights Movement	Lekgotla la Ditokelo tsa Setjhaba
Coat of Arms	Kola / sefoka
Commission for Conciliation, Mediation and Arbitration	CCMA
Commission for the Promotion and Protection of the Rights of Cultural, Religious	Khomishene ya Phahamiso le tshireletso ya Ditokelo tsa Molao wa motheo wa Afrika Borwa wa Moetlo le Bodumedi
Commission for the Promotion and Protection of the Rights of Cultural, Religious and Linguistic Communities	Khomishene ya Ntshetsopele le Tshireletso ya Ditokelo tsa Ditjhabana ho ya ka Setso, Bodumedi le Puo
Commission on Gender Equality	CGE
Commission on Restitution of Land Rights	Khomishene ya Ditokelo tsa Kgutlisetso ya Naha
Commonwealth of Independent States	Moruo o tshwanang wa Dinaha tse ikemetseng
Congress of Democrats	Mokgatlo wa Didemokrate
Constitution of the Republic of South Africa	Molao wa motheo wa Afrika Borwa
Constitutional Assembly	Asembli ya Molao wa Motheo
Constitutional Court	Lekgotla la Molao wa Motheo
Council for Scientific and Industrial Research	Lekgotla la Diphuputso tsa Mahlale le Indasteri
Council of Ministers	Lekgotla la Matona
Council of Provinces	Lekgotla la Diprovense
Council of Traditional Leaders	Lekgotla la Marena a Botjhaba
Cradle of Humankind	Thari ya botho
Criminal Procedure Act	Molao wa Taolo ya Botlokotsebe
Customs and Excise	Ditlwaelo le phethahatso
Day of Reconciliation	Letsatsi la Poelano
Day of the Covenant	Letsatsi la Selekane
Democratic Alliance	Democratic Alliance
Democratic Party	Democratic Party
Department of Agriculture	Lefapha la Temo
Department of Arts and Culture	Lefapha la Bonono le Setho
Department of Communications	Lefapha la Dikgokahanyo
Department of Correctional Services	Lefapha la Ditshebeletso tsa Tshokollo ya Batshwaruwa
Department of Defence	Lefapha la Tshireletso
Department of Education	Lefapha la Thuto
Department of Environmental Affairs and Tourism	Lefapha la Merero ya Tikoloho le Bohahlaudi
Department of Finance	Lefapha la Ditjhelete
Department of Health	Lefapha la Bophelo bo Botle
Department of Home Affairs	Lefapha la Merero ya  Lehae
Department of Housing	Lefapha la Phumantsho ya Matlo
Department of Justice	Lefapha la Toka
Department of Justice and Constitutional Development	Lefapha la Toka le Ntshetsopele ya Molao wa Motheo
Department of Labour	Lefapha la tsa Mesebetsi
Department of Land Affairs	Lefapha la Merero ya Mobu
Department of National Education	Lefapha la Thuto ya Setjhaba
Department of Public Enterprises	Lefapha la Dikgwebo tsa Setjhaba
Department of Public Service and Administration	Lefapha la Ditshebeletso tsa Setjhaba le Tsamaiso
Department of Public Works	Lefapha la Mesebetsi ya Setjhaba
Department of Science and Technology	Lefapha la Saense le Theknoloji
Department of Social Development	Lefapha la Ntshetsopele ya Setjhaba
Department of Sport and Recreation	Lefapha la Dipapadi le Boikgathollo
Department of State	Lefapha la Mmuso
Department of Trade and Industry	Lefapha la Kgwebisano le Indasteri
Department of Transport	Lefapha la Dipalangwang
Department of Water Affairs	Lefapha la Ditaba tsa Metsi
Department of Water Affairs and Forestry	Lefapha la Merero ya Metsi le Meru
Deputy Speaker	Motlatsi wa Spikara
Deputy Speaker of Parliament	Motlatsi wa Spikara sa Palamente
Development Bank of Southern Africa	Banka ya Ntshetsopele ya Afrika e ka Borwa
Director of Public Prosecution	Molaodi wa Diqoso tsa Dinyewe tsa Setjhaba
Director of Public Prosecutions	Molaodi wa Diqoso  tsa Dinyewe
Dutch East India Company	Khamphani ya India ya Fora Botjhabela
Dutch Reformed Church	Kereke ya Ntjhafatso ya Fora
Eastern Cape	Kapa Botjhabela
Employment Equity Act	Molao wa Tekatekano Mesebetsing
Environmental Impact Assessment	Tekolo ya Sekgahla sa Tikoloho
European Union	Kopano ya Yuropa
Executive Council	Lekgotla la Phethahatso
Financial Services Board	Lekgotla la Ditshebeletso tsa Ditjhelete
Financial and Fiscal Commission	Khomishene ya Tjhelete le Merero ya Ditjhelete
Fire Protection Association	Mokgatlo wa Thibello ya Mollo
First World	Lefatshe la Pele
First World War	Ntwa ya Pele ya Lefatshe
Foundation for Creative Arts	Mohlodi wa Bonono ba Boiqapelo
Free State	Freistata
Free State Stadium	Setadiamo sa Freistata
Freedom Charter	Tokomane ya Tokoloho
Freedom Day	Letsatsi la Tokoloho
Freedom Front	Freedom Front
Gauteng Provincial Government	Mmuso wa Provense ya Gauteng
Government of National Unity	Mmuso wa Naha wa Kopanelo
Group Areas Act	Molao wa Dibaka tsa Dihlopha
Heads of Diplomatic Missions	Balaodi ba Merero ya Diplomatiki
Health Professions Council of South Africa	Lekgotla la Afrika Borwa la Mesebetsi ya Bophelo bo botle
High Court	Lekgotla le leholo la dinyewe
High Court of South Africa	Lekgotla le Phahameng la Afrika Borwa
Horn of Africa	Lenaka la Afrika
House of Assembly	Ntlo ya Pokano
House of Commons	House of Commons
House of Delegates	Ntlo ya Barumuwa
House of Lords	House of Lords
House of Representatives	Ntlo ya Baemedi
Human Rights Commission	Khomishene ya Ditokelo tsa Botho
Human Rights Day	Letsatsi la Ditokelo tsa Botho
Human sciences research	Koporasi ya Ntshetsopele ya Indasteri
Independent Electoral Commission	Khomishene e Ikemetseng ya Dikgetho
Industrial Development Corporation	Ditaba tsa Setjhaba le Ntshetsopele
Information Society and Development	Mokgatlo wa Mesebetsi ya Matjhaba
Inkatha Freedom Party	Inkatha Freedom Party
International Labour Organisation	Mokgatlo wa Mesebetsi ya Matjhaba
International Monetary Fund	Letlole la Dijhelete tsa Matjhaba
International Olympic Committee	Komiti ya matjhaba ya Diolimpiki
International Relations	Dikamano tsa matjhaba
International Telecommunications Union	Kopano ya Dikgokahano tsa mehala ya Matjhaba
Judicial Service Commission	Khomishene ya Ditshebeletso tsa Molao
Labour Relations Act	Molao wa Dikamano Mosebetsing
Land Claims Court	Lekgotla la Dinyewe tsa Ditletlebo tsa Naha
Language Task Group	Sehlopha se Mosebetsi wa Puo
Leader of the House	Moetapele wa Ntlo
Leader of the Official Opposition	Moetapele wa Bohanyetsi wa Molao
Minister of Education	Letona la Thuto
Minister of Justice	Tona la Toka
Minority Front	Minority Front
Municipal Demarcation Board	Lekgotla la Tsheho ya Meedi la Masepala
NCOP Committee	Komiti ya NCOP
Natal Indian Congress	Mokgatlo wa Maindia a Natala
National Agricultural Marketing Council	Lekgotla la Mebaraka ya Temo ya Setjhaba
National Arts Council	Khansele ya Bonono ya Naha
National Arts Festival	Mokete wa Bonono wa Naha
National Assembly	Asembli ya Setjhaba
National Commissioner	Mokomishenara wa Setjhaba
National Council of Provinces	Lekgotla la Naha la Diporovense
National Cultural History Museum	Mosiamo wa Nalane ya Meetlo ya Setjhaba
National Environmental Management Act	Molao wa Taolo ya Tikoloho ya Setjhaba
National House of Traditional Leaders	Ntlo ya Setjhaba ya Marena a Setso
National Intelligence Agency	National Intelligence Agency
National Marketing Council	Lekgotla la Mebaraka ya Setjhaba
National Monuments Council	Lekgotla la Diemahale tsa Setjhaba
National Party	National Party
National Prosecuting Authority	Bolaodi ba Botjhotjhisi ba Naha
National Qualifications Framework	Moralo wa Mangolo a thuto a Setjhaba
National Revenue Fund	Letlole la Tjhelete ya Setjhaba
National Swimming Federation	Mokgatlo wa Setjhaba wa Ho sesa
National Training Board	Lekgotla la Setjhaba la Kwetliso
National Women's Day	Letsatsi la Setjhaba la Basadi
National Youth Commission	Khomishene ya Batjha ya Naha
New National Party	New National Party
Nkosi Sikelel' iAfrika	Nkosi Sikelel' iAfrika
Nobel Peace Prize	Kgau ya Nobel Peace
Northern Cape	Kapa Leboya
Orange Free State	Freistata
Orange River Sovereignty	Orange River Sovereignty
Organisation for African Unity	Mokgatlo wa Kopano ya Afrika
Organisation of African	Mokgatlo wa Afrika
Organisation of African Unity	Mokgatlo wa Kopano ya Afrika
P and L	P and L
Pan Africanist Congress of Azania	Pan Africanist Congress of Azania
Pan South African Language Board	Lekgotla la Dipuo tsohle la Afrika Borwa
People Against Gangsterism and Drugs	Mokgatlo wa batho o kgahlano le Mamulwana le Tshebediso ya Dithethefatsi
Perishable Products Export Control Board	Lekgotla la Taolo ya Thomello ya Dihlahiswa tse Senyehang
Population Registration Act	Molao wa Ngodiso ya Baahi
President of the Senate	Mopresidente wa Senate
Pretoria Art Museum	Mosiamo wa Bonono wa Pretoria
Pretoria East Cemetery	Molao wa Thibelo ya Manyalo a Kopaneng
Prohibition of Mixed Marriages Act	Thibelo ya Molao wa Manyalo a Kopaneng
Provincial Commissioner	Mokomishenara wa Provense
Provincial House of Traditional Leaders	Ntlo ya Provense ya Marena a Setso
Public Administration	Taolo ya Setjhaba
Public Order Policing	Khomishene ya Tshebeletso ya Setjhaba
Public Protector	Motshireletsi wa Setjhaba
Public Service Commission	Khomishene ya Ditshebeletso tsa Setjhaba
Reconstruction and Development Programme	Lenaneo la Ntshetsopele le Kahobotjha
Republic of South Africa	Laeborari ya Afrika Borwa ya Difofu
Reserve Bank	Banka ya Resefe
SA Library for the Blind	Laeborari ya Afrika Borwa ya Difofu
San rock painting	Ditshwantsho tsa mafikeng tsa Ma-San 
Second World War	Ntwa ya Bobedi ya Lefatshe
Secretary to Parliament	Mongodi wa Palamente
Sector Education and Training Authority	Bolaodi ba Mokga wa Thuto le Kwetliso
Skills Development Act	Molao wa Ntshetsopele ya Boitsebelo ba mesebetsi
South African Bureau of Standards	Biro ya Boleng ya Afrika Borwa
South African Chamber of Commerce	Mokgatlo wa Kgwebo wa Afrika Borwa
South African Communist Party	South African Communist Party
South African Constitution	Molao wa motheo wa Afrika Borwa
South African Council of Churches	Mokgatlo wa Dikereke tsa Afrika Borwa
South African Defence Force	Sesole sa Afrika Borwa
South African Human Rights Commission	Khomishene ya Ditokelo tsa Botho ya Afrika Borwa
South African Local Government Association	SALGA
South African National Civic Organisation	Mokgatlo wa Setjhaba wa Kahisano
South African National Defence Force	Ssole sa Naha sa Afrika Borwa
South African National Parks	Dirapa tsa Setjhaba tsa Afrika Borwa
South African Native National Congress	South African Native National Congress
South African Police	Sepolesa sa Afrika Borwa
South African Police Service	Tshebeletso ya Sepolesa ya Aforika Borwa
South African Qualifications Authority	South African Qualifications Authority
South African Reserve Bank	Banka ya Resefe ya Afrika Borwa
South African Revenue Service	Tshebeletso ya Ditjhelete ya Afrika Borwa
South African Secret Service	Tshebeletso ya Mautlwela ya Afrika Borwa
South African Sugar Association	Mokgatlo wa Tswekere wa Afrika Borwa
South African citizen	moahi wa Aforika Borwa
South African design	Moetso wa Afrika Borwa
South African tea	Teye ya Afrika Borwa
Southern Africa	Afrika e ka Borwa
Southern African Large Telescope	Sebonelahole se selelele sa Afrika Borwa
State Department	Lefapha la Mmuso
State President	Mopresidente wa Mmuso
Statistics South Africa	Dipalopalo tsa Afrika Borwa
Supreme Court	Lekgotla le leholo la dinyewe
The Call of South Africa	Pitso ya Afrika Borwa
The National Qualifications Framework	Moralo wa Mangolo a thuto a Setjhaba
The South African National Council for the Blind	Lekgotla la Difofu la Setjhaba la Afrika Borwa
Truth and Reconciliation Commission	TRC
UN Security Council	Lekgotla la Tshireletso la UN
Union of South Africa	Kopano ya Afrika Borwa
United Christian Democratic Party	United Christian Democratic Party
United Democratic Front	United Democratic Front
United Democratic Movement	United Democratic Movement
United Nations	Dinaha tse Kopaneng
United States of America	Dinaha tse Kopaneng tsa Amerika
Universal Declaration of Human Rights	Phatlalatso e Akaretsang ya Ditokelo tsa Botho
Water Research Commission	Khomishene ya Diphuputso tsa Metsi
West Bank	West Bank
Western Cape	Kapa Bophirimela
Willem Prinsloo Agricultural Museum	Musiamo wa Temo wa Willem Prinsloo
World Health Organisation	Mokgatlo wa tsa Bophelo wa Lefatshe
World Heritage Site	Setsha sa Letlotlo la Lefatshe
World Trade Organisation	Mokgatlo wa Lefatshe wa Kgwebo
World War I	Ntwa ya Pele ya Lefatshe
World War II	Ntwa ya Bobedi ya Lefatshe
World Wildlife Fund	Letlole la Lefatshe la Diphooofolo tse hlaha
abuse of power	tshebediso e mpe ya matla
academic freedom	tokoloho ya thuto
account for	ikarabela bakeng sa
account to	ikarabella ho
accountable for	ikarabella bakeng sa
accounting officer	moofisiri ya ikarabellang
acid mine drainage	Semonya sa morafo wa asete
act of parliament	molao
act of state	ketso ya mmuso
ad hoc	nakwana
ad hoc committee	komiti ya morero
administration of justice	taolo ya toka
administrative action	ketso ya taolo
administrative function	mosebetsi wa taolo
administrative powers	matla a taolo
advancement of technology	tswelliso pele ya thekenoloji
advisory body	mokgatlo wa boeletsi
affirmative action	ketso ya tokiso
against the law	tlolo ya molao
agent of change	mosebeletsi wa diphetoho
air traffic	sephethephethe sa moyeng
air traffic control	taolo ya sephethephethe sa moyeng
all rights reserved	ditokelo tsohle di babaletswe
all the time	ka nako tsohle
annual financial statement	pehelo ya selemo ya ditjhelete
annual general meeting	kopano ya selemo ya kakaretso
annual report	pehelo ya selemo
appoint the cabinet	-kgetha kabinete
appropriate technology	theknoloji e tshwanelehang
area of interest	karolo ya thahasello
area of jurisdiction	sebaka sa taolo
area of land	sebaka sa naha
area of responsibility	karolo ya boikarabelo
armed struggle	boipelaetso bo hlometseng
arts and crafts	bonono le bobetli
arts and crafts market	mmaraka wa tsa bonono le bobetli
arts and culture	bonono le botjhaba
as amended	jwalokaha ho fetotswe
as far as possible	ka moo ho ka kgonehang ka teng
as many as	ka bongata
as soon as possible	ka potlako ka moo ho ka kgonehang
assumption of duty	kamohelo ya mosebetsi
at a meeting	kopanong
at the age of	dilemo tsa
attainment of independence	phumano ya tokoloho
attend a meeting	ho ba teng kopanong
basic human rights	tokelo ya botho ya motheo
basic needs	ditlhoko tsa motheo
basic rights	ditokelo tsa motheo
bear witness to	ho paka
bed and breakfast	boroko le thahameso
bilateral relations	dikamano tsa phapanyetsano
bill of rights	molao wa ditokelo
black power movement	mokgatlo wa matla a batho ba batsho
board of directors	lekgotla la balaodi
board of trustees	lekgotla la baboloki ba matlotlo
body of water	mokgatlo wa metsi
border post	moedi; lediboho
bottom line	qetellong
box office returns	dikgutliswa tsa ofisi ya lebokose
branches of government	makala a mmuso
budget process	tshebetso ya bajete
budget vote	dintlha tsa bajete
build a part	aha karolo
bunch of grapes	seshoba sa morara
bus rapid transit	bopalamelo bo potlakileng ba bese
business community	setjhaba sa kgwebo
business of parliament	tshebetso ya palamente
business sector	mokga wa kgwebo
by means of	ka tshebediso
by the authorities	ke balaodi
by virtue of	ka maemo a
by way of	ka mokgwa wa
by word of mouth	ka puo ya molomo
call centre operator	molaodi wa taolo ya mehala
call for nominations	letsa bakeng sa dikgetho
capacity building	kaho ya bokgoni
capital city	motsemoholo
central government	mmuso wa bohareng
certify a bill	nnetefatsa molato  
chamber of commerce	lekgotla la kgwebo
change of address	phetoho ya aterese
change of course	phetoho ya thuto
changes over time	diphetoho tsa nako e itseng
changing society	setjhaba se fetohang
checks and balances	tekanyo ya maemo
chief executive	mophethahatsi e moholo
chief whip	sephadi se  seholo
child abuse	tlhekefetso ya ngwana
child rearing practices	mesebetsi ya kgodiso ya ngwana
children of Africa	bana ba Afrika
city centre	bohare ba motsemoholo
civil rights	ditokelo tsa setjhaba
civil rights movement	mokgatlo wa ditokelo tsa baahi
civil service	tshebeletso ya setjhaba
civil society	mokgatlo wa setjhaba
civil war	ntwa ya setjhaba
coat of arms	Kola / sefoka
code of conduct	molawana wa boitshwaro
code of ethics	melao ya boitshwaro
collection of data	pokello ya ditaba
collective responsibility	boikarabelo ba kopanelo ka bongata
colonial power	matla a bokolone
colonial rule	molao wa bokolone
come into force	ho matlafala
come to the point	ho tsepama hodima ntlha ya bohlokwa
committee meeting	kopano ya komiti
common interest	thahasello e tshwanang
community building	kaho ya setjhaba
community development	ntshetsopele ya setjhaba
community involvement	kameho ya setjhaba
community participation	ho ba le seabo ha setjhaba
community police forum	moifo wa sepolesa sa setjhaba
community service	tshebeletso ya setjhaba
conclude an agreement	qetella tumellano
conditions of contract	maemo a kontraka / selekane
conditions of service	maemo a tshebeletso
conflict of interest	kgohlano ya maikutlo
conflict prevention	thibelo ya kgohlano
conflict resolution	tharollo ya kgohlano
constitutional democracy	demokrasi ya molao wa motheo
constitutional mandate	taelo ya molao wa motheo
constitutional state	puso ya molao wa motheo
contempt of parliament	nyediso ya palamente
convene a meeting	bitsa kopano
cooperation agreement	tumellano ya tshebedisanommoho
course of action	tswelopele ya ketso
cultural change	phetoho ya moetlo
cultural community	setjhaba sa moetlo
cultural diversity	phapano ya meetlo
cultural goods	dintho tsa moetlo
cultural heritage	letlotlo la moetlo
cultural revolution	phetolo ya moetlo
culture of human rights	moetlo wa ditokelo tsa botho
current affairs	ditaba tsa nako ya hona jwale
customary law	molao wa moetlo
customs and excise	Ditlwaelo le phethahatso
cutting edge	pulamadiboho; setlabotjha
data collection	pokello ya dintlha
date of birth	letsatsi la tlhaho
decent living	bophelo bo hlomphehang
deciduous fruit industry	indasteri ya ditholwana tse lero
defence force	sesole sa tshireletso
degree of freedom	kgato ya tokoloho
delegated legislation	molao o abilweng
demand and supply	tlhoko le phepelo
democratic culture	moetlo wa demokrasi
democratic election	dikgetho tsa demokrasi
democratic political order	taelo ya sepolotiki ya demokrasi
democratic principle	leano la demokrasi
democratic society	setjhaba sa demokrasi
democratic state	mmuso wa demokrasi
democratic transformation	diphetoho tsa demokrasi
democratic values	makgabane a demokrasi
deputy minister	motlatsi wa letona
deputy president	motlatsi wa mopresidente
dereliction of duty	tlohelo ya mosebetsi
developing country	naha e tswelang pele
development initiatives	mekutu ya ntshetsopele
development process	tshebetso ya ntshetsopele
development programme	lenaneo la ntshetsopele
development strategy	mokgwa wa ntshetsopele
diplomatic corps	sesole sa diplomatiki
diplomatic relations	dikamano tsa diplomatiki
direct support	tshehetso e otlolohileng
director general	molaodikakaretso
disaster management	taolo ya koduwa
disciplinary action	ketso ya kahlolo
discussion document	tokomane ya dipuisano
dispossession of land	kgapo ya naha
distribution capacity	bokgoni ba kabo
distribution of resources	kabo ya matlotlo
distribution of wealth	kabo ya letlotlo
district municipality	masepala wa lebatowa
diverse society	setjhaba se fapaneng
diversity of people	phapano ya batho
divide and rule	puso ka boarodi
domain name authority	bolaodi ba lebitso le leholo
down for discussion	taba ya puisano
draft bill	bili ya nakwana
draft bill	tokomane ya pele ya molao
draft legislation	molao wa pele wa nakwana
early warning	tlhokomelo e potlakileng
early warning system	tshebetso ya tlhokomediso ya pele
ease of access	pebofatso ya ho kena
economic empowerment	matlafatso ya kgwebo
economic growth	kgolo ya kgwebo
economic impact	sekgahla sa kgwebo
economic relations	dikamano tsa kgwebo
economic sector	mokga wa kgwebo
economic strength	matla a kgwebo
effective public service	tshebeletso e hlwahlwa ya setjhaba
election period	nako ya dikgetho
election process	tshebetso ya dikgetho
election results	diphetho tsa dikgetho
enabling environment	tikoloho e kgothaletsang
entitled to vote	dumeletswe ho vouta
environmental impact	sekgahla sa tikoloho
environmental impact assessment	tekolo ya sekgahla sa tikoloho
equal opportunities	menyetla e lekanang
equality before the law	tekano ka pele ho molao
every three years	dilemo tse ding le tse ding tse  tharo
executive action	ketso ya phethahatso
executive authority	bolaodi ba phethahatso
executive organs of state	dikarolo tsa phethahatso 
explanatory memorandum	memorandamo wa ditlhaloso
fair election	dikgetho tse hlokang leeme
fall in love	-ratana
fauna and flora	diphedi le dipalesa
field of study	tikoloho ya thuto
fill a vacancy	tlatsa sekgeo
financial year	selemo sa ditjhelete
fiscal discipline	taolo ya tsa ditjhelete
five hundred and six	makgolo a mahlano le metso e tsheletseng
floor of the House	ditulo tsa Ditho
follow up	tatello
food security	tshireletso ya dijo
forced labour	mosebetsi wa qobello
fore and aft	pele le morao
fore and after	pele le morao
foreign direct investment	letsete le otlolohileng la boditjhaba
foreign exchange	tjhelete ya matjhaba
foreign policy	leano la matjhaba
free and fair election	dikgetho tse lokolohileng
free of charge	ka ntle ho tefo
free society	setjhaba se lokolohileng
freedom fighter	molwanedi wa tokoloho
freedom of association	bolokolohi ba boikamanyo
freedom of conscience	tokoloho ya monahano
freedom of expression	tokoloho ya boipolelo
freedom of movement	tokoloho ya motsamao
freedom of religion	tokoloho ya bodumedi
freedom of scientific research	tokoloho ya diphuputso tsa mahlale
freedom of speech	tokoloho ya puo
freedom of the press	tokoloho ya kgatiso
from the front	ho tswa ka pele
full supply level	boemo bo feletseng ba phepelo
functional area	karolo ya tshebetso
fundamental human rights	ditokelo tsa botho tsa motheo
fundamental rights	ditokelo tsa motheo
future research	diphuputso tsa nako e tlang
gender equality	tekano ya bong
gender inequality	ho hloka tekano ha bong
gender violence	dikgoka tsa bong
general election	dikgetho tse akaretsang
get away with	ho tsamaya ka
give evidence	fana ka bopaki
global development	ntshetsopele ya kakaretso ya lefatshe
global economy	kgwebo ya lefatshe lohle
global village	motsana o akaretsang hohle
go on for	ho ya ka
goods and services	dintho le ditshebeletso
governing party	mokga o busang
government action	ketso ya mmuso
government authority	bolaodi ba mmuso
government by the people	mmuso ka batho
government department	Lefapha la Mmuso
government funding	letlole la mmuso
government level	boemo ba mmuso
government of the day	mmuso wa kajeno
government policy	leano la mmuso
government sector	mokga wa mmuso
government services	ditshebeletso tsa mmuso
governmental organisation	mokgatlo wa mmuso
grassroots level	boemo ba setjhaba
gross domestic product	kuno ya naha
guard of honour	mokoloko wa tlotlo
guilty of contempt	molato wa ho se tsotelle
half a million	halofo ya miliyone
have a vote	vouta
head of government	hlooho ya mmuso
head of office	hlooho kapa mookamedi wa ofisi
health care	tlhokomelo ya bophelo bo botle
hierarchy of authority	tatelano ya bophahamo ba bolaodi
historically disadvantaged	ba hlokileng tlhokomelo e ntle nakong e fetileng
hold a meeting	ho tshwara kopano
hold office	ho laola ofisi
honorary citizenship	tlotlo ya boahi
honours and awards	tlotlo le dikgau
host country	naha e amohelang baeti
host nation	setjhaba se amohelang baeti
house of assembly	ntlo ya pokano
houses of parliament	matlo a palamente
human development	ntshetsopele ya botho
human dignity	seriti sa botho
human nature	tlhaho ya botho
human race	morabe wa batho
human resource	mohlodi wa botho
human resource development	ntshetsopele ya basebetsi
human rights	ditokelo tsa botho
human rights abuse	tshebediso e mpe ya ditokelo tsa botho
human rights activist	mokgothaletsi wa ditokelo tsa botho
human rights violation	tlolo ya ditokelo tsa botho
human security	tshireletso ya batho
imbalances of the past	ho se lekane ha nako e fetileng
immediate past president	mopresidente wa nakwana e sa tswa feta
in accordance with	ho ikamahanya le
in accordance with the rules	ho ikamahanya le melao
in addition to	ho eketsa
in an acting capacity	boemong ba botshwaredi
in any way	ka mokgwa ofe kapa ofe
in case of	haeba
in celebration of	bakeng sa ho keteka
in compliance with	ho ikobela
in connection with	mabapi le
in consultation with	ka ho tsebisa
in excess of	ho feta
in favour of	ho kgetha
in front of	ka pela
in good faith	ka tshepo e tiileng
in office	mosebetsing; ka ofising
in so far	ho ya ka
in spite of	le ka ntle ho
in support of	ka tshehetso ya
in terms of	malebana le
in the balance	ka masalla
in the course of	kgabareng
in the evening	ka phirimana
in the event of	ketsahalong ya
in the field of	maemong a
in the gap	sekgeong sa 
in the interim	maemong a nakwana
in the lead	boetapeleng ba
in the long term	ka nako e telele
in the majority	ka bongata
in the morning	hoseng
in the name of	ka lebitso la
in the picture	setshwantshong
in the region of	lebatoweng la
in the white	bosweung
inaugural address	puo ya kgakolo
inaugural meeting	kopano ya kgakolo
income tax	lekgetho la lekeno
indigenous culture	moetlo wa setso
indigenous language	puo ya setso
indigenous people	batho ba setso
industrial society	setjhaba sa indasteri
infant mortality rate	sekgahla sa ho hlokahala ha masea
information retrieval	dintlha
information retrieval	phihlello ya ditaba
information retrieval system	tshebetso ya phihlello ya ditaba
inner city	bohare ba motsemoholo
inspector of mines	mohlahlobi wa merafo
intellectual property rights	ditokelo tsa thepa ya kelello
intergovernmental relations	dikamano tsa mebuso e mmedi
interim constitution	molao wa motheo wa nakwana
international affairs	ditaba tsa matjhaba
international community	setjhaba sa matjhaba
international humanitarian law	molao wa botho wa matjhaba
international olympic committee	komiti ya matjhaba ya diolimpiki
international relations	dikamano tsa matjhaba
interrupt the proceedings	ho sitisa tshebetso
investment of capital	letsete la kapitale
job creation	theho ya mosebetsi
joint committee	komiti e kopaneng
joint meeting	kopano e kopaneng
joint responsibility	boikarabelo ba kopanelo
joint rules committee	komiti ya melao e kopaneng
joint sitting	kapono ya kopanelo
judicial authority	bolaodi ba molao
keep in mind	ho boloka monahanong
keep up to date	ho beha maemong a tshwanelehang a jwale
key performance area	karolo ya motheo ya tshebetso
labour force	basebetsi
labour intensive	sekgahla sa mosebetsi
labour market	mmaraka
lack of energy	tlhoko ya matla
land ownership	borui ba naha
land reform	tlhabollo ya naha
land restitution	kabo ya naha
land rights	ditokelo tsa naha
language policy	leano la puo
language practice	tshebediso ya puo
language rights	ditokelo tsa puo
law enforcement	taelo ya molao
lay a charge	ho qosa
leader of the opposition	moetapele wa bohanyetsi
learning process	tshebetso ya ho ithuta
least of all	e fokolang ho tsohle
legacy of apartheid	nalane ya kgethollo
legal deposit library	laeborari ya tsa molao
legislative authority	bolaodi ba molao
legislative function	tshebetso ya molao
legislative power	matla a molao
legislative powers	matla o molao
legislative process	tshebetso ya molao
level of government	boemo ba mmuso
level of service	boemo ba tshebeletso
levels of development	maemo a tswelopele
liberation movement	mokgatlo wa tokoloho
liberation struggle	boitseko ba tokoloho
limited access	fokoditsweng
limited access	phihlello e lekanyeditsweng
lingua franca	lingua franca
list of members	lenane la ditho
local government	mmuso wa lehae
local government level	boemo ba mmuso wa lehae
local government sector	mokga wa mmuso wa lehae
local municipality	masepala wa lehae
local sphere of government	karolo ya lehae ya mmuso
mainstream economy	kgwebo ya bongata
majority of votes	bongata ba divoutu
majority party	mokga  wa bongata
make a mark	etsa letshwao
make a statement	etsa pehelo
make an effort	leka
management review	tekolobotjha ya bolaodi
manner of speaking	mokgwa wa ho bua
marine living resources	mehlodi ya diphedi tsa mawatle
market economy	kgwebo ya mmaraka
mass mobilisation	tswelopele ya bongata
master of ceremonies	molaodi wa dipuisano
matter of public importance	taba e hlokolotsi ya setjhaba
matter of urgency	taba ya bohlokwa
means of communication	mokgwa wa dikamano
means of transport	mokgwa wa ho tsamaya
member of the council	setho sa lekgotla
member states of the UN	dinaha tseo e leng ditho tsa UN
memorandum of understanding	memorandamo wa kutlwisiso
metropolitan area	karolo ya metropolitan
middle class	sehlopha sa bohare
minority domination	kokamelo  ya palo e fokolang
minority party	mokgatlo wa palo e nyenyane
minutes of proceedings	metsotso
mode of operation	mokgwa wa tshebetso
moment in time	ntlha e itseng ya nako
money laundering	tshebediso e mpe ya tjhelete
months of the year	dikgwedi tsa selemo
mortality rate	boemo ba mafu
mortality rate	sekgahla sa mafu
mother tongue	puo ya lapeng
motion of no confidence	tshisinyo ya ho hloka tshepo
multicultural society	setjhaba sa meetlo e mengata
music rights organisation	mokgatlo wa ditokelo tsa mmino
mutual understanding	kutlwano ya ba babedi
mutually exclusive	kgethehile ho latela bobedi
national affairs	ditaba tsa setjhaba
national anthem	pina ya setjhaba
national asset	asete ya setjhaba; bokgabane ba setjhaba
national budget	bajete; tekanyetso ya setjhaba
national coat of arms	kola
national coat of arms	sefoka sa naha
national conference	seboka sa naha
national conference	setjhaba
national department	naha; lefapha la setjhaba
national development	ntshetsopele ya setjhaba
national economy	kgwebo ya setjhaba
national education	thuto ya setjhaba
national executive	naha
national executive	phethahatso ya setjhaba
national executive authority	bolaodi ba phethahatso ba naha
national executive authority	setjhaba
national executive committee	komiti ya phethahatso ya naha
national executive committee	setjhaba
national flag	folakga ya naha
national government	mmuso wa naha
national identity	boitsebahatso ba naha
national interest	thahasello ya naha
national leader	moetapele wa setjhaba
national level	naha; boemo ba setjhaba
national level of government	naha ba mmuso; boemo ba setjhaba
national policy	setjhaba; leano la naha
national pride	motlotlo wa setjhaba
national reconciliation	poelano a setjhaba
national security	tshireletso ya setjhaba
national sphere of government	karolo ya setjhaba ya mmuso
national strategy	mokgwa wa setjhaba
national symbols	diemela tsa naha
national symbols	matshwao
national unity	kopano ya setjhaba
natural justice	toka ya setjhaba
natural resources	mehlodi ya tlhaho
need to know	lokela ho tseba
new dispensation	tshebetso e ntjha
not later than	eseng ka mora nako
notice of motion	tsebiso ya ditshisinyo
number of children	palo ya bana
number of deaths	palo ya mafu
oath of office	kano ya ofisi
of paramount importance	ya bohlokwa haholo
office bearer	monnga ofisi
official language	puo ya semmuso
official residence	bodulo ba molao
on the defence	tshireletsong
on the market	mmarakeng
on the run	palehong
on the second	ka motsotswana
on the wing	ho fofa
on top of	hodima
open society	setjhaba sohle
opening address	pulo; puo ya selelekela
order of merit	hlahlamano
order of preference	tatelano ya kgetho e ratwang
order of the day	taba ya letsatsi leo
ordinary session	karolo e tlaelehileng
organs of state	dikarolo tsa mmuso
out of control	ha e sebetse
out of date	e feletswe ke nako
out of order	tswile lekoteng
out of print	e tswile kgatisong
out of service	ha e sa sebediswa
out of stock	ha e yo pokellong ya thepa
outbreak of war	ho qhoma ha ntwa
ownership of land	borui ba lefatshe
paradigm shift	phetoho ya tlwaelo
parliament is in session	kopano ya palamente e ntse e tswela pele
parliamentary committee	komiti ya palamente
parliamentary correspondent	mosebeletsi wa palamente
parliamentary democracy	demokrasi ya palamente
parliamentary process	tshebetso ya palamente
participate in the debate	e ba le seabo dingangisanong
participatory democracy	demokrasi ya seabo
party discipline	boitshwaro ba mokgatlo
party system	tshebetso ya mokgatlo
pass laws	melao ya dipasa
pave the way	bula tsela
peaceful coexistence	phihlellano ya kgotso
peaceful demonstration	pontsho ya kgotso
peaceful transition	phetoho e tswellang ya kgotso
per capita	per capita
performing arts council	lekgotla la ketso la bonono
permanent residence permit	phemiti ya boahi ya moshwelella
pillar of strength	tshiya e matla
pilot project	simollang; projeke e qalang
place of safety	sebaka sa tshireletso
platinum group metals	dimetale tsa sehlopha sa polatinamo
play the lead	bapala o le moetapele
playing field	sebaka; tulo ya ho bapalla
point of contact	ntlha ya boikopanyo
point of order	tlhokomediso ya tsamaiso
point of view	maikutlo
police service	tshebeletso ya sepolesa
policy development	ntshetsopele ya leano
policy environment	tikoloho ya leano
policy formulation	theho ya leano
policy framework	moralo wa leano
policy implementation	tshebediso ya leano
policy making	ketso ya leano
policy statement	polelo ya leano
political context	tjhadimo ya sepolotiki
political control	taelo ya sepolotiki
political development	ntshetsopele ya sepolotiki
political dispensation	tshebetso sepolotiki
political environment	tikoloho ya sepolotiki
political instability	ho hloka botsitso ha sepolotiki
political leadership	boetapele ba sepolotiki
political order	taelo ya sepolotiki
political party	mokgatlo wa sepolotiki
political process	tshebetso ya polotiki
political rights	ditokelo tsa sepolotiki
political system	tshebetso ya sepolotiki
political tradition	tlwaelo ya sepolotiki
poor living conditions	maemo a bofutsana
poorest of the poor	mofutsana e moholo
popular culture	moetlo o tlwaelehileng
popular participation	ho ba le  seabo ho tlwaelehileng
popular sovereignty	borena bo tummeng
population register	rejistara ya setjhaba
population size	bongata ba setjhaba
portfolio committee	potefoliyo; komiti ya maemo
powers and functions	matla le mesebetsi
powers that be	matla a ka bang teng
practical reality	bojwalo bo ka phethahatswang
praise singer	seroki
presiding officer	moofisiri ya laolang
press freedom	tokoloho ya kgatiso
primary health care	tlhokomelo ya sethatho ya bophelo
private sector	mokga wa poraefete
professional ethics	boitshwaro ba seprofeshenale
professional organisation	mokgatlo wa seprofeshenale
prophets of doom	baporofeta ba bohata
proportional representation	boemedi ba karolo
provincial administration	taolo ya provense
provincial budget	bajete ya provense
provincial government	mmuso wa provense
provincial legislature	molao wa provense
provincial level	boemo ba provense
provincial sphere of government	puso ya provense
provision of services	phumantsho ya ditshebeletso
public administration	botsamaisi ba setjhaba
public domain	ntlokgolo ya setjhaba
public expenditure	ditshebenyehelo tsa setjhaba
public funds	matlole a setjhaba
public health	bophelo bo botle ba setjhaba
public hearing	nonyo ya maikutlo a setjhaba
public interest	takatso ya setjhaba
public meeting	kopano ya setjhaba
public money	tjhelete ya setjhaba
public office	ofisi ya setjhaba
public opinion	maikutlo a setjhaba
public participation	seabo sa setjhaba
public policy	leano la setjhaba
public relations officer	moofisiri wa dikamano tsa setjhaba
public sector	mokga wa setjhaba
public service	tshebeletso ya setjhaba
public services	ditshebeletso tsa setjhaba
public transport system	tshebetso ya dipalangwang tsa setjhaba
public works	mesebetsi ya setjhaba
public works programme	lenaneo la mesebetsi ya setjhaba
pumped storage scheme	sekimi sa polokelo ya tshutuletso
put a motion	ho hlahisa maikutlo
put in writing	e ngole
quality of life	boleng ba bophelo
question paper	pampiri ya dipotso
quota system	quota; tshebetso ya tekanyetso
quota system	tshebetso ya pehelo
race relations	dikamano tsa merabe
racial equality	tekano ya merabe
racial segregation	kgethollo ya morabe
rainbow nation	setjhaba sa mookodi
range of vision	lethathama la dipono
rapid transit system	tshebetso ya ho palama kapele
redistribution of land	kabobotjha ya naha
reference book	bukana ya boitsebiso
regional integration	kenyeletso ya lebatowa
register of members	rejisatara ya ditho
removal from office	ho ntshwa ofising
remuneration package	pokello ya moputso
required to carry	tshwanela ho nka
reside in	phela ho
residence permit	lengolo la tumello la bodulo
resistance movement	motsamao wa kganyetso
resistance to change	ho hana phetoho
resolution of conflict	tharollo ya kgohlano
resource base	motheo wa mohlodi
responsible for	ikarabela bakeng sa
restitution of land	kabo ya naha
restitution of land rights	kabo ya ditokelo tsa naha
return on investment	kuno ya letsete
right of access	tokelo ya phihlello
right to assemble	tokelo ya kopano /kgobokano
right to human dignity	tokelo ya seriti sa botho
right to life	tokelo ya ho phela
right to privacy	tokelo ya ho ba sephiring
right to strike	tokelo ya ho ipelaetsa
right to vote	tokelo ya ho vouta
rights and privileges	ditokelo lle menyetla
rise and fall	ho wa le ho tsoha
rite of passage	tokelo ya ho feta
road network	maranrang a tsela
road show	dipontsho tsa tseleng
rule of law	tshebetso ya molao
rules and orders	melao le ditaelo
rules of debate	melao ya ngangisano
rules of natural justice	melao ya toka ya tlhaho
rules of procedure	melao ya mokgwa wa tshebetso
ruling party	mokgatlo o busang
rural development	ntshetsopele ya mahae
school library service	tshebeletso ya laeborari ya sekolo
school nutrition programme	lenaneo la phepo sekolong
science and technology	saense le theknoloji
search and rescue	fuputsa mme o pholose
seat of government	bodulo ba mmuso
security clearance	tlhakiso ya tshireletso
security forces	masole  a tshireletso
sending and receiving	romela le ho fumana
sense of responsibility	kelello kapa maikutlo a boikarabelo
sense of touch	maikutlo a kamo
separate but equal	arohane empa ka ho lekana
separate development	ntshetsopele ka karohano
separation of powers	karolo ya matla; karolo ya puso
services industry	indasteri ya ditshebeletso
services rendered	ditshebeletso tse entsweng
set in motion	e tsamaise
shortage of skills	leqeme la boitsebelo ba mesebetsi
sitting of parliament	kopano ya palamente
small town	toropo e nyenyane
social benefits	menyetla ya setjhaba
social capital	kapitale ya setjhaba
social change	phetoho ya setjhaba
social contract	kontraka ya setjhaba
social control	taolo ya setjhaba
social development	ntshetsopele ya setjhaba
social interaction	tshebeletsano ya setjhaba
social justice	toka ya setjhaba
social movement	motsamao wa setjhaba
social security	tshireletso ya setjhaba
social services	ditshebeletso tsa setjhaba
social system	mokgwa wa tshebetso ya setjhaba
social upliftment	phahamiso ya setjhaba
social welfare	boiketlo ba setjhaba
socio-economic development	ntshetsopele ya moruo wa setjhaba
source of income	mohlodi wa lekeno
source of information	mohlodi wa dintlha kapa tsebo
sovereign democratic state	puso e tlotlehileng ya demokrasi
sovereign state	puso e tlotlehileng
sphere of government	karolo ya mmuso
standard of living	boemo ba bophelo
state assets	diasete tsa setjhaba; makgabane a setjhaba
state emblem	lepetjo la mmuso; lepetjo la puso
state institutions	diinstitjushene tsa setjhaba
state money	tjhelete ya mmuso; tjhelete ya puso
state of emergency	maemo a tshohanyetso
state of mind	maemo a kelello
state of the nation address	puo ya setjhaba ya mopresidente
state revenue	letlole la mmuso
status of women	maemo a basadi
status quo	status quo; maemo a tlwaelo
statute book	buka ya melao
strategic management	taolo ho ya ka leano
structural violence	dikgoka tse hlophisitsweng
struggle for liberation	tseko ya bolokolohi
subject for discussion	sehlooho sa dipuisano
subject to the provisions of	ho latela diphumantsho tsa
substantive motion	keletso; tshisinyo e molemo
supply and demand	phepelo le tlhoko
supreme law	molao o moholo
sustainable development	ntshetsopele e ka tshwarellang
sustainable economic growth	kgolo ya moruo e ka tshwarellang
sworn in	ikanetse ho
system of government	mokgwa wa tshebetso ya mmuso
systems approach	mokgwa wa katamelo
table of contents	theibole ya dikateng
take account of	ikarabelle bakeng sa
take advantage of	sebedisa monyetla
take an oath	ikane
take cognisance of	hlokomela
take cognizance of	hlokomela
take into consideration	hlokomela
take off	ho tloha
task team	sehlopha sa tshebetso
tax revenue	letlole la lekgetho
technical services department	lefapha la ditshebeletso tsa setekgeniki
term budget	bajete ya nako e itseng
term of office	nako ya ofisi
terms and conditions	maemo le dipehelo
terms of reference	dintlha tsa dipuisano / tsa tadimisano
terms of trade	dipehelo tsa kgwebo
the Cold War	Ntwa e Masisi
the East	Botjhabela
the West	Bophirimela
the common good	makgabane a tshwanang
the disadvantaged	ba se nang menyetla
the historically disadvantaged	ba sa bang le menyetla nalaneng
the masses	setjhaba
the powers that be	matla a ka bang teng
the right	tokelo
the services	ditshebeletso
the struggle	boitseko
the voiceless	ba se nang puo
thousand and one	sekete le motso o le mong
time of arrival	nako ya ho fihla
time of departure	nako ya ho tsamaya
title deed	lengolo la thuto
to and fro	ho ya le ho kgutla
to the effect that	ho fihlela boemong ba
to the left of	ka ho le letshehadi
to the right of	ka ho le letona
top management	botsamaisi bo boholo
top secret	sephiri se seholo
total onslaught	qaka e kgolo
track record	nalane ya tshebetso
trade relations	dikamano tsa kgwebo
trade union	mokgatlo wa kgwebo
trading partner	molekane wa kgwebo
traditional leadership	boetapele ba setso
traffic control	taolo ya sephethephethe
training facilities	disebediswa tsa kwetliso
training institution	institjushene ya kwetliso
transition to democracy	phetoho ya demokrasi
translation of the Bible	phetolo ya Bibele
tree of knowledge	sefate sa tsebo
tree of life	sefate sa bophelo
umbrella body	mokgatlo o moholo o akaretsang
unanimous concurrence	phihlellano ya kgotso
under the auspices of	tlasa taolo ya
under the authority of	tlasa bolaodi ba
unemployment rate	sekgahla sa ho hloka mesebetsi
unfair discrimination	kgethollo ya leeme
unique people	batho ba ikgethang
united nations organisation	mokgatlo wa dinaha tse kopaneng
university of technology	yunivesithi ya theknoloji
unreserved postal service	tshebeletso ya poso e sa beheletswang
up to date	-nakong
up to standard	maemong a nepahetseng
upper middle class	sehlopha se phahameng se bohareng
urban area	sebaka sa makeishene
urban centre	setsi sa makeishene
urban development	ntshetsopele ya makeishene
urban renewal	ntjhafatso ya metse ya ditoropo
value system	tshebetso ya makgabane
violation of human rights	tlolo ya ditokelo tsa botho
violence against children	tlhekefetso ya bana
violence against women	tlhekefetso ya basadi
voice of the people	lentswe la setjhaba
vote in favour	voutela
vote of thanks	diteboho
waste management	tsamaiso ya dikgwerekgwere
ways and means	mekgwa e fapaneng
welfare state	mmuso wa boiketlo
winds of change	meya ya phetoho
winter rainfall region	lebatowa la pula ya mariha
with effect from	ho qala ka
with the sun	ka letsatsi
with the wind	ka sekgahla sa moya
within a radius of	ka hara tikoloho ya
within the limits	ka tlasa bokgoni
word of welcome	lentswe la kamohelo
working group	sehlopha sa tshebetso
world community	setjhaba sa lefatshe
you are here	o mona