APRIL	MORANANG; 
AU	AU ; 
Africa	Aforika; 
Africa's	Aforika; 
African-American	Moamerika wa Aforika; 
Africans	Maaforika; 
Afrikaans	seaforikanse; 
America	Amerika; 
American	Moamerika; 
Apr	MORANANG; 
April	 Moranang; Aporele; 
Arab	Moarabea; 
Asian	Moasia; 
Auditor	Moruni; 
Auditor-General	Morunikakaretso; 
Beginner's	-simolodi; 
Boer	Leburu; 
Britain	Borithane; 
British	­maesimane;  ­borithane; 
CEOs	di-CEO; 
Caribbean	Kharibiene; 
Castle	Kasetele; 
Cedar	mopane; 
Chairman	Modulasetilo; 
Chinese	Motšhaena; 
Christian	 -sekeresete; modumedi;  mokeresete; 
Christianity	bokeresete; 
Christmas	keresemose; 
Clerks	Ditlelereke; 
Commissioner	Khomišenara; Moikanisi; 
Confederations	cikhonfedereišene;  ditlamagano; 
DECEMBER	SEDIMONTHOLE; 
Dec	SEDIMONTHOLE; 
December	Sedimonthole; 
Dominican	Modominikhene; 
Dutch	Holannere; 
England	Engelane; 
English	sejatlhapi; 
Europe	Yuropa; 
European	Yuropa; 
Excellency	Motlotlegi; 
FEBRUARY	TLHAKOLE; 
FRIDAY	LABOTLHANO; 
Feb	TLHAKOLE; 
February	Tlhakole; 
Federal	Federale; 
Filter	 felitara; tlhotlha;  motlhotlho; 
Fort	kago ya tlhabano;  kago ya phemelo; 
France	Fora; 
French	Mafora; 
Fridays	bo Labotlhano; 
Gazette	Kasete; 
German	Mojeremane; 
Germany	Jeremane; 
Glossary	lenanefoko; 
God	Modimo; 
Guardian	Motlhokomedi; 
HIV-positive	tshwaetsegile ka HIV; 
Handbook	Bukaithuto; 
Hawks	di-Hawks (police); 
Humphreys	ba ga Humphrey; 
India	Intia; 
Indian	Mointia; 
Infecting	tshwaetsang; 
Interjections	malatlhelwa; 
Islam	Iselamo; 
Islamic	­Iselamo; 
Italy	Itali; 
JANUARY	FIRIKGONG; 
JULY	PHUKWI; 
JUNE	SEETEBOSIGO; 
Jacob	Jakobo; 
Jan	FIRIKGONG; 
January	Ferikgong;  Janawari; 
Japan	Japane; 
Jewish	Juta; 
Joseph	Josefa; 
Jul	PHUKWI; 
Julius	Juliase; 
July	Phukwi;  Julae; 
Jun	SEETEBOSIGO; 
June	June;  Seetebosigo; 
Keyword	Lefoko la pulo; 
Kimberley	Teemaneng; 
London	Lontone; 
Lotteries	Dilothari; 
MONDAY	MOSUPOLOGO; 
MPs	di-MP; 
MR	RRE; 
Madam	Mma; 
Mandela's	­Mandela; 
Mayor	Meiyara; Ramotse; 
Meanwhile	kgabagare;  go sale jalo; 
Methodist	Wesele; 
Monday	Mosupologo; 
Moses	Moshe; 
Mourns	hutsafala; 
Mr	Rre; 
Mrs	Mme; 
NOVEMBER	NGWANAITSEELE; 
Natal	Natala; 
Nigerian	Moagi wa Nigeria; 
Nobel	Nobele; 
Nov	NGWANAITSEELE; 
November	Ngwanatsele;  Nofemere; 
OCTOBER	DIPHALANE; 
Oct	DIPHALANE; 
October	Diphalane;  Okotobore; 
Offender's	­motlolamolao; 
Olympic	Olimpiki; 
Olympics	Diolimpiki; 
PACs	di-PAC; 
Palestine	Palesetina; 
Parliament's	­Palamente; 
Peter	Pitori; 
Postpones	busetsa morago; 
Presidency	maemo a Moperesidente; 
President's	Mopresidente; 
Pretoria	Tshwane; 
Prince	Morwakgosi; 
Prof	Moporofesara; 
Protector	mosireletsi; 
Reginald	tsalwa sešwa; 
Registrar	Mokwadisi; 
Russian	Morašia; 
SALSA	motantsho wa SALSA; 
SEPTEMBER	LWETSE; 
Saturday	Lamatlhatso; 
Secretariat	­bokwaledi; 
Secretaries	Bakwaledi; 
Secretaries-General	Bakwaledi-Kakaretso; 
Self-Governance	itaolo; 
Senegal	Senekale; 
Sep	LWETSE; 
September	 Setemere; Lwetse; 
Shanghai	Shankai; 
Skip	tlola; 
Sunday	laTshipi; 
Surname	Sefane; 
Switchboard	boto ya kgolagano ya megala; 
TUESDAY	LABOBEDI; 
TV	thelebišene; 
Thursday	Labone; 
Tuesday	Labobedi; 
Unsubscribe	ikwalolola; 
WEDNESDAY	LABORARO; 
Wednesday	Laboraro; 
Williams	Ba ga William; 
Xhosa	Mothosa; 
Zimbabwean	Moagi wa Zimbabwe; 
ability	bokgoni; 
able	kgona;  nonofile; 
about	 e ka ne e le; ka ga; 
above	- godimo; 
above-mentioned	­umakilweng fa godimo; 
abroad	moseja ga mawatle; 
absence	 - se nne teng; tlhokafalo; 
absent	 go sa nneng teng; se yong; 
absolute	gotlhelele; 
abuse	tshotlo;  tirisobotlhaswa;  sotla; 
abused	sotla; 
academia	ditiro tsa akatemi; 
academic	 - botlhalefi; akatemi; 
academics	 akatemi; baakatemi; -botlhalefi; 
academies	batlhatlheledi ba kholetšhe kgotsa yunibesithi; 
academy	akatemi; 
accelerate	koketso;  akofisa; 
accelerated	okeditse; akofisitse; 
accelerating	akofisang; 
accept	- dumela; 
acceptable	amogelesega; 
acceptance	 tumelo; kamogelo; 
accepted	dumetse; 
accepting	- dumelang; 
access	 botseno; sekaseka;  go tsena; 
accessed	sekasekile; 
accessibility	phitlhelego; 
accessible	fitlhelela; 
accession	tumelano;  tlhomo; 
accident	kotsi; 
accidents	dikotsi; 
acclaim	 rorisa;  duduetsa; boka; 
acclaimed	dudueditse;  rorisitse; bokile; 
accommodate	 naya bonno; tlwaela; 
accommodated	tlwaetse;  neile bonno; 
accommodation	bonno; 
accompanied	nnile mmogo;  - felegeditse;  tsamaile mmogo; 
accompany	tsamaya mmogo;  - nna teng;  - felegetsa; 
accomplish	fetsa; 
accomplished	 weditse; feditse; 
accord	 bongwefela jwa pelo; tumelano;  dumelana; 
accordance	tatelo; 
accorded	dumelane; 
according	go latela; 
accordingly	go ya ka; 
account	 tshupamolato;  tshupatlotlo; letlotlo;  tshupatuelo; 
accountability	boikarabelo; 
accountable	ikarabelang; 
accountant	mmalatlotlo; 
accountants	mmalatlotlo; 
accounting	 mmalatlotlo; palotlotlo; 
accounts	 ditshupamolato; matlotlo;  ditshupatlotlo;  ditshupatuelo; 
accreditation	tetlelelo; 
accredited	letleletswe;  laoletswe; 
accruals	 dikokotlegelo; dikoketsego; 
accrue	direga; 
accrued	diregile; 
accumulate	kokotlela; 
accumulated	kokotleditse; 
accuracy	 nepo;  - nepa; nepagalo; 
accurate	nepagalo;  nepa; 
accused	molatofadiwa; 
achieve	fitlhelela; 
achieved	fitlheletse; 
achievement	phitlhelelo; 
achievements	diphitlhelelo; 
achieving	fitlhelelang; 
acknowledge	amogela; 
acknowledged	amogetse; 
acknowledges	amogela; 
acquire	bona;  fitlhelela; 
acquired	bone;  fitlheletse; 
acquisition	pono; 
across	kgabaganya; 
act	molao;  diragatsa;  tiro; 
acted	dirile;  diragaditse; 
acting	yo o tshwareletseng;  -diragatsa; 
action	tiro; 
actions	ditiro; 
active	 matlhagatlhaga; bonako; 
actively	ka matlhagatlhaga; 
activism	botsosolosi; 
activist	motsosolosi; 
activists	motsosolosi; 
activities	ditiro; 
activity	tiro;  botlhaga; 
actor	modiragatsi; 
actors	badiragatsi; 
acts	 melao;  ditiragatso; ditiro; 
actual	sebele; 
actually	totatota; 
ad-hoc	thulaganyetsonakwana; 
adaptation	boitlwaetso; 
add	 tlhakanya; oketsa; 
added	 tlhakantse; okeditse; 
adding	 tlhakanyang; oketsang; 
addition	tlhakanyo; 
additional	 oketsang; tlaleletso; 
address	bua;  aterese; 
addressed	buile; 
addresses	bua;  diaterese; 
addressing	buang; 
adds	 tlhakanya; oketsa; 
adequate	lekane; 
adequately	ka go lekana; 
adhere	obamela; 
adherence	kobamelo; 
adjourned	 kgaoditse; emisitse nakwana; 
adjudication	 tsereganyo; katlholo; 
adjust	 lolamisa; lekanyetsa; 
adjusted	lekanyeditse;  lolamisitse; 
adjustment	 kokeletso; paakanyo; 
adjustments	 dikokeletso; dipaakanyo; 
administer	tsamaisa; 
administered	tsamaisitse; 
administering	tsamaisang; 
administration	tsamaiso; 
administrations	ditsamaiso; 
administrative	­tsamaiso; 
administrator	 mmusakarolo; motsamaisi; 
administrators	batsamaisi;  babusakarolo; 
admissible	­letlelesegang; 
admission	tumelelo;  -amogela molato;  kamogelo; 
admit	dumelela; 
admitted	dumeletse; 
adopt	 - nna motsadi ka tsholo; -tsaya; 
adopted	- nnile motsadi ka tsholo;  -tshotse; 
adopting	tsayang;  nnang motsadi ka tsholo; 
adoption	botsadi ka tsholo; 
adoptive	botsadikakgodiso; 
adopts	 - nna motsadi ka tsholo; -tsaya; 
adult	 mogodi; mogolo; 
adults	 bagodi; bagolo; 
advance	tswelelopele;  tefelelopele;  tefelopelo; 
advanced	tsweletseng; 
advancement	tsweletsopele; 
advances	 ditefelelopele; ditefelopele; ditswelelopele; 
advancing	tswelang pele; 
advantage	mosola;  molemo; 
advantages	melemo;  mesola; 
advent	 kgakolo; paka ya dibeke tse nne pele ga Keresemose; 
adverse	­sa siamang; 
adversely	ka tsela e e sa siamang; 
adversity	pitlagano; 
advertise	phasalatsa; 
advertised	phasaladitse; 
advertisement	phasalatso; 
advertising	-phasalatsa; 
advice	kgakololo; 
advise	 gakolola; eletsa; 
advised	gakolotse;  eleditse; 
adviser	moeletsi; mogakolodi; 
advisers	 baeletsi; bagakolodi; 
advisor	mogakolodi; 
advisors	 baeletsi; bagakolodi; 
advisory	-kgakololo; 
advocacy	tshegetsophatlalatsa; 
advocate	mmueledi;  moatefokate;  buelela; 
advocates	 baatefokate; babueledi;  buelela; 
affairs	merero; 
affect	ama;  tlhotlheletsa; 
affected	amegile; 
affecting	amang;  tlhotlheletsang; 
affects	ama;  tlhotlheletsa; 
affirm	tlatsa; 
affirmation	tlhomamiso; 
affirming	tlatsang; 
afford	-kgona; 
affordable	- go kgonega; 
afforded	kgonne; 
aforementioned	umakilweng pele;  kailweng pele; 
aforesaid	umakilweng pele;  kailweng pele; 
after	morago ga; 
afternoon	thapama;  tshokologo; 
again	gape; 
against	 tlhabana le;  kgatlhanong le; ganetsana le; 
age	 motlha; dingwaga;  bogolo;  go gola; 
aged	­tsofetse;  ­nang le dingwaga tse; 
agencies	mekgatlho; 
agency	mokgatlho; 
agenda	lenanetema; 
agent	 sediredi; moemedi;  phetodi;  sediriso;  letlhalosi la agentifi; 
agents	 baemedi;  matlhalosi a agentifi; didiredi;  diphetodi; didiriso; 
ages	dingwaga;  bogolo;  metlha;  gola; 
aggregate	palogare; 
aggrieved	kgopisitsweng; 
ago	 bogologolo tala; fetileng;  kgale; 
agree	dumela; 
agreed	dumetse; 
agreement	tumalano;  kutlwano; 
agreements	 dikutlwano; ditumalano; 
agrees	dumela; 
agricultural	Temothuo; 
agriculture	temothuo; 
ahead	kwa pele; 
aid	 thuso; thusa; 
aids	thusa;  dithuso; 
aim	 -korola; boikaelelo; 
aimed	ikaeletse; 
aims	maikaelelo; 
air	 anega; mowa;  loapi; 
aircraft	 sefofi; sefofane; 
airport	boemafofane;  botsurafofane; 
airports	boemafofane;  botsurafofane; 
albeit	le mororo; 
alcohol	 alekhoholo; tagi; 
alert	thantse; 
align	tlhamalatsa; 
aligned	tlhamaladitse; 
alignment	tlhamalatso; 
alike	 lekana; tshwana; 
alive	phedisa; 
all	 gotlhe; tsotlhe;  botlhe;  otlhe; 
allegation	 magatwe; tatofatso; 
allegations	 magatwe; ditatofatso; 
alleged	ga twe; 
allegedly	ka magatwe; 
alleviate	fokotsa bogale; 
alleviation	imololo; phokotsego; 
alliance	tshwaragano; 
allocate	 abela; aba; 
allocated	abetse;  abile; 
allocation	kabo; 
allocations	dikabo; 
allow	letla;  dumelela; 
allowance	tetlo; 
allowances	ditetlo; 
allowed	dumeletse;  letlile; 
allowing	 dumelelang; letlang; 
allows	letla;  dumelela; 
almost	batlile; 
alone	 osi;  kalaotega; esi;  bosi; 
along	tsamaya le ;  tokafala; tswelela; 
alongside	go bapa le; 
already	setse; 
also	le; 
alter	fetola; 
alternate	 -refosanang; refosana; 
alternative	refosanang; 
although	le mororo;  etswa;  le fa; 
always	ka gale;  ka metlha; 
ambassador	moemedi;  moambasatara; 
ambassadors	baemedi; baambasatara; 
ambient	 ­mmino o o iketlileng; ­tikologo; 
ambit	tekanyetso; 
amend	tlhabolola; 
amended	tlhabolotse; 
amending	tlhabololang; 
amendment	tlhabololo;  phetolo; 
amendments	ditlhabololo;  diphetolo; 
amends	tlhabolola; 
ammunition	ditlhabano; 
amnesty	tokololo; 
among	mo gare ga; 
amongst	mo gare ga; 
amount	bokana;  kana ka;  seboka; 
amounted	lekane ka; 
amounting	kana ka; 
amounts	bokana;  kana ka;  seboka; 
analogue	analoko; 
analyse	sekaseka;  lokolola; 
analysed	sekasekile;  lokolotse; 
analyses	ditshetshereganyo; 
analysing	 lokololang; sekaseka; 
analysis	tshetshereganyo; 
ancestor	 modimo; badimo;  mogologolo; 
ancestors	 bagologolo; badimo; 
ancient	bogologolo; 
and	le; 
animal	phologolo;  sebata;  sebatana; 
animals	diphologolo;  dibata;  dibatana; 
animation	ka matlhagatlhaga; dipopae; 
annex	 gapa ka dikgoka; gapa; 
annexure	mametlelelo; 
anniversary	segopotso; 
announced	itsisitse; 
announcement	kitsiso; 
announcements	dikitsiso; 
announces	itsise; 
annual	 ngwaga le ngwaga; sengwaga; 
annually	ka ngwaga;  ngwaga le ngwaga; 
annum	ngwaga; 
answer	karabo; 
answers	dikarabo; 
antenatal	boimana;  pele ga pelego; 
anthem	pina; 
anti-apartheid	kgatlhanong le kgethololo; 
anti-corruption	­kgatlhanong le bonweenwee; 
anti-pass	­kgatlhanong le dipasa; 
anticipated	 akanyeditse kwa pele; solofetse; 
any	nngwe le nngwe;  ­epe; 
anyone	mongwe; 
anything	sengwe le sengwe; 
apart	aroganeng; 
apartheid	kgethololo; 
apparent	ka ponalo; 
appeal	boikuelo;  ipiletso; 
appeals	boikuelo;  ipiletso; 
appear	tlhagelela;  lebega;  bonala;  go ntse jaaka; 
appearance	tlhagelela;  tebego; 
appeared	 bonagetse;  lebegile; tlhageletse;  go nnile jaaka; 
appearing	tlhagelelang;  lebegang;  bonalang; 
appears	tlhagelela;  lebega;  bonala;  go ntse jaaka; 
appellant	moikuedi; 
appendix	 lelana; mametlelelo; 
applaud	opa diatla; 
applause	lošalaba; 
applicable	maleba; 
applicant	mokopi; 
applicants	bakopi; 
application	 tiriso; kopo;  tiragatso;  lenaanetiriswa; 
applications	 ditiriso; manaanetiriswa; dikopo;  ditiragatso; 
applied	 tiredi; dirisitsweng; 
applies	kopa; 
apply	kopa; 
applying	kopang; 
appoint	thapa; 
appointed	thapile; 
appointing	thapang; 
appointment	peo;  peelano; 
appointments	 dipeelano; dithapo; 
appoints	thapa; 
appreciate	 -leboga; anaanela; 
appreciated	anaanetse; lebogile; 
appreciates	leboga;  anaanela; 
appreciation	kanaanelo; 
approach	itlhagisa;  itlhagiso; 
approached	itlhagisitse; 
approaches	itlhagisa;  itlhagiso; 
appropriate	 -lebaneng; tshwanela; 
appropriated	tshwanetse;  lebaneng; 
appropriately	ka tsela e e maleba; 
appropriation	kabo; 
appropriations	dikabo; 
approval	tumelo; 
approve	rebola; 
approved	rebotse; 
approximately	katametso;  - ka nnang; 
arbitration	tsereganyo; 
arbitrator	motsereganyi; 
architect	ramaanokago; 
architects	boramaanokago; baralakago; 
architectural	­boagi; 
architecture	boagi; 
archival	­akhaefe; 
archive	akhaefe; 
archives	akhaefe; 
area	karolo;  kgaolo;  boalo; 
areas	 dikgaolo; dikarolo;  boalo; 
arena	botlhabanelo; 
argued	phegisane; 
argument	ngangisano; 
arguments	diajumente; dingangisano; 
arise	tsoga;  nanoga; 
arises	tsoga;  nanoga; 
arising	 nanogang; tsogang; 
arm	letsogo; 
armed	tletse kitso;  ­tlhometse; 
arms	dibetsa; 
arose	tsogile;  nanogile; 
around	dikologa; 
arrange	rulaganya; 
arranged	rulagantse; 
arrangement	thulaganyo; 
arrangements	dithulaganyo; 
array	tatelano; 
arrest	tshwara; 
arrested	tshwere; 
arrival	 bogorogelo; kgorogo; 
arrive	 goroga; fitlha; 
arrived	 fitlhile; gorogile; 
art	bokgabisi;  botsweretshi; 
artefacts	dilwana tsa bogologolo; 
article	 selo;  athikele, kgang; kgang;  athikele;  temana; 
articles	 diathikele;  dikgang;  ditemana; dilo; 
articulate	 ­kgona go bua bonolo;  tlhagisa maikutlo; kapodisa; 
articulated	tshwaragantsweng; 
artist	 sekgabisi; motsweretshi; 
artistic	-bokgabane;  botsweretshi; 
artists	bataki; bakgabisi;  batsweretshi; 
arts	botshweretsi; 
artwork	setshwantsho; 
artworks	ditshwantshotako; ditshwantsho; 
as	jaaka; 
ascertain	netefatsa;  tlhomamisa; 
aside	fa thoko; 
ask	botsa; 
asked	boditse; 
asking	botsang; 
asks	botsa; 
aspect	ntlha; 
aspects	dintlha; 
aspiration	 phegelelo; khuetso; 
aspirations	diphegelelo; dikhuetso; 
assault	tlhaselo;  kgobatso; 
assembly	kokoano; 
assented	dumelane; 
assert	tlhomamisa; 
assess	 lekanya; atlhola; 
assessed	 lekanyeditse; atlhotse; 
assesses	 lekanya; atlhola; 
assessing	 atlholang; lekanyang; 
assessment	tekanyo; 
assessments	ditekanyo; 
assessor	molekanyetsi; 
assessors	balekanyetsi; 
asset	letlotlo; 
assets	letlotlo; 
assign	 neela tiro; aba; 
assigned	 neetse tiro; abile; 
assignment	tiro; 
assist	thusa; 
assistance	thuso; 
assistant	mothusi;  motlatsa­; 
assisted	thusitse; 
assisting	thusang; 
assists	thusa; 
associate	botsalano;  tsalana; 
associated	tsalane; 
association	tsalano; 
associations	ditsalano; 
assume	 simolola (tiro); itlhoma;  itshwara (maitsholo); 
assumed	simolotse;  itshwere;  itlhomile; 
assumptions	maitlhomo;  ditshimololo; 
assurance	netefaletso; 
assure	netefaletsa; 
assured	netefaleditse; 
astronomy	bolepanaledi; 
at	 fa; mo;  kwa; 
athletics	atleletiki;  diatleletiki; 
atmosphere	lefaufau; 
atmospheric	­lefaufau; 
attach	 thukutha; tshwaraganya; 
attached	tshwaragantse; 
attachment	 go rata thata; mametlelelo; 
attack	tlhaselo;  tlhasela; 
attacks	tlhasela;  ditlhaselo; 
attain	go fitlha; 
attained	fitlhile; 
attainment	phitlhelelo; 
attempt	iteka;  iteko; 
attempted	itekile; 
attempts	maiteko;  iteka; 
attend	go tsena; 
attendance	tseno; 
attended	tsene; 
attending	tsenang; 
attention	ema tswe; 
attitude	boitshwaro; 
attitudes	boitshwaro; 
attorney	mmueledi; 
attorney-general	ratshekiso; 
attorneys	babueledi; 
attract	gogela; 
attracted	gogetse; 
attribute	 semelo;  setlhaodi; boleng; 
auction	fantisi; 
audience	bareetsi;  babogedi; 
audiences	bareetsi;  babogedi; 
audio	 ­modumo; ­kutlo; 
audio-visual	 sedirisokutlopono; -kutlopono; 
audiovisual	kutlopono; 
audit	 thuno; runa; 
audited	runile; 
auditing	thuno; runang; 
auditor	moruni; 
auditor-general	moruni-kakaretso; 
auditors	baruni; 
audits	 dithuno; runa; 
august	phatwe;  ­kgatlhisang; 
auspices	ka thuso le tshegetso; 
authentic	­mmatota; mannete; 
author	mokwadi; 
authorisation	 tumelelo; tetla; 
authorise	letla;  dumelela; 
authorised	dumeletswe; 
authorities	 dipuso; dithata;  ditaolo;  balaodi; 
authority	 moitseanape; thata;  taolo;  molaodi;  puso; 
authorization	 tumelelo; tetla; 
authorize	letla;  dumelela; 
authorized	 letleletse; dumeletse; 
authors	bakwadi; 
automated	­dirisitse motšhini; dirisitse khomphiuta; 
automatic	-itirisang; 
automatically	ka go itirisa; 
availability	botlhokamolekane; bokgoni jwa go nna teng; 
available	teng; 
avenue	mmila; 
avenues	mebila; 
average	 -palogare; palogare; 
aviation	bofofane; 
avoid	tila;  tlhokomologa; 
avoidance	tlhokomologo; phefogo;  thibogo;  tilo; 
awaiting	 letileng; emetseng; 
award	kabelo; 
awards	dikabelo; 
aware	itse;  -itse; 
awareness	temoso; 
away	 ­se yo; ­e seng fa gae; 
babies	masea; 
baby	lesea; 
back	 motlokolo;  marudi;  lentle la seatla;  kgorikgori; morago;  kutu ya loleme;  motlhana; 
backdrop	lemorago; 
background	 maitshetlego; lemorago; 
backgrounds	 maitshetlego; lemorago; 
backlog	tshalelomorago; 
backlogs	ditshalelomorago; 
bad	maswe;  -be;  bosula;  -seng sentle; 
bag	kgetse; 
bail	madi a kgololo;  topololo; 
bake	 -besa; besa; 
baking	besang; 
balance	tekatekano;  selekanyaboima;  lekalekana;  batla tshalelo;  tekano;  itshetlela;  tshalelo;  madi a a setseng; 
balanced	lekalekanang; 
balances	lekalekanya; diêlamaleka;  batla tshalelo;  ditekanyaboima;  itshetlela;  ditekatekano;  ditekano;  ditshalelo; 
ball	 sebete sa leoto; kgwele; 
band	setlhopha;  banta;  orekese; 
bank	 losi; banka;  polokelo; 
banking	go gotsa; 
banks	 dipolokelo;  dintshi; dibanka; 
baobab	mowana; 
bar	noko;  ntlo ya nnotagi; 
bargain	sesolo; 
barrier	legora; 
barriers	magora; 
base	 motheo- thulaganyopalo; motheo;  beisi;  bodimelo;  letlase; 
based	theilwe; 
baseline	selekanyetso; 
basic	theo; 
basics	dintlhatheo; 
basis	 theo; motheo; 
basket	seroto; 
battle	ntwa; 
bay	kgogometso; 
be	go nna; 
beach	lebopo; 
beaches	mabopo; 
bear	bera;  Bera (sika loo ntswa); 
bearers	bafetisatuelo; 
bearing	bereng; 
bears	dibera; 
beautiful	ntle; 
beauty	bontle; 
became	nnile; 
because	 ka gore;  ka gobo; gonne;  ka ntlha ya; 
become	-nna; 
becomes	nna; 
becoming	nnang; 
bed	 bolao; boalo; 
beds	 malao; boalo; 
bee	notshe; 
beer	biri; 
before	pele ga; 
began	simolotse;  theile;  simologile; 
begin	 thaya; simolola; 
beginning	tshimologo; 
begins	 thaya; simolola; 
begun	simolotse;  theile; 
behalf	mo boemong jwa; 
behaviour	mokgwa; 
behind	kwa morago ga; 
being	motho;  e leng; 
beings	batho; 
belief	tumelo; 
beliefs	ditumelo; 
believe	dumela; 
believed	dumetse; 
believes	dumela; 
believing	dumelang; 
belong	­ga; 
belonging	­ga; 
belongs	­ga; 
beloved	moratwa;  ­rategang; 
below	tlase ga; 
benchmark	seelo;  selekanyetsi; 
beneficial	­mosola; 
beneficiaries	baamogeladitshiamelo; 
beneficiary	moamogeladitshiamelo; 
benefit	 mosola; thusa; 
benefited	thusitse; 
benefits	 mesola; thusa; 
better	 sita; botoka;  kaone;  phala; 
between	fa gare;  magareng ga; 
beyond	 moseja; feta; 
bid	 - beeletsa; beeletsa; 
bidder	mmeeletsi; 
bidders	babeeletsi; 
bids	beeletsa; 
big	kgolo; 
bigger	kgolwane; 
biggest	kgolokgolo; 
bilateral	 ­dinaga tse pedi; ­ditlhopha tse pedi; 
bill	 molaotlhomo; molato;  tshupamolato;  seananyo; 
billion	bilione; 
bills	melato;  ditshupamolato;  melaotlhomo;  dikananyo; dithomelotshupamolato; 
bind	lomaganya;  konela; 
binding	mokono; 
bingo	motshameko wa bingo; 
biodiversity	­mefutafuta ya diphologolo le dimela; 
biological	­tshela; 
biome	tikologo go ya ka maemobosa le dimela; 
bird	nonyane; 
birds	dinonyane; 
birth	 pelego; botsalo; 
birthday	letsatsi la botsalo; 
black	bontsho; 
blind	foufala;  foufatsa;  foufetse; 
block	semika;  semika sa kgapetla;  katerole; 
blood	 tikologo ya madi; madi; 
blue	tala;  botala;  bolousele;  lousela; 
board	lekgotla;  lekgotla la patlisiso;  letlapa;  papetla; 
boards	diboto;  dikhateboto;  dipapetla; 
boasts	belafala; 
bodies	ditoiso tsa sopo; mekgatlho;  mebele; 
bodily	­mmele; 
body	 sebele;  mmele; mokgatlho; 
bold	pelokgale; 
bond	tlamo; 
bonds	ditlamo; 
book	buka; 
books	dibuka;  beeletsa manno; 
boom	 maparego; poelo; 
boost	tokafatsa;  oketsa; 
border	 thetha; molelwane;  lesi;  mothetho; 
borders	methetho; melelwane;  dintshi;  thetha; 
born	belegwe;  tsalwa; 
borrow	adima; 
borrowing	adimang; 
boss	kgabiso e e rotologileng; 
botanical	­thutadimela;  ­dimela; 
both	ka bobedi; 
bottom	botlase;  letlase; 
bought	rekile; 
bound	lomagantse; konetse; 
boundaries	melelwane; 
boundary	molelwane; 
box	lekase;  lebokose;  ratha; 
boy	mosimane; 
boys	basimane; 
brackets	sekwerepako;  masakana; 
braille	mokwalo wa difofu; 
branch	 moditlhakore;  iphara;  fapoga;  kala; lekala; 
branches	meditlhakore;  dikala;  iphara;  fapoga; makala;  kalo kala; 
brand	 tshuba; letshwaokgwebo;  kuno; 
bravery	- nna sebete; 
breach	tlolo; 
breadth	 bomatla; bophara; 
break	thuba;  go tswa kotswana; 
breakdown	robega; 
breakfast	sefitlholo;  phitlholo; 
breaking	kabelo ya senkgwe; 
breakthrough	katlego; 
bridge	 moratho; letsibogo; 
brief	 sedimosetsa; kwala;  lokwalo; 
briefed	 sedimoseditse; kwadile; 
briefing	tshedimosetso; 
briefly	ka bokhutshwane; 
briefs	 dikwalo;  sedimosetsa; kwala; 
bring	 tla le;  lere; tlisa; 
bringing	 lereng; tlisang;  tlang le; 
brings	 tla le;  lere; tlisa; 
broad	phaphathi; 
broadband	kgolagano ya dikhomphuita ka inthanete;  thomelotemosi; 
broadcast	 -gasa;  gasa; kgaso; 
broadcaster	mogasi; 
broadcasters	bagasi; 
broadcasting	kgaso; 
broaden	oketsa;  atolosa;  atlhamisa; 
broadening	katoloso;  koketso; katlhamiso; 
broader	phaphathi; 
broadly	ka kakaretso; 
brochure	bukana; 
brochures	dibukana; 
bronze	boronse; 
brother	morwaarra; 
brothers	bomorwarra; 
brought	 lerile;  tlile le; tlisitse; 
brutal	setlhogo; 
brutality	bosetlhogo; 
budget	 tekanyetsokabo;  lekanyetsa; tekanyetso; 
budgetary	­tiriso ya ditšhelete; 
budgeted	lekanyeditse; 
budgeting	lekanyetsang; 
budgets	 ditekanyetsokabo; lekanyetsa;  ditekanyetso; 
buffalo	nare; 
build	aga; 
build-up	oketsega ka iketlo; 
building	moago; 
buildings	meago; 
built	agile; 
bulk	 kgoboko; botlalo; 
burden	 mokgweleo; morwalo; 
bureau	biro; 
buried	epetse; 
burning	phisetso; 
bursaries	dibasari; 
bursary	basari; 
bury	epela; 
bus	bese; 
business	kgwebo; 
businesses	dikgwebo; 
busy	tshwaregile; 
but	 mme fela; mme; 
buy	reka; 
by	 go bapa le; ka; 
cabinet	kabinete; 
calculate	balela; 
calculated	baletse; 
calculating	balelang; 
calculation	palelo; 
calendar	 kalentara; alemanaka; 
call	 leletsa;  etela;  bitsa; raya; 
called	 biditse; etetse;  teile; letseditse; 
calling	pitso; 
calls	ditaelo;  megala; 
came	tlile; 
camp	 moraka;  kampa; thibelela;  mathibelelo;  - kampa; 
campaign	letsholo; 
campaigns	matsholo; 
camps	thibelela;  dikampa;  mathibelelo;  meraka; 
campus	khempase; 
campuses	dikhempase; 
can	kane;  khena; 
can't	­kake;  ­se ke; 
cancel	 khansela; sutlha; 
cancellation	phimolo; tshutlho; 
cancelled	khansetswe; 
cancer	kankere; 
candidate	 ntlhopeng;  motlhatlhobiwa; ntlhopheng; 
candidates	bontlhopheng;  batlhatlhobiwa;  bontlhopeng; 
cannot	­kake;  ­se ke; 
cant	­kake;  ­se ke; 
cap	mmese; 
capabilities	bokgoni;  nonofo; 
capability	bokgoni;  nonofo; 
capable	kgona; 
capacities	methamo; 
capacity	mothamo; 
capacity-building	koketso ya bokgoni; 
cape	kapa; 
capita	per capita; 
capital	 kapetlele;  mošate;  motsemogolo; letlotlo; 
caps	 mebese; makgetlotshameko; 
capture	gatisa;  thopa; 
captured	 thopile; gatisitse; 
captures	gatisa;  thopa; 
car	kara; 
carbon	khabone;  khabono; 
card	karata; 
cards	dikarata; 
care	 tlhokomela; tlhokomelo; 
career	boiphediso; 
careers	maiphediso; 
careful	- ka tlhokomelo; 
carefully	ka tlhokomelo;  ka kelotlhoko;  ka go itisa; 
cargo	morwalo;  foraga; 
caring	tlhokomelang; 
carpet	khapete; 
carried	rwele;  kakamere;  tshwere; sikere; 
carries	 sikara; kakamara; rwala; 
carry	 sikara; kakamara; rwala; 
carrying	phetiso ya dipalo; 
case	molato;  letlole; 
cases	 melato; matlole; 
cash	madi;  tšhelete; 
cast	motlhala; 
catalogue	 khathaloko; kataloko; 
catalyst	motlhodi; 
catch	kapa;  tshwara; 
categories	ditlhopha; 
category	setlhopha; 
cater	 aba dijo; tlhokomela; 
catering	tlhokomelo; kabodijo; 
cattle	dikgomo; 
caucus	khokase; 
cause	lebaka; 
cave	logaga; 
caves	dikgaga; 
cease	 khutla;  emisa; fela; 
ceases	 khutla;  emisa; fela; 
cedar	mopane; 
celebrate	keteka; 
celebrated	ketekile; 
celebrates	keteka; 
celebrating	ketekang; 
celebration	moletlo;  mokete;  keteko; 
celebrations	 diketeko;  mekete; meletlo; 
cell	sele; 
cells	disele; 
cellular	 ­sele; ­selefounu; 
census	sensase; 
censuses	disensase; 
cent	sente; 
centenary	ngwaga ya bolekgolo;  letsatsi la bolekgolo; 
center	tikwatikwe;  setshiketsi;  bogare;  borakanelo; 
central	gare; 
centre	tikwatikwe; sentha;  setshiketsi;  bogare;  borakanelo; 
centres	ditikwatikwe;  marakanelo; disentha;  bogare;  ditshiketsi; 
centuries	dingwagakgolo; dipalokgolo; 
century	 palokgolo; ngwagakgolo; 
ceremonial	seremoni; 
ceremonies	diseremoni; meletlo; 
ceremony	moletlo;  seremoni; 
certain	netefatsa; 
certainly	e le ruri;  ka nnete; 
certainty	bonnete; boammaaruri; 
certificate	setifikeiti; 
certificates	disetifikeiti; 
certification	neelosetifikeiti;  tokomane ya tetlotiro; 
certified	-e e kanetsweng; 
cession	go gapelwa lefatshe; 
chain	keetane;  ketane; 
chair	setilo;  sedulo; 
chairman	modulasetulo;  motshwaramarapo; 
chairperson	modulasetulo; 
chairpersons	badulasetulo; 
challenge	 phegisano;  gwetlha; kgwetlho; 
challenged	phegisane; gwetlhile; 
challenges	diphegisano;  dikgwetlho;  gwetlha; dikgwetlho; 
challenging	gwetlhang;  ­phegisanang;  phegisanang;  ­gwetlhang; 
chamber	phaposi; 
chambers	diphaposi;  dirua; 
champion	modipa; 
champions	badipa; 
championship	bodipa; bosimega;  bommampodi; 
championships	bodipa;  bommampodi; dikgaisano tsa bosimega; 
chance	sebaka;  tšhono; 
change	 maditshalelo;  fetoga;  thuba; phetogo; 
changed	fetotse;  maditshalelo;  thubile; 
changes	 maditshalelo;  fetoga;  thuba; phetogo; 
changing	fetogang;  thubang; 
channel	 mosele;  tšhanele; laolela; 
channels	ditšhanele;  mesele; laolela; 
chapter	kgaolo; 
chapters	dikgaolo; 
character	 moanelwa;  botho; mokgwa; 
characterised	kaile sebopego; 
characteristic	 pharologantsho;  -farologanyang; semelo; 
characteristics	dipharologantsho; 
characterize	kaya sebopego; 
characterized	kaile sebopego; 
characters	mekgwa;  botho;  baanelwa; 
charge	 latofatsa;  tlhotlhwa; tlatsa;  tatofatso;  katlholo; 
charged	-tletseng; 
charges	 latofatsa;  ditlhotlhwa;  ditatofatso; tlatsa;  dikatlholo; 
charter	lokwalo lwa ditshwanelo;  tšhata; 
check	netefatso; 
chemical	 khemikale; khemikhale; 
cheque	tšheke;  ditšheke; 
chief	kgosi; 
child	ngwana; 
childhood	bongwana; 
children	bana; 
children's	­bana; 
choice	tlhopho; 
choices	ditlhopho; 
choir	 setlhopha sa mmino; khwaere; 
choose	tlhopha; 
choral	kopelo; 
chose	tlhophile; 
chosen	tlhophile; 
chronic	­sa foleng; 
church	kereke; 
churches	dikereke; 
cinema	baesekopo;  baesekopong; 
cinemas	dibaesekopo; 
circumstances	mabaka; 
cite	tagafara; 
cities	metsemogolo;  diteropo; ditoropokgolo; 
citizen	moagi; 
citizenry	baagibotlhe; 
citizens	baagi; 
citizenship	 thutaboagi; boagi; 
city	 teropo; motsemogolo; 
civic	 ­toropokgolo; ­toropo; 
civil	-gae; 
civilian	moagi; 
claim	tleleimi;  topotuelo;  topokabelo;  go lopa tuelo; 
claimed	lopile tuelo; 
claims	 ditleleimi;  lopa tuelo; ditopotuelo; 
clarification	tlhaloso;  tshedifatso; 
clarify	tlhalosa;  sedifatsa; 
clarion	tlelarione; 
clarity	bolenkutlwalo; 
class	 setlhopha;  boemo; thulaganyo;  mophato; 
classes	 ditlhopha;  mephato; maemo;  dithulaganyo; 
classic	 ­gaisang; tlelasiki;  ­gapang maikutlo; 
classics	hisetori ya Roma le Gerika); ditlelasiki (puo, dikwalwa; 
classification	 pharologanyo; tlhopho;  tlhophelo; 
classified	tlhopha; 
classroom	phaposi; 
clause	karolwana;  polelwana; 
clauses	dikarolwana;  dipolelwana; 
clean	 phepafetseng; phepa; 
clear	 apogile;  - bonatsang;  phimola; bonala;  go apoga ga legodimo; 
clearance	kgololo; 
clearing	gololang; 
clearly	­bonalang; 
clerk	tlelereke;  tlelereke ya kgotla; 
click	 modumopuo; tobetsa;  kakato; 
client	modirelwa;  batlathusong; 
clients	badirelwa;  batlathusong; 
climate	 maemobosa; tlelaemete; 
clinic	tleliniki; 
clinical	setleliniki; 
clinics	ditleliniki; 
close	gaufi;  hupetse; 
closed	tswaletswe; 
closely	­thata;  ka kelotlhoko; 
closer	gaufinyana; 
closing	hupetse; 
closure	tswalelo; 
closures	ditswalelo; 
clothing	 ditswalo; diaparo; 
club	setlhopha;  tlelapa; 
clubs	 ditlelapa; ditlhopha; 
cluster	ngata;  tlelasetara; 
co-operation	 tirisano; mokgatlho; 
co-operative	 thulaganyo ya tiriso ya tsadiso; dirisanang; 
co-ordinate	kopanya; 
co-ordination	kopanyo; 
co-production	 ntshotlhakanelo; ntshommogo; 
coach	 leteroko la terene; katisa;  kariki ya ditonki;  mokatisi; 
coal	malatlha;  lelatlha; 
coast	lebopo; 
coastal	­lebopo; 
coat	tshasa;  bobowa; 
code	 khoute; khoutu; 
codes	dikhoutu; 
coherent	 ­utlwalang;  ­kopaneng; ­tshwaraganeng; 
cohesion	kopano; 
cohesive	­kopaneng; 
cold	 mofikela;  go nna tsididi; tsididi;  -tsididi;  go tsididi;  botsididi;  maruru; 
collaborate	dirisana; 
collaboration	tirisano; 
collaborative	­tirisano; 
collapse	 pheretlhana; go wa; 
colleagues	badirammogo;  badiri ka; 
collect	kgobokanya; 
collected	kgobokantse; 
collecting	kgobokanyang; 
collection	phutho; 
collections	diphutho; 
collective	­kopanelo;  setlhopha se se kopaneng; 
collectively	jaaka setlhopha; 
colleges	dikholetšhe; 
colloquium	kholokwiamo (khonferense); 
colonial	ya koloni; 
colonialism	bokoloniale; 
colonies	dikoloni; 
colony	koloni; 
colour	mmala; 
coloured	mebalabala; 
colourful	mebalabala; 
colours	mebala; 
column	 mokhutlolo;  pilara; kholomo;  mokoloko wa dira;  kolomo;  leru la mosi; 
combat	ntwa;  lwantsha; 
combating	lwantshang; 
combination	kopanyo;  kgolaganyo; 
combined	kopantsweng; 
come	tla; 
comedy	 motlae; metlae; 
comes	tla; 
coming	tlang;  kgorogo; 
comma	phegelwana; 
command	taelo; 
commas	diphegelwana; 
commemorate	ikgopotsa; 
commemorating	ikgopotsang; 
commemoration	segopotso; 
commemorative	­segopodiso; 
commence	 thaya; simolola; 
commenced	simolotse;  theile; 
commencement	tshimololo, theo; 
commencing	simololang;  thayang; 
commend	baka;  tlotlomatsa; 
commendable	tlotlomatsegang; ­pakegang; 
commensurate	­bapisa; 
comment	 anela; tshwaela; 
comments	dikanelo; 
commercial	papatso;  ya kgwebo;  - kgwebo; 
commission	 khomišene; tshwaiso; 
commissioner	 moikanisi; molaodi; 
commissioners	 baikanisi; balaodi; 
commissions	dikhomišene; ditshwaiso; 
commit	itlama; 
commitment	tlamego; 
commitments	ditlamego; 
commits	itlama; 
committed	itlamile; 
committee	komiti; 
committee's	­komiti; 
committees	dikomiti; 
committing	itlamang; 
commodities	diphatlho; 
commodity	phatlho; 
common	gale; 
commonly	ka batho ba bantsi; 
communal	tlhakanelo; 
communicate	bolela;  neeletsanya; 
communicated	tlhaeletsana;  neeletsanya; 
communication	 puisano;  neeletsanyo; tlhaeletsano; 
communication-related	­amanang le tlhaeletsano; 
communications	ditlhaeletsano; 
communities	 masaisai; baagi;  ditšhaba; 
community	 setšhaba; baagi;  lesaisai; 
community-based	­baagi; 
companies	ditlamo; 
company	setlamo; 
comparability	 tshwantshego; papisego; 
comparable	 tshwantshega; bapisega; 
comparative	­amanang; 
compare	 tshwantshanya; bapisa; 
compared	tshwantshanye; bapisitse; 
comparison	papiso; 
compassion	kutlwelobotlhoko; 
compatriot	mogaeno; 
compatriots	bagaeno; 
compelled	pateletsa; 
compelling	pateletsang; 
compensate	duela;  phimola keledi; 
compensation	pusetso; 
compete	gaisana;  phadisana; 
competence	kgono; 
competencies	bokgoni; 
competency	bokgoni; 
competent	kgona; 
competition	kgaisano; 
competitive	 ­kgaisano;  ­ikaeletseng go atlega mo kgaisanong; tlhotlhwatlase; 
competitiveness	bogaisani; 
compilation	thulaganyo;  tlhamo; 
compile	tlhama; 
compiled	tlhamile; 
complainant	mongongoregi; 
complaint	ngongorego; 
complaints	feditse; 
complement	tlaleletsa; 
complementary	­dikhutlo tse di tlhakanang go dira 90°;  ­tsamaisana; 
complete	 -fetsa; fetsa;  feletse; 
completed	 -feditse;  bakaulengwe; feditse; 
completely	ka gotlhe; 
completing	feletse;  fetsang; 
completion	konosetso; phetso; 
complex	 -pataganeng; metsemetse;  tikatikwe;  pataganeng; 
complexity	tharaano; 
compliance	kobamelo; 
complied	obametse; 
complies	obamela; 
comply	obamela; 
complying	obamelang; 
component	karolo;  serwe; 
components	dirwe; 
composed	tlhamile; 
composition	 tshimololo; tlhamo;  botlhami; 
comprehensive	­akaretsang gotlhe; 
comprehensively	ka go akaretsa gotlhe; 
comprise	­na le; 
comprises	­na le; 
comprising	­nang le; 
compromise	 ineelo; ineela; 
compromised	ineetse; 
compulsory	pateletso; 
computer	motšhinipalelo; 
computers	 metšhinipalelo; dikhomphiutha; 
comrade	mokaulengwe; 
comrades	bakaulengwe; 
conceive	ima;  go ima; 
concentrated	- loileng; 
concentration	kokoano; 
concept	 kgopolo; tlhaloganyo; 
concepts	dikgopolo;  ditlhaloganyo; 
concern	 ­ka ga; tshwenya; 
concerned	amegang; 
concerning	­ka ga;  malebana le; 
concerns	matshwenyego; 
concert	khonserata;  khonsata; 
conciliation	thuanyo; 
conclude	 digela; fetsa;  wetsa; 
concluded	 weditse;  digetse; feditse; 
concludes	 digela; fetsa;  wetsa; 
conclusion	 tigelo; kwetso; phetso; 
concrete	konkereite;  sa popego; 
concurrence	tumelano; 
concurrent	gongwe; 
condemn	garaswanya; 
condemned	garaswantse; 
condemns	garaswanya; 
condition	 boemo; maemo; 
conditional	pakajaanong; 
conditions	boemo; 
condom	 kgotlopo; khontomo;  khontomo ya borre; 
condoms	 dikhontomo; dikhontomo tsa borre; dikgotlopo; 
conducive	­siametse; 
conduct	 opedisa; tsamaisa;  boitshwaro;  itsaya; 
conducted	 opedisitse;  itshotse; tsamaisitse; 
conducting	 itsayang;  opedisang; tsamaisang; 
conducts	 opedisa; tsamaisa;  boitshwaro;  itsaya; 
confer	 gakololana;  buisana; fa; 
conference	khonferense; 
conferences	dikhonferense; 
conferred	buisane;  gakololane;  file; 
confidence	itshepa;  tshepo; 
confident	itshepa; 
confidential	khupamarama;  pipanapipe; 
confidentiality	bophiri; 
confirm	tlhomamisa;  tiisa; 
confirmation	tlhomamiso; 
confirmed	 tlhomamisitse; netefaditse; 
confirms	tlhomamisa;  tiisa; 
confiscation	kamogo; 
conflict	kgotlhang; 
conflicts	dikgotlhang; 
confront	itebaganya; 
congratulate	akgola; 
congratulates	akgola; 
congratulating	akgolang; 
congratulations	dikakgolo; 
congress	kopano; 
conjunction	lekopanyi; 
connect	gokaganya; 
connected	­golaganeng; 
connection	kgolagano; 
conscience	segakolodi; 
conscious	thathamologetswe; 
consciousness	boitemogo; 
consecutive	latelana; 
consensus	tumelano; 
consent	 letla;  tumelelo; tetla; 
consequence	ditlamorago;  pheletso; 
consequences	ditlamorago; dipheletso; 
consequential	­ka ntlha ya;  ­botlhokwa; 
consequently	kwa pheletsong; 
conservation	tshomarelo; 
conserve	 sebolokwa; boloka;  somarela;  poloko; 
consider	akanya;  nagana; 
considerable	­golo; 
considerably	ka bontsi; 
consideration	tshiamisetso; 
considerations	­tshiamisetso; 
considered	akanyeditse; 
considering	akanyang;  naganang; 
considers	akanya;  nagana; 
consist	na le; 
consistency	tlhomamo; 
consistent	tlhomame; 
consistently	ka tlhomamo; 
consisting	nang le; 
consists	na le; 
consolidate	tiisa; 
consolidated	tiisitsweng; 
constant	tlhomameng;  tlhomamo; 
constantly	ka gale;  ka metlha le metlha; 
constituency	kgaolotlhopho; 
constitute	tlhama; 
constituted	tlhamile; 
constitutes	tlhama; 
constitution	molaotheo; 
constitutional	­molaotheo; 
constitutions	melaotheo; 
constraint	leparego; 
constraints	maparego; 
construct	aga; 
constructed	agile; 
construction	kago; 
constructive	­mosola; 
construed	lebile jaaka; 
consult	rerisana; 
consultant	moitseanape; 
consultants	baitseanape; 
consultation	therisano;  therisanelo; 
consultations	ditherisano; 
consultative	­gakololang; 
consulted	rerisane; 
consulting	rerisanang; 
consumable	jegang; 
consumer	modirisi; 
consumers	badirisi; 
consumption	tiriso; 
contact	kamano; 
contacts	dikamano; 
contain	-na le; 
contained	-nnile le; 
container	setshelo;  setshodi; 
containers	ditshelo;  ditshodi; 
containing	nang le; 
contains	-na le; 
contemplated	akantse; 
contemporary	tsa segompieno; 
contempt	lenyatso; tshotlho; 
content	mothamo; 
contents	diteng;  mothamo; 
context	togamaano; 
continent	kontinente; 
continental	­kontinente; 
continents	dikontinente; 
contingency	­tshoganyetso; 
contingent	­ikaegile ka (sengwe se se ka diregang mo isagong); batshwani; 
continuation	 tswelelo; tsweletso; 
continue	tswelela; 
continued	tsweleditse; 
continues	tswelela; 
continuing	tswelelang; 
continuity	ka tswelelo; 
continuous	 pakatsweledi; tswelelang; 
continuously	rakonteraka; 
contract	 hunyela; konteraka;  ngotlega;  tlamano; 
contracted	 ngotlegile; hunyetse; 
contracting	 hunyelang; ngotlegang; 
contractor	borakonteraka; 
contractors	­dumelane mo konterakeng; 
contracts	 hunyela; dikonteraka; ditlamano;  ngotlega; 
contractual	­ganetsang; 
contrary	tlola molao; 
contrast	 pharologanyo; farologanya;  phapaano; 
contravenes	tlolomolao; 
contravention	 tsenya letsogo;  nna le seabe; abela; 
contribute	 nnile le seabe;  tsentse letsogo; abetse; 
contributed	 nnile le seabe;  tsentse letsogo; abetse; 
contributes	abelang;  tsenyang letsogo;  nnang le seabe; 
contributing	seabe;  kabelo; 
contribution	dikabelo; 
contributions	moabi; 
contributor	baabi; 
contributors	kopana;  epa (pitso); 
control	taolo;  laola; 
controlled	laotse; 
controlling	laolang; 
controls	 ditaolo; laola; 
convene	kopane;  epile; 
convened	­tlwaelegileng; 
convention	tlwaelo;  kokoano;  tumelano; 
conventional	phuthagano;  tlhakanelo; 
conventions	ditumelano; 
conversation	puisano; 
conversations	dipuisano; 
conversion	 tshokologo;  phetolo; phetolelo; 
convert	 mosokologi; fetola;  sokolola; 
converted	fetotse;  sokolotse; 
convey	 neeletsa; tsamaisa; 
conviction	ponomolato; 
convinced	 tlhomamiseditse; tlhotlheleditse; 
cookie	khuki; 
cooperation	 thusano; tirisano; 
cooperative	 thulaganyo ya tiriso ya tsadiso; dirisanang; 
cooperatives	dithulaganyo tsa tiriso ya tsadiso; 
coordinate	gokaganya;  nyalanya; 
coordinated	kopantse; 
coordinating	kopanyang; 
coordination	kgolagano; 
cope	kgotlelela; 
copies	kopolola; dikhopi;  kopisa;  kôpa; 
copy	khopi;  kopiso;  kopisa; 
copyright	tetlokhopi; 
core	thapo; 
corner	sekhutlo;  lengoto; 
cornerstone	motheo; 
corporate	mmogo; 
corporation	mokgatlho; 
corporations	mekgatlho; 
corps	setlhopha se se kgethegileng sa masole; 
correct	 siamisa;  -siama; nepagetseng;  nepagetse; 
correction	 nepiso; tshiamiso; 
correctional	­kgopololo;  ­paakanyo;  ­tshiamiso; 
corrections	ditshiamiso; 
corrective	nepisang; 
correctly	ka nepiso; 
correspondence	kwalelano; 
corresponding	dumelanang; 
corrupt	senyegile; 
corruption	tshenyego; 
cost	 baya theko;  tlhotlhwa; ditshenyegelo; 
cost-effective	­go le gontsi ka tlhotlhwatlase; 
costs	 baya theko;  ditlhotlhwa; ditshenyegelo; 
council	lekgotla; 
councillor	 mokgotla; mokhansele; 
councillors	balekgotla;  bakhansele; 
councils	makgotla; 
counsel	kgakololo;  mmueledi;  kaelo; 
counselling	kgakololo; 
count	bala; 
countdown	- balelela la bofelo; 
counter	 khaontara; mmadi;  sebadi;  sebadisi; 
counterpart	molekane ka tiro; 
counterparts	balekane ka tiro; 
countries	dinaga; 
country	naga; 
country's	­naga; 
countrywide	naga ka bophara; 
couple	 tshwaraganya; sebedi; 
coupled	tshwaragantse; 
coupon	khupone; 
courage	go nna le sebete; 
course	motsholo; 
courses	metsholo; 
court	kgotla; 
court's	­kgotlatshekelo; 
courtesy	tlotlo; 
courts	dikgotla; 
cover	akaretsa; 
coverage	pego ya bobegakgang;  tshireletso (inšorense); 
covered	akareditse; 
covering	 go goma; letlalo;  sebipo; 
covers	akaretsa; 
covet	eletsa; 
coveted	eleditse; 
cradle	thari; 
craft	thuto ya boitseanape; 
crafters	babetli-ka-diatla; 
crafts	dithuto tsa boitseanape; ditiroatla; 
crater	molomo wa lekgwamolelo; 
create	tlhola; 
created	tlhodile; 
creates	tlhola; 
creating	tlholang; 
creation	tlholego;  lobopo;  popo; 
creative	bokgoni; 
creativity	bokgoni; 
creator	mmopi; 
creators	babopi; 
credibility	boikanyego; 
credible	­ikanyegang; 
credit	molato;  keretiti; 
creditor	monayamolato; 
creditors	banayamolato; 
credits	melato;  dikeretiti; 
creed	 molawanatheo; tumelo; 
cricket	 kirikete; tsintsiri; 
crime	bosenyi;  tshenyo; 
crimes	 ditshenyo; bosenyi; 
criminal	sesenyi;  sesinyi; 
criminals	disenyi; 
crisis	moseneke; 
criteria	mokgwa; 
criterion	mokgwa; 
critical	tlhobaetsang; 
critically	 ­botlhokwatlhokwa; ­tlhobaetsang; 
crop	 sejelo;  kotulo;  sejalo; thobo; 
crops	dijalo; dikotulo;  dithobo; 
cross	kobo;  sefapaano; 
cross-border	­ka kwa ga molelwane; 
crucial	­botlhokwa; 
culminate	feleletsa;  konosediwa ka; 
culmination	 konosetso ka; pheleletso; 
cultural	tsa setso; 
culture	setso; 
cultures	ditso; 
cup	kopi; 
curate	moruti wa maemopotlana; 
curator	motlhomamisi; 
curators	batlhokomelamusiamo; batlhomamisi; 
currency	ledi; 
current	moela; 
currently	ga jaana; 
curriculum	thulaganyo ya dirutwa;  thulaganyo ya marutwa; 
curve	 kgogoropo; segoro; 
custodian	 molebedi;  modisa; motlhokomedi; 
custodians	 balebeledi; batlhokomedi;  badisa; 
custody	tlhokomelo;  tiso;  - tswalelwa; 
custom	 moetlo; tlwaelo; 
customary	­tlwaelo; 
customer	moreki; 
customers	bareki; 
customs	ditlwaelo;  meetlo; 
cut	 moseto;  legopelo;  lengapo; tshego; 
cutting	 phata; kalana;  thupana; 
cycle	tsheko; 
daily	letsatsi le letsatsi; 
dam	letamo;  tama; 
damage	 senya; tshenyo; 
damages	 ditshenyo; senya; 
dance	bina;  reteletsa;  moretelediane;  -tantsha; 
dancers	batantshi; 
dances	 tantsha; metantsho; bina;  reteletsa;  mereteletso; 
danger	kotsi;  diphatsa; 
dangerous	kotsi; 
dark	lefifi;  go fifala; 
data	tshedimosetso; 
database	sefalanatshedimoso; 
databases	difalatshedimoso; 
date	letlha; 
dates	ditatlele; 
dawn	masa; 
day	letsatsi; 
days	malatsi; 
dead	moswi; 
deadline	makgaolakgang; 
deaf	susu; 
deal	samagana le;  gwebisana; 
dealer	mogwebi; 
dealers	bagwebi; 
dealing	tshamagano le; kgwebisano; 
deals	ditumelano; mefutakgong; 
dealt	 dirana; samagana; 
dear	 moratiwa; tlhotlhwagodimo; 
death	loso; 
deaths	dintsho; 
debate	 ngangisano; kgang;  kganetsano; 
debated	 ngangisane; ganetsane; 
debates	 dingangisano;  dikganetsano; dikgang; 
debt	molato; 
debtor	mokoloti; 
debtor's	­mokoloti; 
debts	melato; 
decade	ngwagasome;  dingwaga tse lesome; 
decades	dingwagasome; dingwaga tse lesome; 
deceased	moswi;  -suleng; 
decent	­ntle;  ­siame;  ­kgotsofatsang; 
decide	fetsa; 
decided	sweditse;  tshotse tshwetso; 
decides	fetsa; 
deciding	fetsang; 
decision	 phetso; tshwetso; 
decision-making	tseotshwetso; 
decisions	 diphetso; ditshwetso; 
declaration	polelo; 
declare	-tlhomamisa; 
declared	goeleditse; 
declares	tlhomamisa; 
decline	gana; 
declined	ganne; 
declines	gana; 
declining	ganang; 
decrease	 ngotla; fokotsa; 
decreased	fokoditse;  ngotlile; 
decryption	pulokhoutu ; 
dedicate	 abela; neela; 
dedicated	neetse;  abetse; 
dedication	boineelo; 
deduct	 ntsha; fokotsa; 
deducted	 fokoditse; ntshitse; 
deduction	ditloso;  -ntsha; 
deductions	ditloso; 
deeds	dikano; 
deem	akanya;  gopola; 
deemed	akantse;  gopotse; 
deems	akanya;  gopola; 
deep	boteng;  tengteng; 
deepen	tsenelela kwa teng; 
deeper	boteng-teng; 
deeply	tselatelele; ka kelotlhoko; 
default	 tlhaelo; molato;  tlhokomologo; 
defect	phoso; 
defence	tshireletso;  phemelo; 
defend	sireletsa;  femela; 
defendant	moiphemedi; 
defiance	 bodipa; lonyatso; 
deficiencies	ditlhaelo; 
deficit	tlhaelo; 
deficits	ditlhaelo; 
define	ranola; 
defined	ranotse; 
defines	ranola; 
defining	ranolang; 
definition	bokao;  tlhaloso; 
definitions	ditlhaloso; 
degree	selekanyo;  dikerii; 
degrees	dilekanyo;  didikerii; didikerii; 
delay	tiego; 
delayed	diegile; 
delays	ditiego; 
delegate	 roma; moemedi;  thomeletso; 
delegated	romile; 
delegates	 roma; baemedi;  dithomeletso; 
delegation	boemedi;  thomeletso; 
delegations	boemedi;  dithomeletso; 
delete	phimola; 
deleted	phimotse; 
deletion	phimolo; tshutlho; 
deliberate	akanya ka kelotlhoko;  ka bomo; 
deliberately	ka bomo;  kakanyo ya kelotlhoko; 
deliberations	ditherisano; 
delighted	 kgatlhegile; itumetse;  jele monate; 
deliver	 belegisa; gorosa; 
delivered	gorositse; belegisitse; 
delivering	 gorosang; belegisang; 
delivers	 belegisa; gorosa; 
delivery	khubamo; 
demand	topo;  setlhokwa; 
demands	ditlhokwa;  ditopo; 
demarcation	kgaoganyo; 
democracy	 demokerasi; temokerasi; 
democratic	ya temokerasi; 
democratically	ka temokerasi; 
demographic	thutabatho; 
demonstrate	bontsha;  supa;  supetsa; 
demonstrated	 supeditse;  dirile ditshupetso; bontshitse;  supile; 
demonstrates	bontsha;  supa; dira ditshupetso;  supetsa; 
demonstration	tshupetso; 
denied	phegile; ganeditse; 
dental	­meno; 
deny	ganela;  phega; 
department	lefapha;  lephata; 
department's	­lefapha; 
departmental	ya lefapha; 
departments	mafapha;  maphata; 
departure	botlogo; 
depend	 ikanya; ikaega; 
dependants	batsholwa; 
dependence	boikaego;  boikanyo; 
dependency	naga e e laolwang ke e nngwe; 
dependent	batlhokomelwa;  baikaegi; batsholwa; 
depending	ikaegileng;  ikanyang; 
depends	 ikanya; ikaega; 
deploy	bolotsa; 
deployed	boloditse; 
deployment	thapa masole; 
deposit	peeletso;  sesiti;  letlotlo; 
deposited	beile madi; 
depository	polokelo; 
depreciation	phokotsegotlhotlhwa; 
depth	boteng; 
deputies	bathusi;  batlatsi; 
deputy	 motlatsi; mothusi; 
deregister	kwalolola; 
derive	tswa; 
derived	tswile; 
descent	fologela;  pagologa; 
describe	tlhalosa;  thala; 
described	tlhalositse;  thadile; 
description	tlhaloso; 
desert	 sekaka; ngwega; 
design	 akanyetsa;  rala; moakanyetso; 
designate	naya maemo; 
designated	neo ya maemo;  inakemo; 
designation	inakemo; 
designed	tlhametsweng; 
designer	moakanyetsi; 
designers	baakanyetsi; 
designs	 meakanyetso; akanyetsa;  dithalo; 
desirable	­rokotsang mathe;  ­eletsegang; 
desire	 meletsa mathe; eletsa; 
desired	meleditse mathe; eleditse; 
despite	 ila; nyatsa;  le fa; 
destiny	isago; 
destroy	senya; 
destroyed	sentse; 
destruction	tshenyo; 
detail	 ka botlalo;  - botlalo; botlalo; 
detailed	ka botlalo; 
details	dinwane; 
detained	tshwerwe;  golegilwe;  tlhatlhetswe; 
detainees	 mapantiti; bagolegwa;  batshwarwa; 
detection	temogo; 
detention	- tswalelwa; 
determination	boikaelelo; 
determine	tlhomamisa; 
determined	ikemisetsa; 
determines	tlhomamisa; 
determining	 tlhotlhomisa [tlhotlhomisang]; tlhomamisa; 
develop	godisa;  gola;  nonofa; 
developed	 godisitse;  nonofile; godile; 
developing	 nonofang; golang;  godisang; 
development	kgolo;  kgodiso;  nonofo; 
developmental	­tlhabologo;  ­tsweletso; 
developments	 dikgodiso; dikgolo;  nonofo; 
develops	godisa;  gola;  nonofa; 
device	sediriswa;  loga; 
devices	botlhamo; 
devolution	tholelo; 
diagnosis	 tupo ya bolwetse; temogo; 
dialogue	puisano;  mmuisano; 
dialogues	dipuisano; 
diamond	taemane; 
diamonds	diteemane; 
diaspora	 diasepora; phasalalo; 
dictionary	bukantswe; 
did	dirile; 
didn't	­sa dira; 
die	letaese;  -tlhokofala;  go swa; 
died	 tlhokofetse; sule; 
dies	 tlhokofala; swa; 
differ	farologana; 
difference	 phapaano; pharologano; 
differences	dipharologano;  diphapaano; 
different	farologaneng; 
differently	ka go farologana; 
difficult	thata; 
difficulties	mathata; 
difficulty	bothata; 
digital	tshedimosetsopalo; 
dignified	­tlotlegang; 
dignitaries	batlotlegi; 
dignity	seriti; 
dimension	selekanyo; 
dimensions	dilekanyo; ditekani; 
dinner	tinara;  dijo tsa maitsiboa; 
diploma	dipoloma; 
diplomatic	dipolomateki; 
direct	lebane; 
directed	lebane; 
directing	lebaneng; 
direction	ntlha;  ditaetso;  kaelo; 
directions	dikaelo; 
directive	tiredi; 
directives	ditiredi; 
directly	ka tlhamalalo; 
director	mokaedi; 
director-general	mokaedikakaretso; 
directorate	bokaedi; 
directors	bakaedi; 
directory	 bukakaedi; faelekaedi; 
directs	lebane; 
disabilities	bogole; 
disability	bogole; 
disabled	 golafetse; bogole; 
disadvantage	thapolo; 
disaster	matlhotlhapelo; 
disasters	matlhotlhapelo; 
discharge	 lebusa;  go nya; tiragatso;  fokotsega;  kgololo;  golola; 
discharged	fokotsegile;  nyele;  golotse; 
disciplinary	kgalemo; 
discipline	 boitiso; boitshwaro; 
disciplines	 boitiso; boitshwaro; 
disclaimer	 boitatolo; boikgololo; 
disclose	senola; 
disclosed	senotse; 
disclosure	tshenolo; 
discourse	puo;  sekwalwa; 
discover	ribolola; 
discovered	ribolotse; 
discovery	thibololo; 
discretion	ka fa o bonang ka teng; 
discretionary	­ka fa motho a bonang ka teng; 
discrimination	tlhaolele;  tlhophololo; 
discuss	buisana; 
discussed	buisane; 
discussing	buisanang; 
discussion	puisano; 
discussions	dipuisano; 
disease	bolwetse;  botlhoko; 
diseases	 matlhoko; malwetse; 
dismissal	 naya tsela; teleko;  go kobiwa; 
disparities	dipharologano; diphapaano; 
display	 -bontsha; bontsha;  pontsho; 
displayed	 -bontshitse; bontshitse; 
displaying	bontshang;  -bontshang; 
disposal	go latlha; 
dispose	latlha; 
disposed	latlhile; 
dispossession	kamogo; 
dispute	kganetsano;  ganetsana; 
disputes	dikganetsano;  ganetsana; 
disqualified	itsile; 
disqualify	itsa; 
dissatisfied	 ­galala; ­betwa ke pelo; 
dissemination	phasalatso; 
dissolution	tlhaoloso;  tlhamololo (palamente); 
dissolve	thuba;  tlhaolosa;  tlhaologa; 
dissolved	 tlhaolositse; thubile;  tlhaologile; 
distance	sekgala;  bokgakala; 
distant	kgakala; 
distinct	 ­bonalang; farologane; 
distinction	pharologano; 
distinctions	dipharologano;  maduo a a gaisang; 
distinctive	bonagala; 
distinguished	 ­itsegeng; farologantse; 
distribute	aba; 
distributed	abile; 
distribution	kabo;  kgasagano;  kabo phatlalatso; 
district	kgaolo;  setereke; 
districts	 disetereke; dikgaolo; 
distrust	-se tshepege; 
diverse	mefutafuta; 
diversion	phapogo; 
diversity	kakaretso ya mefutafuta; 
diverted	fapogile; 
divide	arola; 
divided	arogantse; 
dividend	karolelo; 
dividends	dikarolelo;  dikarolwa; 
division	karolo;  kgaoganyo;  kgaogano;  lephata; 
divisions	dikarolo;  maphata;  dikgaogano;  dikgaoganyo; 
divorce	tlhalo; 
do	dira; 
doctor	ngaka;  ngaka ya malwetse; 
doctorate	thuto ya bongaka; 
doctors	dingaka;  dingaka tsa malwetse; 
document	lekwalo; 
documentation	ditokomane; 
documents	makwalo; 
does	dira; 
doesn't	­se dire; 
doing	dirang; 
dollar	dolara; 
domains	didomeine; 
domestic	tsa legae; 
dominant	phekeetsi; 
domination	phekeetso; 
don	 motlhatlheledi; rwala;  apara;  tswala; 
don't	­se ke; 
donation	dineelo; 
donations	dineelo; 
done	 feditse;  weditse; dirile; 
donor	moabi; 
donors	baabi; 
door	setswalo; 
doors	ditswalo; 
double	 oketsa gabedi; sebedi; 
doubt	 kakabalo;  belaela;  akabala; pelaelo; 
down	 lefofatlase;  diphofaleta; tlase; 
download	sitlholola; 
downtown	mo gare ga toropo; 
downturn	phokotsego; 
draft	tlhamo; 
drafted	tlhamile; 
drafting	tlhamang; 
drama	terama; 
dramatic	 ­golo; ­terama;  ­kgatlhisang; 
draw	 thala;  maleka;  lekalekana;  tšhentšha;  rala; ntsha; 
drawing	 sethalo;  tshwantsha; setshwantsho; 
drawn	 gogile; ntshitse; 
dream	toro; 
dreams	ditoro; 
drew	 thadile; ntshitse; 
drink	 nwa; seno; 
drinking	nno; 
drive	mmila; 
driver	mokgweetsi; 
driver's	­mokgweetsi; 
drivers	bakgweetsi; 
driving	kgweetsang;  mmila; 
drop	 lerothodi; wa; 
drug	 seokobatsi;  seritibatsi; kalafi;  more;  molemo; 
drugs	melemo;  mere;  diokobatsi;  dikalafi;  diritibatsi; 
drum	moropa;  meropa;  teromo; 
dry	omileng;  omile;  go oma;  omisa;  oma; 
dual	-pedi; 
due	kolotang; 
duly	 jaaka go solofetswe; ka tsela e e maleba; 
duplicate	dupolikata;  go dupolikata; 
duplication	tirosebedi; 
duration	 lobaka; paka;  sebaka;  boleele jwa nako; 
during	ka nako ya; 
duties	metšhaelo;  ditshwanelo;  makgetho; ditiro; 
duty	 tshwanelo; tiro;  lekgetho; 
dynamic	tshelang-tota; 
e-mail	kwalelano ka inthanete;  posa ka inthanete; 
earlier	pejana;  ­pele;  go sa le gale; 
earliest	­pelepele; 
early	phakela; 
earmarked	tshwaya; 
earn	amogela; 
earned	amogetse; 
earnings	dikamogelo; 
earth	lefatshe;  sethibelalegadima;  mmu; 
ease	bonolo; 
easier	bonojana; 
easily	 ka bonolo; ka bofefo; 
east	botlhaba;  botlhabatsatsi;  -botlhaba; 
eastern	­botlhaba; 
easy	bonolo; 
economic	thuo; 
economically	ka ditšhelete;  ka tlhotlhwatlase; 
economics	thuto ka tsa ikonomi; 
economies	diikonomi; 
economists	moikonomise; 
economy	 ekonomi; ikonomi; 
ecosystem	tsela ya go dira ka tsa tikologo; 
ecosystems	ditsela tsa go dira ka tsa tikologo; 
edge	losi; 
edit	tseleganya; 
editing	tseleganyang; 
edition	kgatiso; 
editor	motseleganyi; 
editors	batseleganyi; 
educate	- ruta; 
educated	rutile; 
educating	rutang; 
education	 -ruta; thuto; 
educational	ya thuto; 
educator	morutabana; 
educators	barutabana; 
effect	 sephetho;  phetodi; diragatsa; 
effected	diragaditse; 
effective	nonofile; 
effectively	ka nonofo; 
effectiveness	nonofo; 
effects	 phetodi; diragatsa;  diphetho; 
efficacy	bokgoni; 
efficiency	bokgoni; 
efficient	bokgoni;  kgona; 
efficiently	ka bokgoni; 
effort	matsapa;  boiteko; 
efforts	maiteko;  matsapa; 
eight	robedi; 
either	le fa e le; 
elderly	godileng;  tsofetse; 
elders	 bagodi; bagolo; 
elect	tlhopha;  kgetha; 
elected	 kgethile; tlhophile; 
election	ditlhopho;  kgetho; 
elections	ditlhopho;  dikgetho; 
electoral	­ditlhopho; 
electrical	­motlakase; 
electricity	motlakase; 
electrification	tsenyomotlakase; 
electronically	ka seeleteroneki; 
elects	tlhopha;  kgetha; 
elevate	tsholetsa; 
eleven	somenngwe; 
eligible	­tshwanelegang; 
eliminate	 tlosa; ntsha; 
eliminated	 tlositse; ntshitse; 
elimination	tloso; 
eloquently	ka botswerere mo puong; 
else	­sele; 
elsewhere	go sele; 
email	 kwalelano ka inthanete; -romela ka inthanete;  posa ka inthanete; 
emanating	ntshang;  ­tswang; 
emancipation	kgololo; 
embark	tsena mo sekepeng; 
embarked	tsene mo sekepeng; 
embarking	tsenang mo sekepeng; 
embassies	dintlokemedi; diembasi; 
embassy	ntlokemedi;  embasi; 
embed	nanganela; 
embedded	nanganetse; 
emblem	sekano; 
embodiment	kano; 
embraced	hakane; 
embraces	hakana; 
emerge	tswelelela; 
emerged	tsweleletse; 
emergence	 rotogo; photsego; tlhagelelo; 
emergency	tshoganyetso; 
emergent	dikgatopele tsa tlhabologo; 
emerging	tswelelelang; 
eminent	 ­tlotlegang; ­itsegeng; 
emission	-ntsha; 
emoluments	dituelo;  meputso; 
emotion	maikutlo;  khuduego; 
emotional	-maikutlo; 
emotions	maikutlo;  dikhuduego; 
emphasis	kgatelo; 
emphasise	gatelela; 
emphasised	gateletse; 
emphasises	gatelela; 
employ	thapa; 
employed	thapile; 
employee	mothapiwa; 
employees	bathapiwa; 
employer	mothapi; 
employers	bathapi; 
employing	thapang; 
employment	 thapo; tiro; 
employs	thapa; 
empower	matlafatsa; nonotsha;  siamisetsa; 
empowered	matlafaditse;  siamiseditse; nonotshitse; 
empowering	nonotshang; matlafatsang;  siamisetsang; 
empty	lolea; 
emulate	go etsa; 
enable	kgontsha;  kgonisa; 
enabled	kgontshitse; 
enables	kgontsha;  kgonisa; 
enabling	kgontshang;  kgonisang; 
enacted	 tlhoma molao; diragaditse; 
enacting	 tlhomang molao; diragatsang; 
enactment	taolo; 
enactments	ditaolo; 
encourage	rotloetsa;  kgothatsa; 
encouraged	rotloeditse;  kgothaditse; 
encourages	rotloetsa;  kgothatsa; 
encouraging	rotloetsang;  kgothatsang; 
end	bokhutlo; 
endangered	-kotsing; 
endeavor	leka; 
endeavour	leka; 
endeavours	 diteko; leka; 
ending	bokhutlo; 
endorse	tiisa; 
endorsed	tiisitse; 
endorsement	kano; 
enduring	itshokelang; 
energy	maatla;  maikatlapelo; 
enforce	gatelela; 
enforced	gateletse; 
enforcement	kobamedisomolao; 
engage	 tsaya karolo; tlhoma letlhokwa; 
engaged	tshotse karolo;  tlhomile letlhokwa; 
engagement	- beeletsa; 
engagements	 - beeletsa; dipeeletso; 
engaging	­ntle; 
engender	baka; 
engendering	 ­bakang; tlholang; 
engine	enjene; 
engineer	moenjenere;  go kgona; 
engineers	baenjenere; 
enhance	oketsa; 
enhanced	okeditse; 
enhancement	 tlhatloso; koketso; 
enhancing	oketsang; 
enjoy	iphina; 
enjoyed	iphinne; 
enormous	­kgolo; 
enough	lekane; 
enquiry	patlisiso; 
enrich	humisa; 
enrol	kwadisa; 
enrolled	kwadisitse; 
enrolment	kwadiso; 
enshrined	somaretswe; 
ensue	latelang; 
ensuing	latelang; 
ensure	netefatsa; 
ensured	netefaditse; 
ensures	netefatsa; 
ensuring	netefatsang; 
entail	akaretsa;  na le; 
entails	akaretsa;  na le; 
enter	tsenya; 
entered	tsentse; 
entering	tsenyang; 
enterprise	kgwebo; 
enterprises	dikgwebo; 
enters	tsenya; 
entertainment	boitumelo;  thabiso;  boitumediso; 
entire	 borethe; otlhe; 
entirely	gotlhe; 
entities	ditheo; 
entitle	tshwanetse; 
entitled	tshwanetse; 
entity	setheo; 
entrance	kgoro; 
entrepreneur	mopakakgwebo; 
entrepreneurial	 pakakgwebo; gwebipotlana; 
entrepreneurs	bapakakgwebo; 
entries	 ditlhabeletso; dikwadiso; 
entrusted	laetse; 
entry	 tlhabeletso; kwadiso; 
envelope	enfelopo; 
environment	tikologo; 
environmental	tikologo; 
environments	ditikologo; 
envisaged	akanyeditse; 
envisages	akanyetsa; 
epidemic	leroborobo;  segajaja; 
equal	 lekanang;  nonofile;  -lekana; lekana; 
equality	tekatekano; 
equally	ka go lekalekana; 
equals	lekana le; 
equipment	ditlamelo;  sediriswa; 
equipped	tlametse; 
equitable	­lekalekanang;  ­sa gobeleleng; 
equity	tekatekano; 
equivalent	lekanang;  -lekanang; 
eradicate	 senyetsa ruri; ntsha; 
eradicating	 senyetsang ruri; ntshang; 
eradication	nyeletso; 
error	phoso; 
errors	diphoso; 
escape	 phologa; tshaba; 
escapes	 phologa; tshaba; 
especially	segolo; 
essence	boleng; 
essential	 sa botlhokwa; tlhokegang; 
essentially	ka tiriso ya dintlhatheo; 
establish	tlhoma; 
established	tlhomile; 
establishes	tlhoma; 
establishing	tlhomang; 
establishment	lenanethapo; 
establishments	mananethapo; 
estate	 lefa; boswa; 
estates	 lefa; boswa; 
esteemed	­tlotlegang;  ­kgatlhisang; 
estimate	 lekanyetsa; tekanyetso; 
estimated	lekanyeditse; 
estimates	lekanyetsa;  ditekanyetso; 
ethical	­ngwao; 
ethics	 boitsholo; botho; 
ethnic	 semorafe; morafe; 
ethnicity	 bomorafe; botso; 
ethos	dingwai; 
evaluate	lekola;  tlhotlhwafatso; 
evaluated	lekotse; 
evaluating	lekolang; 
evaluation	patlotlhotlhwa; 
eve	letsatsi pele ga; 
even	lekalekana;  borethe; 
evening	maitsiboa;  lotlatlana; 
event	tiragalo; 
events	ditiragalo; 
eventually	kwa bokhutlong; 
ever	 go sa khutleng; go sa feleng; 
every	botlhe; 
everybody	 mongwe le mongwe; botlhe; 
everyone	mongwe le mongwe; 
everything	sengwe le sengwe; 
evidence	 bopaki; bosupi; 
evident	­bonala;  ­lemosega; 
evolve	tswa; 
evolved	tswile; 
evolving	tswang; 
ex	moratiwa wa pele; 
exactly	e le tota;  ka nepo; 
examination	tlhatlhobo; 
examinations	ditlhatlhobo; 
examine	leka;  tlhatlhoba; 
examined	 tlhatlhobile; lekile; 
example	sekao; 
examples	dikao; 
exams	ditlhatlhobo; 
exceed	feta; 
exceeded	fetile; 
exceeding	fetang; 
exceeds	feta; 
excelled	gaisitse; 
excellence	kgaiso;  thwadi; 
excellent	bontle;  sentlentle; 
except	aroga; 
exception	learogi;  karogo; 
exceptional	 ­phapogo; ­karogo; 
excess	 phetotekano; phetotekanyetso; 
excessive	­feteletse; 
exchange	 anaanya;  phontšhi;  ananya; kananyo; 
exchanges	ananya;  anaanya;  dikananyo; 
excise	lekgetho; 
excitement	tlhagafatso; 
exciting	tlhagafatsang; 
exclude	tlogela; 
excluded	tlogetse; 
excludes	tlogela; 
excluding	tlogelang; 
exclusion	tswalelontle;  tlhotlhololo; tlogelo; 
exclusions	ditswalelontle; ditlogelo;  ditlhotlhololo; 
exclusive	­kgethegile; 
exclusively	ka tsela e e kgethegileng; 
execute	diragatsa;  bolaya; 
executed	bolaile;  diragaditse; 
executing	 bolayang; diragatsang; 
execution	polaosemolao; 
executive	khuduthamaga; 
executor	 moabi wa lefa; modiragatsi; 
exempt	rebola; 
exempted	rebotseng; 
exemption	thebolo; 
exemptions	dithebolo; 
exercise	 thobolola;  katisa;  thobololo;  thutiso;  itshidilo; katiso; 
exercised	ikwetlisitse; ikatisitse;  thobolotse; 
exercises	 dibuka tsa thutiso;  ditshidilo; dikatiso; 
exercising	-ikwetlisang; 
exhibit	 sesupo; bontsha; 
exhibition	tshupetso;  pontsho; 
exhibitions	dipontsho;  ditshupetso; 
exile	 tshedisa melelwane;  tshedisomelelwane; motshediswamelelwane; 
exist	 go nna teng; le yo; 
existed	nnile teng;  le yo; 
existence	 - nna teng; boleyo; 
existing	­nnang teng; 
exists	 nna teng; le yo; 
exit	tswa;  botso; 
expand	 atologa; atolosa; 
expanded	 atolositse; atologile; 
expanding	atolosang;  atologang; 
expansion	 katologa; katoloso;  katologo; 
expect	solofela; 
expectation	tsholofelo; 
expectations	ditsholofelo; 
expected	solofetse; 
expedient	tshwanetseng; 
expenditure	tshenyegelo; 
expense	madi a a dirisitsweng; 
expenses	ditshenyegelo; 
expensive	e turang; 
experience	 go itemogela; maitemogelo; 
experienced	itemogetse; 
experiences	 itemogela; maitemogelo; 
experiencing	 itemogelang; maitemogelo; 
expert	moitseanape; 
expertise	bokgoni;  kitso; 
experts	baitseanape; 
expiration	khemelontle; 
expired	fedile; 
expiry	fela; 
explain	tlhalosa; 
explained	tlhalositse; 
explains	tlhalositse; 
explanation	tlhaloso; 
explanatory	­tlhalosang; 
explicit	­bontshang thobalano;  ­utlwalang; 
exploitation	go ja ntsoma; 
explore	 utulola;  - tsamaya; tlhotlhomisa; 
explored	- tsamaile;  tlhotlhomisitse; utulotse; 
explores	 utulola;  - tsamaya; tlhotlhomisa; 
exploring	 tlhotlhomisang; tsamayang;  utulolang; 
expo	pontsho; 
export	 seyantle;  isa ntle;  diromelwantle; thomelontle;  thomelo; 
exports	diyantle; 
expose	tlhagisa; 
exposed	tlhagisitse; 
exposure	tlhagelela; 
express	thadisa;  setimelasegaodi; 
expressed	thadisitse; 
expression	 tlhagisomaikutlo; sekao;  ponagalo; 
expressions	ditlhagisomaikutlo; dikao;  diponagalo; 
expressly	tlhamalala; 
extend	 leelefatsa; atolosa; 
extended	leelefaditse; atolositse; 
extending	atolosang;  leelefatsang; 
extends	 leelefatsa; atolosa; 
extension	 tiraki; katoloso;  koketso; 
extensive	­atlhameng; 
extent	 selekano; bogolo; 
external	lentle;  -ntle; 
extra	 tlaleletsang; koketsego;  koketso;  ekesetera; 
extract	 sentshwa;  go ntsha (leino); ntsha; 
extraordinary	­makatsang; 
extreme	galakang; 
extremely	mo go boitshegang; 
eye	 lerobana la nnelete; leitlho; 
eyes	matlho; 
face	 lepele;  boalo; letlhakore;  sefatla;  sefatlhego; 
faces	matlhakore;  difatla;  boalo;  difatlhego; 
facie	prima facie; 
facilitate	 fefofatsa; nolofatsa; 
facilitated	nolofaditse;  fefofaditse; 
facilitates	 fefofatsa; nolofatsa; 
facilitating	 fefofatsang; nolofatsang; 
facilitation	bebofatso; nolofatso; 
facilities	dibebofatsi; 
facility	sediriso; 
facing	sebipo; 
facsimile	fekese; 
fact	ntlha; 
factor	 katisani;  palokatiso; lebaka; 
factors	 melao ya metšhini;  dipalokatiso;  difaboriki le tiro ya kago; mabaka; dikatisani; 
factory	bodirelo;  faboriki; 
facts	dintlha; 
fail	palelwa;  tlhaela;  fosa; 
failed	 fositse; paletswe;  tlhaetse; 
failing	paletsweng;  tlhaetseng;  fositseng; 
fails	palelwa;  tlhaela;  fosa; 
failure	palelo; 
failures	dipalelo; 
fair	 go sa siama; go sa sa itekanela; 
fairly	ka go sa gobelele;  ka go lekalekana; 
fairness	tekatekano; tlhokakgobelelo; 
faith	tumelo; 
fall	 phuagana; wa; 
fallen	wele; phuagane; 
falling	go theoga; 
falls	diphororo; 
familiar	itsege; 
families	malapa;  ditshika;  ba lelapa; 
family	 losika; lelapa;  ba lelapa; 
famous	itsege; 
fan	sefoki;  morati; 
fans	barati;  difoki; 
far	tennyanateng; kgakala; 
farewell	tumediso;  salang sentle;  tsela tshweu; 
farm	 polasa; lema; 
farmer	rapolasa; 
farmers	borapolasa; 
farming	temothuo; 
farms	 dipolasa; lema; 
fashion	fešene; 
fast	itima dijo; 
father	rre;  ntate; 
fathers	borre;  bontate; 
fault	phoso;  go supa phoso; 
favorite	ratiwang;  seratwa; 
favorites	diratwa; 
favour	molemo; 
favourable	­molemo;  ­utlwalang; 
favourite	ratiwa;  seratwa; 
fax	fekese; 
fear	poifo; 
fears	dipoifo; 
feasibility	­kgonegang; 
feature	setlhogo se se rileng; 
federal	 pusotshwaraganetsweng; federale; 
federation	tshwaragano; 
fee	tuelo; 
feed	 go fepa; fepa; 
feeds	diphepo;  go fepa; fepa; 
feel	utlwa;  phuruphutsa;  apaapa; 
fees	dituelo; 
fell	wele;  rema; 
fellow	 mogagabo;  mogaeno; monkana; molekane;  mogaetsho; 
felt	 utlwega; utlwala; 
female	mosadi;  namagadi; 
females	 bonamagadi; basadi; 
festival	moletlo; 
festivals	meletlo; 
festive	keteko; 
fever	letshoroma;  -fisa; 
few	 se kae; mmalwa; 
fewer	mmalwanyana;  ­se kaenyana; 
field	 kampa; naga; 
fields	 dikampa; dinaga; 
fifth	botlhano; 
fifty	somamatlhano; 
fight	ntwa; 
fighter	motlhabani; molwani; 
fighters	 batlhabani; balwani; 
fighting	ntwa;  lwa [lwanne]; 
figure	 dikapuo; popego;  tlhakapalo; 
figures	 dikapuo; ditlhakapalo; dipopego; 
file	 feile; faele;  rethefatsa; 
filed	rethefaditse; 
files	 difeile;  rethefatsa; difaele; 
fill	tlatsa;  katela;  gelela; 
filled	tladitse;  geletse;  katetse; 
filling	setlatsi; 
film	filimi;  filemi; 
filmmakers	badiradifilimi; 
filmmaking	bodirabaesekopo;  bodirafilimi; 
films	difilimi; 
final	makgaolakgang; 
finalisation	phediso;  konotelelo; kwetso; 
finalise	fetsa;  konotelela;  wetsa; 
finalised	 weditse; konoseditse; feditse; 
finalising	konosetsang;  feditseng; weditseng; 
finally	 kwa bokhutlong; kwa bofelong; 
finance	madi;  ditšhelete;  - neela madi; 
financed	neetse madi; 
finances	madi;  ditšhelete; 
financial	tsa ditšhelete; 
financially	­ditšhelete; 
financing	neelang madi; 
find	senka; 
finding	phitlhelelo; 
findings	diphitlhelelo; 
finds	senka; 
fine	 pheletso;  boso jo bo siameng;  borethe; tuelo;  tefiso;  otlhaya; 
fines	dituelo; dipheletso;  ditefiso;  otlhaya; 
finest	 pheletso;  boso jo bo siameng; borethe; 
fingerprints	dikgatisomenwana; 
fire	molelo; 
firearm	sethunya; 
firearms	dithunya; 
firm	 -tsetsepetseng;  tsetsepetseng; feme; 
firmly	 ka tlhomamo; ka tsepamo;  ka nitamo; 
firms	difeme; 
first	ya ntlha; 
firstly	­ntlha; 
fiscal	lotseno; 
fish	tlhapi; 
fisheries	madirelathapi; 
fishery	bodirelathapi; 
fishing	 tshwaro ya ditlhapi; - tshwara ditlhapi; 
fit	itekanetseng;  itekanetse; 
fitting	 idibalang;  ngategang; lekanyang;  lomaganyang; 
five	tlhano; 
five-year	dingwaga tse tlhano; 
fixed	baakantse;  tlhomile matlho;  ­sa fetweng; 
flag	folaga; 
flags	difolaga; 
flagship	sekepe se se botlhokwa sa sesole; 
flame	kgabo; 
flexibility	temeko; 
flexible	-swedietega; 
flood	morwalela; 
floods	merwalela; 
floor	 bodilo;  foluru; boalo; 
flora	 botshelo jwa semela;  dimedi; dimela; 
floral	ya mebala; 
flow	kelelo; 
flower	 sethunya tšhese; sethunya;  bolomo; 
flows	dikelelo; 
fly	 fofa; ntsi; 
flying	 tsubalalang; fofang; 
focus	 tsepa; tsepamisa; 
focused	tsepamisitse;  tsepile; 
focuses	 tsepa; tsepamisa; 
focusing	 tsepang; tsepamisang; 
follow	 sala morago; latela; 
follow-up	tatelelo; 
followed	latetse;  setse morago; 
following	latelang; 
follows	 sala morago; latela; 
food	dijo; 
foot	kgato;  leoto;  futu;  lonao; 
football	kgwele ya maoto dinao; 
footsteps	dikgato; 
for	gonne; 
force	thata;  maatla;  pateletsa; 
forced	pateleditse;  ;  gapeleditswe; 
forces	maatla;  pateletsa;  dithata; 
forebears	badimo; batsogapele; 
forefront	kwa pele; 
foreign	 boditshaba; motswakwa; 
foreigner	motswakwa;  moditšhaba; 
foreigners	batswakwa; baditšhaba; 
forensic	forensiki; 
forest	sekgwa; 
forestry	 jalo ya dikgwa; tlhokomelo ya dikgwa; 
forests	dikgwa; 
forever	bosakhutleng;  ­bosenabokhutlo; 
forfeited	latlhegetswe;  amogilwe; 
forfeiture	tatlhegelo; 
forge	thula;  bothulelo; 
forged	thudile; 
forget	 gakwa; lebala; 
form	 sebopego;  foroma; foromo;  bopa;  panka; 
formal	ka melawana; 
formally	 ka tshwanelo; semmuso; 
format	fomete; 
formation	 setlhopha sa moretelediane; popo; 
formations	ditlhopha tsa moretelediane; dithulaganyotshameko;  dipopo; 
formed	 bopa [bopile]; sebopego;  bopile; foromile; 
former	pele; 
formerly	 ­pele; ­jale; 
forms	diforomo;  foroma;  dipopego;  bopa; 
formula	sekaelo; 
formulation	popego;  tlhamo; 
forth	­tswelela;  jalo le jalo; 
forthcoming	­tlang; 
forthwith	 ka bonako; ka gangwe; 
forum	 foramo; kopano; 
forums	dikopano;  diforamo; 
forward	 phapa; romela;  kwa pele; 
forwarded	rometse; 
foster	tsweletsa; 
fostering	tsweletsang; 
fought	ntwa;  lwa [lole]; 
found	ribolotswe; 
foundation	motheo; 
foundations	metheo; 
founded	ribolotse; 
founder	mothei; 
founding	ribolotsweng; 
four	nne; 
fourth	­bone; 
frame	 foreimi; kgatlha; 
framework	letlhomeso; 
frameworks	matlhomeso; 
franchise	 tshwaneloboutu; lekwalo la go rekisa; 
fraternity	 bokaulengwe; selekane; 
fraud	tsietso; 
fraudulent	­tsietsa; 
free	 itaola;  gololesega; mahala;  golola; 
freed	 gololesegile;  itaotse; golotse; 
freedom	 boipuso; kgololosego;  kgololosego ya go tsamaya; 
freedoms	 dikgololosego ya go tsamaya;  dikgololosego; boipuso; 
freely	kwa ntle ga tuelo; 
freight	 morwalo;  tefamorwalo; dithoto; 
frequency	lekhubu; 
frequently	gangwe le gape; 
fresh	naana; šwa; 
friend	tsala; 
friendly	­botsalano; 
friends	ditsala; 
friendship	botsalano; 
from	­go tswa mo;  ­go tloga mo; 
front	pele; 
fruit	leungo; 
fruitful	­nonneng;  ­ungwang; 
fuel	 dibeso; setuki; 
fuels	 dibeso; dituki; 
fulfil	digela; 
fulfill	digela; 
fulfilling	­kgotsofatsang; 
full	tletse; 
full-time	nakotletseng; 
fully	 ka botlalo; ka boleka; 
function	 tiriso; dira;  tiro;  go dira;  modiro;  tiro ya go ikgotla; 
functional	dirang; 
functionality	bokgoni jwa go dira; 
functions	 ditiriso; dira;  ditiro;  mediro; 
fund	letlole; 
fundamental	theo; 
fundamentally	ka theo; 
funds	 aba matlole; matlole; 
funeral	poloko;  phitlho; 
furnish	abela; 
furnished	abetse; 
furniture	fenitšhara; 
further	tsweletsa;  fa pele; 
furthermore	­go ya pele; 
future	 pakaisago jaana; bokamoso;  pakaisago gale; 
gain	 boelwa; poelo; 
gained	boetse; 
gains	 boelwa; dipoelo; 
gala	 moletlwana; tiragatso; 
galleries	disoloro; bobontshotsweretshi; 
gallery	disoloro; 
gamble	leka lesego;  -leka lesego;  itekolesego; 
gambling	-lekang lesego;  leka lesego;  itekolesego; 
game	diphologolo;  serapa;  motshameko; 
games	 metshameko ya katiso le karolo; metshameko ya morumo ka bonako;  metshameko ya tlhakanyo;  metshameko ya mopeleto; 
gap	phatlha; 
gaps	diphatlha; 
garden	 segotlo; tshingwana; 
gardens	 digotlo; ditshingwana; 
garnishee	mogapelwa; 
gas	gase; 
gateway	kgoro; 
gather	kokoana; 
gathered	kokoane; 
gathering	 phuthego; kopano;  pitso;  kgotla; 
gave	file;  neile; 
gazette	phasalatso; 
gear	kere; 
geared	kerile; 
gender	bong; 
gender-based	ikaegile ka bong; 
general	kakaretso;  mogenerala; 
generally	ka kakaretso; 
generate	fetlha; 
generated	fetlhile; 
generating	fetlhang; 
generation	 losika; balekane;  phetlho; 
generations	 diphetlho; balekane;  ditshika; 
genres	mefutatlhamo; 
gentlemen	makau; 
geographic	­lefelo;  ­lefatshe; 
geographical	ya thutafatshe;  -ya thutafatshe; 
geography	thutafatshe; 
get	 amogela; bona; 
gets	 amogela; bona; 
getting	 amogela; bona; 
giant	mokaloba;  mogokotlou; 
gift	mpho;  neo; 
girl	mosetsana; 
girls	basetsana; 
give	 naya; fa; 
given	-newa; 
gives	 naya; fa; 
giving	pelonolo; 
glad	 ja monate; itumetse; 
glass	galase; 
global	lefatshe ka bophara; 
globalisation	kanamisotshwano; 
globally	lefatshe ka bophara; 
globe	lefatshe;  kgolokwe; 
glory	tlotlo; 
glossary	lenanefoko; 
go	ya;  tlhomoga;  emoga;  tloga;  tsamaya; 
goal	 nno;  boikemisetso; boikaelelo; 
goals	 boikaelelo; maikemisetso;  dino; 
goes	ya;  tlhomoga;  emoga;  tloga;  tsamaya; 
going	bothata;  botlogo; 
gold	gouta; 
golden	­gouta;  ­botlhokwa; 
gone	 tlhomogile; emogile;  tlogile;  tsamaile; ile; 
good	­ntle;  ­siame; 
goods	 morwalo; dithoto; 
google	batla ka google;  google; 
gore	thula ka dinaka; 
gospel	mmino wa sedumedi; 
got	tshotse;  na le; 
govern	busa; 
governance	 taolo; puso; 
governed	busitse; 
governing	 busang; laolang; 
government	 mmuso; puso; 
government's	­puso; 
governments	 mebuso; dipuso; 
governor	molaodi; 
governors	balaodi; 
grace	tshegofatso; 
grade	seemo;  tlhopha ka seemo;  mophato;  tlhopha;  setlhophana; 
grades	 diemo; tlhopha;  ditlhophana;  mephato; 
grading	tlhophang; 
gradually	ka boiketlo; 
graduate	sealogane;  motsholadikerii; 
graduates	dialogane; batsholadikerii; 
grand	­ntle; 
grant	thuso;  kabelo; 
granted	thuso;  thusa [thusitse];  aba [abile];  kabelo; 
grants	dikabelo;  dithuso; 
graphic	­tshwantsho; 
grass	bojang; 
grassroots	batho fela; 
grateful	leboga; 
gratitude	tebogo;  malebogo; 
grave	lebitla; 
graves	mabitla; 
great	 ­golo; ­tonna; 
greater	­golwane; 
greatest	­golo thata; 
greatly	thata;  ka bogolo; 
green	tala;  botala; 
greenhouse	ntlo ya bogodisetso jwa dijalo; 
greetings	madume; 
grew	 medile; godile; 
grind	 gaila; sila; 
gross	koroso; 
ground	gaitse;  sidile; 
ground-breaking	šwa ; 
groundbreaking	šwa ; 
grounds	 sidile; mebu;  mmuru; 
group	 rulaganya; setlhopha; 
groups	 rulaganya; ditlhopha; 
grow	 mela; gola; 
growing	 melang; golang; 
grown	 medile; godile; 
growth	kgolo; 
guarantee	tshireletsego; 
guarantees	 ditshireletsego; tshepisa; 
guard	molebeledi; 
guardian	 motlamedi; motlhokomedi; 
guest	moeng;  moeti; 
guests	 baeti; baeng; 
guidance	kaelo; 
guide	 mosupatsela; kaela; 
guided	 kaetse;  supa tsela [supile tsela]; mosupatsela; 
guideline	kaedi; 
guidelines	dikaedi; 
guides	 basupatsela; kaela; 
guiding	kaelang; 
guilt	phoso; 
guilty	molato; 
gun	tlhobolo;  sethunya; 
h	bogodimo; 
had	nnile le; 
hail	sefako; 
hailed	sefako;  na ka sefako [nele ka sefako]; 
hails	sefako;  na ka sefako; 
half	 seripagare; halofo; 
hall	ntlolehalahala;  holo; 
hand	seatla;  lenaka;  letsogo; 
handle	ogole; 
handling	tshwaro; 
handover	 neeletsa; neela; 
hands	 dinaka;  matsogo; diatla; 
happen	direga; 
happened	diregile; 
happening	tiragalo e e makatsang; 
happens	direga; 
happy	 lapa la kagiso; boitumelo; 
harassment	henahena; 
hard	 retelela; thata;  pala;  popota;  tiile; 
hare	moduolo; mmutla; 
harm	 senya; molato;  utlwisa botlhoko;  tshenyo; 
harmful	kotsi; 
harmony	kutlwano; 
has	na le; 
hatred	letlhoo; 
have	na le; 
having	nang le; 
hazardous	kotsi; 
he	ene (monna); 
head	tlhogo; 
heading	setlhogo;  ntlhakgolo; 
headline	setlhogo; 
headlines	ditlhogo; 
heads	ditlhogo; 
heal	fola; 
healing	kalafi;  phodiso; 
health	 pholo; boitekanelo; 
healthcare	tlhokomelo ya pholo; 
healthy	itekanetse;  -fodileng; 
hear	 utlwa; reetsa; 
heard	utlwile;  reeditse; 
hearing	theetso;  go utlwa; 
hearings	 ditheetso; go utlwa; 
hears	 utlwa; reetsa; 
heart	 leiso; gare;  pelo; 
heavy	 -bokete; bokete; 
hectare	 tekanyo; heketara; 
hectares	diheketara; ditekanyo; 
height	 bogodimo;  bogodimo ba thabana; boleele; 
heights	 bogodimo;  bogodimo ba thabana; boleele; 
held	dutile; 
help	 thuso;  femela; thusa; 
helped	thusitse;  femetse; 
helping	tshola; 
helps	 thuso;  femela; thusa; 
hence	ke ka moo; 
her	ene (mosadi); 
heraldry	thutasekao (coats and arms); 
here	fa;  fano; 
hereby	ka se; 
hereinafter	morago ga se; 
heritage	boswa; 
hero	mogale;  mogaka; 
heroes	 bagaka; bagale; 
heroine	mogale; 
heroines	bagale; 
herself	ka boene (mosadi); 
hide	letlalo; 
hierarchies	ditatelano tsa maemo; 
high	godimo; 
high-level	kwa godimo; 
higher	godingwana; 
highest	godimodimo; 
highlight	gatisa;  fetola mmala wa moriri;  tshwaya; 
highlighted	 tshwaile; gatisitse;  fetotse mmala wa moriri; 
highlights	ditiragalo tsa botlhokwa; 
highly	thata; 
hill	mmoto; 
hills	dithabana; 
him	ene (monna); 
himself	ka boene (monna); 
his	gagwe (monna); 
historian	mohisetori; 
historians	bahisetori; 
historic	 ­bogologolo; ­mo nakong e e fetileng; 
historical	hisetori; 
historically	bogologolo; 
histories	 hisetori; ditiragalo; 
history	 hisetori; ditiragalo; 
hit	betsa;  itaya;  konopa; 
hold	duta; 
holder	seduti; 
holders	diduti; 
holding	dišere; 
holdings	dišere; 
holds	duta; 
holiday	boikhutso; 
holidays	boikhutso; 
holistic	ka gotlhe; 
homage	tlotlo; 
home	legae; 
homelessness	botlhokagae; 
homepage	tsebekgorogo; 
homes	magae; 
hominid	sekamotho; 
honorary	tlotla; 
honour	 tlotlego; tlotlo;  tlotla; 
honourable	 yo o tlotlegang; motlotlegi; 
honoured	tlotlegile;  tlotlilwe; 
honouring	tlotlang; 
honours	onase; 
hope	tshepo; 
hoped	tshepile; 
hopefully	ka tsholofelo; 
hopes	tshepo; 
hospital	 sepetlele; bookelo; 
hospitality	 thelesetso; tsholo; 
hospitals	maokelo;  dipetlele; 
host	mong-gae; 
hosts	beng-gae; 
hotel	hotele; 
hotels	dihotele; 
hour	 iri; ura; 
hours	diura; 
house	ntlo; 
household	 ditsalapa; legae; 
households	 ditsalapa; magae; 
houses	dintlo; matlo; 
housing	ntlo;  bonno;  kagomatlo; 
how	jang; 
however	 le fa go ntse jalo; le gale; 
hub	pelo;  bogare;  legare; 
huge	­golo; 
human	 ya motho;  setho; motho; 
humanities	dithuto tsa saense ya botho; 
humanity	 dithuto;  go rata batho; botho; 
humankind	batho; 
humans	batho;  ya motho;  setho; 
humble	 boikokobetso; boikobo; 
humbled	ikokobeditse; 
humility	 boikokobetso; botho; 
hundred	lekgolo; 
hundreds	makgolo; 
husband	mogatsa (monna); 
icon	tshupane; 
iconic	aekhone; ­tumileng; 
icons	ditshupane; 
idea	kgopolo; 
ideal	maikaelelo; 
ideals	maikaelelo; 
ideas	dikgopolo; 
identical	tshwanang tota; 
identification	temogo; 
identified	lemogile;  supile; 
identifies	lemoga;  supa; 
identify	lemoga;  supa; 
identifying	supang;  lemogang; 
identities	ditlhaolo; boitshupo; 
identity	 tlhaolo; boitshupo; 
if	 fa e le gore; fa; 
ill	 bobola;  utlwa botlhoko;  ­maswe; lwala; 
illegal	- seng molaong; 
illiteracy	go sa itse go kwala le go bala; 
illness	bolwetse; 
illustrate	tlhalosa;  kaya;  sedifatsa; 
illustrated	tlhalositse;  kaile;  sedifaditse; 
image	setshwano; 
images	ditshwano; 
imagination	kakanyo; 
imbalances	botlhokatekatekano; 
immediate	fela jaanong; 
immediately	ka bonako;  jaanong jaana; 
immense	kgologadi; 
immensely	thata; 
immigration	khudugelo; 
imminent	­bonako; 
immovable	­sa suteng; 
immunisation	moento;  tlhabela;  tshoutiso; 
impact	thulano; 
impaired	koafetse; 
impediments	dikgoreletsi; 
imperative	modirisotaelo; 
imperatives	medirisotaelo; 
implement	diragatsa;  sediriswa; 
implementation	tiriso; 
implemented	diragaditse; 
implementing	diragatsang; 
implements	diragatsa; 
implications	bokao; 
implies	 raya; kaya; 
import	ditswantle;  serapo;  raopa; 
importance	botlhokwa; 
important	 tlhokegang; botlhokwa; 
importantly	ka botlhokwa; 
imported	raopile; 
importer	moraopi; 
imports	ditswantle; 
impose	gobetsa; 
imposed	gobeditse; 
imposing	gobetsang; 
imposition	kgobetso; 
impossible	- sa kgonege; 
impressed	kgatlhegile; 
impressive	­kgatlhisang; 
imprison	 golega; -tswalelwa kgolegelong; 
imprisoned	golegilwe;  -tswaletswe kgolegelong; 
imprisonment	tswaletswe; 
improper	­seng maleba; 
improve	tokafatsa; 
improved	tokafaditse; 
improvement	tokafatso; 
improvements	ditokafatso; 
improving	tokafatsang; 
inability	bosenathata; 
inadequate	­sa lekanang; 
inappropriate	­seng maleba; 
inaugural	tlhomo; 
inauguration	tlhomo; 
incapable	­se na bokgoni; 
incapacity	tlhaelo ya bokgoni; 
incarceration	 golega; tshwara; 
incentive	 rotloetsang; tlhotlheletso; 
incentives	ditlhotlheletso; 
inception	 tshimologo; tlholego; 
incident	tiragalo; 
incidental	wela; 
incidents	ditiragalo; 
include	akaretsa; 
included	akareditse; 
includes	akaretsa; 
including	mmogo; 
inclusion	go tsenya; 
inclusive	­tsenyeletsang;  ­akaretsang; 
inclusivity	kakaretso; 
income	lotseno; 
incomes	lotseno; 
incomplete	­sa felelang; 
inconsistent	-sa tshwane; 
incorporate	tlhakanya; 
incorporated	tlhakantse; 
incorporates	tlhakanya; 
incorporation	kopanyo;  tlhakanyo; 
incorrect	fosagetse; 
increase	oketsa; 
increased	okeditse; 
increases	oketsa; 
increasing	oketsang; 
increasingly	 ka totafalo; ka koketsego;  ka ntsifalo; 
inculcate	tlhabelela; 
incurred	tshwanelo ya tuelo; 
indaba	kgothakgothe; 
indeed	e le ruri; ka mannete; 
independence	boipuso; 
independent	ipusang; 
independently	ka kemonosi; 
index	tshupane; 
indicate	supa; 
indicated	supile; 
indicates	supa; 
indicating	supang; 
indication	 sesupo;  kaelo; sekao; 
indications	 disupo; dikaelo;  dikao; 
indicative	­supa; 
indicator	 sekaedi; sebontshi;  sebontshiphetodi; 
indicators	dibontshi; dibontshaphetodi; dikaedi; 
indices	ditshupane; 
indigenous	 -tlholegileng; tlholegileng; 
indirect	motsopodia; 
indirectly	­sa tlhamalalang; 
individual	 ka nosi; nosi; 
individually	 ka nosi; ka bongwe; 
individuals	 batho ka nosi;  ka nosi; nosi; 
industrial	 sa diatla; intaseteri; 
industries	 diintaseteri; madirelo; 
industry	 bodirelo; intaseteri; 
inequalities	ditlhokatekatekano; 
inequality	tlhokatekatekano; 
infected	tshwaeditswe; 
infection	tshelo;  tshwaetso; 
infections	ditshelo;  ditshwaetso; 
inferior	nyatsegang; 
inflows	tseno;  kgorogo; 
influence	 - tlhotlheletsa; tlhotlheletso; 
influenced	tlhotlheleditse; 
informal	e seng ka tlwaelo; 
information	tshedimosetso; 
informed	 boleletse; itsisitse; 
informing	itsiseng; 
infrastructure	 dithulaganyetso tsa; mafaratlhatlha; 
inherent	karolo e e ka se kgaoganngweng; 
inherit	- ja boswa;  go ja boswa; 
inherited	jele boswa; 
initial	 tlhakaina; pele; 
initially	kwa tshimologong; 
initiate	- ya lebololo; 
initiated	go kwala ditlhakaina; 
initiative	itshimololelo; 
initiatives	diitshimololelo; 
initiator	mosimolodi; moitshimololedi; 
injuries	dikgobalo;  dikhutlego; 
injury	kgobalo;  khutlego; 
injustice	tshokelelo; 
injustices	ditshokelelo; tlhokabosiamisi; 
inmates	batshwarwa, mapantiti; 
inner	ka fa gare; 
innovative	go itlhamela; 
input	tsenya tshedimosetso;  setsenngwa;  tshedimosetsotsenngwa; 
inputs	tsenya tshedimosetso; ditsenngwa;  tshedimosetsotsenngwa; 
inquest	ditlhotlhomiso; 
inquiry	patlisiso; 
inscribed	kwadile;  thadile; 
insert	tsenya; 
inserted	tsentse; 
insertion	tsenyo;  kgokelo; 
inside	-teng; 
insight	tshedimosetso; 
insights	bokgoni jwa go tlhaloganya; 
insolvency	botšhoni; 
insolvent	tšhona; 
inspect	tlhatlhoba; 
inspection	 - tlhatlhoba; tlhatlhobo; 
inspections	ditlhatlhobo; 
inspector	motlhatlhobi; 
inspectorate	setlhopha sa batlhatlhobi; 
inspectors	batlhatlhobi; 
inspiration	kgothatso;  go tiya mooko; 
inspire	tlhotlheletsa; 
inspired	tlhotlheleditse; 
inspiring	tlhotlheletsang; 
install	tsenya;  gokela; 
installation	kgokelo; 
installed	goketse; 
instalment	karolotuelo; 
instalments	dikarolotuelo; 
instance	sekai; 
instances	dikai; 
instead	mo boemong jwa; 
institute	setheo; 
institution	setheo; 
institutional	­setheo; 
institutions	ditheo; 
instruction	taelo; 
instructional	 ­rutang; ­laelang; 
instructions	ditaelo; 
instrument	 seletso; sediriswa;  sediriso; 
instruments	didiriswa;  didiriso;  diletso; 
insufficient	go sa lekana; 
insurance	putlelelo; 
insurer	moabi wa inšorense; 
intangible	tlhokatlhaloso; ­sa tshwaregeng; 
integral	tletseng; 
integrate	 lotana; kopanya; 
integrated	kopane;  lotane; 
integration	lotano; 
integrity	tshiamo; 
intellectual	­tlhaloganyo; 
intellectuals	batlhalefi; 
intelligence	bokgoni;  tlhalefo;  matlhale; 
intend	ikaelela; 
intended	ikaeletse; 
intends	ikaelela; 
intensify	­maatlafatsa; 
intensive	tirisisi; 
intent	maikaelelo; 
intention	maikaelelo;  maitlhomo; 
intentionally	ka bomo;  ka maikaelelo; 
inter	­gare; 
interact	 dirisana; tirisano; 
interacting	dirisanang; 
interaction	tlhotlheletsano; 
interactive	tshedimosetsano; 
interception	 kgaoletso; kgoreletso; 
interdepartmental	­gare ga mafapha; 
interest	 dinamanyane; kgatlhego;  tsalo;  kgatlha; 
interested	kgatlhegile; 
interesting	kgatlhang; 
interests	 dinamanyane; dikgatlhego; dikgatlhiso;  kgatlha;  ditsalo; 
interfaith	­gare ga badumedi; 
interfere	kgoreletsa; 
interference	kgoreletso; 
intergenerational	­gare ga ditshika; 
intergovernmental	­gare ga dipuso; 
interim	nakwana;  sebakana; 
intermediaries	batsereganyi; 
intermediary	tsereganyo; 
intermediate	­magareng; 
internal	 -ka fa teng; teng;  -teng; 
international	boditšhabatšhaba; 
internationally	boditšhabatšhaba; 
internet	inthanete; 
interns	baithutelatirong; 
internship	ithutelotirong; 
interpret	ranola;  - ranola;  toloka; 
interpretation	toloko; 
interpreted	ranotse; tolokile; 
interrogate	botsolotsa; 
interval	kgaotso; 
intervene	 tsena gare; kgaoganya; 
intervention	tsenogare; kgaoganyo; 
interventions	dikgaoganyo; ditsenogare; 
interview	potsotherisano;  go tshwara ditherisano; 
interviews	dipotsotherisano;  go tshwara ditherisano; 
intestate	go sa aba boswa; 
into	mo teng; 
introduce	tlhagisa;  - tlisa;  - tshela;  itsise; 
introduced	tlhagisitse;  itsisitse;  tlisitse; 
introducing	tlhagisang;  itsiseng;  - tlisang; 
introduction	tlhagiso; 
invalid	sekoa; 
invaluable	sa botlhokwa; 
inventory	lenanethoto; 
invest	 gwebisa; beeletsa; 
invested	gwebisitse; beeleditse; 
investigate	batlisisa; 
investigated	dikgaotso; 
investigating	batlisisang; 
investigation	patlisiso; 
investigations	dipatlisiso; 
investigative	­patlisiso; 
investigator	mmatlisisi; 
investigators	babatlisisi; 
investing	 beeletsang; gwebisang; 
investment	 tsadiso; peeletso; 
investments	dipeeletso;  ditsadiso; 
investor	mmeeletsi; 
investors	babeeletsi; 
invitation	taletso; 
invite	- laletsa; 
invited	- laleditse; 
inviting	- laletsang; 
involve	akaretsa; 
involved	akareditse; 
involvement	go akaretsa; 
involves	akaretsa; 
involving	akaretsang; 
iron	 tshidilo;  aene; tshipi;  sidila; 
irregular	sa tlhamalala; 
irregularities	dithulaganyo-botlhaswa; 
irrespective	go sa tshwenye; 
irrigation	nosetso; 
isiXhosa	puo ya isiXhosa; 
island	 setlhake; setlhaketlhake; 
issue	tlhagiso; 
issued	tlhagiso;  tlhagisitse; 
issues	ditlhagiso; 
item	ntlhana;  ntlhana ya; 
items	dintlhana; 
itself	sebele;  bosone; 
jazz	jese; 
jewellery	dibenya; 
job	tiro; 
jobs	ditiro; 
join	lomaganya; 
joined	lomagantse; 
joining	lomaganyang; 
joint	tokololo;  tomaganyo; 
jointly	ka kopanelo; 
journalism	bobegakgang; 
journalist	mojenalese; 
journalists	babegakgang; 
journey	 eta; leeto; 
joy	boipelo;  boitumelo; 
judge	moatlhodi;  atlhola; 
judgement	katlholo; 
judges	atlhola;  baatlhodi; 
judgment	katlholo; 
judgments	dikatlholo; 
judicial	katlholelo; 
judiciary	bosiamisi; 
junior	mmotlana; 
jurisdiction	taolo; 
jurisdictions	ditaolo; 
juristic	mothomolaong; 
just	­lolame;  ­siame; 
justice	bosiamisi; 
justified	siamisitswe;  ­utlwalang;  rulagantswe (ditsebe); 
justify	 siamisa; rulaganya; 
keen	 šwegašwega; tlhaga; 
keep	tshola;  boloka;  dibela; 
keeping	ka go tshwantshanya; 
kept	 dibetse;  bolokile; tshotswe; 
key	 senotlolo;  dinnoto; kaedi;  khii;  taetsi;  konopo; 
keynote	 morero wa botlhokwa; nnotokhii; 
kick	raga; 
kill	bolaya; 
killed	bolaile; 
kilometre	kilometara; 
kilometres	dikilometara; 
kind	siama; 
kindly	 ka bopelotlhomogi; ka bopelonomi; 
king	kgosi; 
kingdom	puso;  bogosi; 
kings	dikgosi; 
knew	itsile; 
know	itse; 
knowing	­kitso; 
knowingly	ka kitso; 
knowledge	kitso; 
known	itsile; 
knows	itse; 
laboratories	dilaboratori; 
laboratory	laboratori; 
labour	 go belega; dira;  leralelo;  tiro; 
lack	 go tlhoka; tlhoka; 
ladies	makgarebe; 
laid	beile;  beetse; 
lake	letsha; 
land	lefatshe;  tshimo;  kotama; 
landfill	 epa thotobolo; thotobolo ya mo tlase ga mmu; 
lands	mafatshe; 
landscape	lenaga; 
language	puo; 
languages	dipuo; 
lapse	 kgeloga; tlhaela; 
large	kgolo; 
large-scale	ka bontsi; 
largely	ka bogolo; 
larger	kgolwane; 
largest	kgolokgolo; 
last	bofelo; 
lasting	tshwarelelang; 
lastly	kwa bofelong; 
late	 setswe;  tlhokafetse; thari; 
later	moragonyana; 
latest	­sešweng; 
latter	morago; 
laughter	setshego; 
launch	tlhasela; 
launched	tlhasetse; thankgolotse; 
launches	tlhasela; thankgolola; 
launching	thankgololang; tlhaselang; 
laundering	 utswa madi; tlhatswa; 
laureate	moamogelatlotla (kabo ya Nobele); 
laureates	baamogelatlotla; 
law	molao; 
law-making	tlhomo-molao; 
lawful	­semolao;  ­letleletswe; 
lawfully	ka molao;  ka tetla; 
laws	melao; 
lawyer	ramolao;  agente; 
lawyers	 diagente; boramolao; 
lay	 beela; baya; 
laying	 beelang; bayang; 
lead	lloto;  bothale; 
leader	moeteledipele; 
leaders	baeteledipele; 
leadership	 baetapele; boeteledipele;  ketapele; 
leading	eteletse pele; 
leads	bothale; dilloto; 
leaflet	letlhatshana; 
leaflets	matlhatshana; 
league	 lliki; kgolagano; 
learn	ithuta; 
learned	ithuta; 
learner	morutwana; 
learners	barutwana; 
learning	ithuta; 
learnt	ithutile; 
lease	khiriso ya setsha; 
leased	 hirisa [hirisitse]; khiriso ya setsha; 
leasehold	thekokhiro; 
least	 bobotlana; bonnye; 
leave	khunologo; 
leaves	dikhunologo; 
lecture	thuto;  ruta; 
left	molema; 
leg	 leoto; letlhakore; 
legacies	boswa; 
legacy	boswa; 
legal	molao;  - semmuso; 
legally	ka molao; 
legend	noolwane; 
legendary	 ­itsegeng; ­tumileng; 
legends	dinoolwane; 
legislation	peomolao; 
legislative	­peomolao; 
legislature	kokoanopeomolao; 
legislatures	dikokoanopeomolao; 
legitimacy	ka molao; 
legitimate	­ka fa molaong; 
lend	adima; 
lending	adimang; 
length	boleele; 
less	 -nnye; nnye; 
lesser	 bobotlana go; ­nnye go; 
lesson	thuto; 
lessons	dithuto; 
let	rebola;  mma;  letlelela;  letla; 
letter	lekwalo;  tlhaka; 
letters	 ditlhaka; makwalo; 
level	 lekalekanya; bogodimo;  lekalekane;  baterepasa; 
levels	 lekalekanya; dibaterepase; bogodimo; 
levies	makgethwana; 
levy	lekgethwana; 
liabilities	melato; 
liability	molato; 
liable	boikarabelo; 
liaise	gokaganya; 
liaison	kgokaganyo; 
liberalisation	phokotsobogale (molao); 
liberation	kgololosego; 
librarian	molaeborari;  radirekoto;  ramabuka; 
librarians	 boramabuka; balaeborari;  boradirekoto; 
libraries	dilaeborari; dipolokelarekoto; 
library	 polokeladirekoto; laeborari;  mabuka; 
licence	laesense;  lekwalotetla; 
licences	dilaesense;  makwalotetla; 
license	lekwalotetla; 
licensed	 ­letlelesegile;  ­na le lekwalotetla; ­na le laesense; 
licensee	moletlwa ; 
licensees	baletlwa; 
lie	tsela e lesea le robalang ka yona mo popelong; 
life	botshelo; 
lifetime	botshelo botlhe; 
light	 tshuba; lesedi;  bofefo;  kganya;  botlhofo; 
lighting	dipone; 
like	 tshwana le; rata; 
likely	­na le kgonagalo ya; 
limit	 tekano; tekanyetso; 
limitation	tekanyetso; 
limitations	ditekanyetso; 
limited	lekanyeditswe; 
limits	ditekanyetso;  ditekano; 
line	 aletsa; mola;  mothaladi; 
line'	 aletsa;  methaladi; mela; 
line-up	 mokoloko; kologano; 
lines	mela; 
link	gokaganya;  segokaganyi;  segoke; 
linkage	kgokagano; 
linkages	dikgokagano; 
linked	gokagantse; 
linking	gokaganyang; 
links	dikgoke; dikgokagano; 
liquid	seedi; 
liquidation	tlhaoloso; 
liquidator	motlhaolosi; 
liquidity	boedi; 
liquor	bojalwa; 
list	 lenaane; lenane; 
listen	reetsa;  sekega tsebe; 
lists	manane; 
literacy	bokgoni jwa go kwala le go bala; 
literally	go ya ka bokaotota; 
literary	­dikwalo; 
literature	dikwalo; 
litigation	tleleimi (kgotlatshekelo); 
little	 lemme; nnye; 
live	tshela; 
lived	tshedile; 
livelihoods	metswedituelo; 
lives	matshelo; 
livestock	 diruiwa; loruo; 
living	tshelang; 
load	morwalo; 
load-shedding	kgaolo ya motlakase; 
loan	kadimo; 
loans	dikadimo; 
local	selegae;  tikologo; 
locally	selegae; 
locals	selegae; 
located	­fitlhelwa; 
location	 lekeišene; lefelo; 
lock-up	notlela; 
lodge	 bonno ba nakwana; ntlo; 
lodged	tlhomile;  file bonno jwa nakwana; 
lodging	bonno ba nakwana (ntlo); 
long	-telele; 
long-term	pakatelele; 
longer	telejana; 
look	sheba; leba; 
looked	lebile; 
looking	lebang; shebang; 
looks	ditebego; 
loop	segole; 
lose	fenngwa; 
loss	 phesente; tatlhegelo; 
losses	diphesente; ditatlhegelo; 
lost	fentswe; 
lot	botshelo jwa motho; 
love	rata; 
loved	ratile; 
lovers	baratani;  dinyatsi; 
low	-tlase; 
low-income	lotseno le le kwa tlase; 
lower	 ­tlase;  isa tlase; fokotsa; 
lowest	tlasetlase; 
lump	 mokoma;  kuruga; lengothe; 
mace	letlhotlho; 
machine	motšhini; 
machinery	metšhini; 
machines	metšhini; 
macro-economic	ikonomikgolo; 
macroeconomic	ikonomikgolo; 
made	dirile;  modiro; 
magazine	makasine;  selata sa dikolo; 
magazines	dimakasine;  dilata sa dikolo; 
magisterial	­magiseterata; 
magistrate	 moatlhodi; magiseterata; 
magistrate's	ya ga magiseterata; 
magistrates	bomagiseterata; 
magnificent	­tlotlomala; 
magnitude	bogolo; 
mail	poso;  posa;  setimela; 
main	­golo; 
mainly	bogolosegolo; 
mainstream	mekgwatirisogale; ­amogelwang ke batho; 
mainstreaming	­akaretsa; 
maintain	tshegetsa; 
maintained	tshegeditse; 
maintaining	tshegetsang; 
maintains	tshegetsa; 
maintenance	 - siamisa; tlamelo;  tshegetso; 
major	 majoro;  mogodi; golo; 
majority	 bontsi; bogolo; 
make	dira;  modiro; 
makers	 batlhodi; badiri;  babopi; 
makes	dira;  mediro; 
making	dirang; 
malaria	letadi; 
male	monna;  bongtona; 
males	banna; 
mall	mmolo; 
man	tlamela; 
manage	 laola; kgona; 
managed	kgonne;  laotse; 
management	 - laola;  taololbolaodi; balaodi; 
manager	molaodi; 
managers	batsamaisi;  balaodi; 
manages	 laola; kgona; 
managing	 laolang; kgonang; 
mandate	taolelo; 
mandates	ditaolelo; 
mandatory	­taolelo; 
manifestations	diponalo;  ditshenolo; 
manner	mokgwa; 
manual	 ya diatla; mosupatsela; 
manufacture	dira;  bopa; 
manufactured	dirile;  bopile; 
manufacturer	modiri; 
manufacturing	bopopo; 
manuscript	leyakgatiso; 
manuscripts	mayakgatiso; 
many	 -ntsi; ntsi; 
map	 mmapa; mmepe; 
mapping	go thadisa; 
maps	dimmapa; 
march	mogwanto;  -gwanta; 
marched	mogwanto;  gwantile;  -gwanta; 
margin	losi;  moolwane; 
marginal	mo molelwaneng; 
marginalised	beetsweng kwa thoko; 
marginalized	beetsweng kwa thoko; 
marine	lewatle; 
maritime	­lewatle; 
mark	 tshwaya;  leduo; letshwao; 
marked	 tshwaile; supile; 
market	 borekisetso;  rekisa;  bagwebi; mmaraka; 
marketing	papatso; 
markets	 mebaraka;  bagwebi;  marekisetso; rekisa; 
marking	 go disa; letshwao; 
marks	matshwao;  tshwaya;  maduo; 
marriage	lenyalo; 
marriages	manyalo; 
married	nyetse; 
mass	 bontsi; bogolo;  boima; 
massive	­golo; 
master	 mothapi; mong;  molaodi; 
master's	­molaodi; 
match	 kgaisano;  mokgwaro;  nyalanya;  - tshwana; tshwana;  motshameko;  nyalano; 
matches	mokgwaro; 
material	 sediro; lesela;  sere; 
materially	ka tiriso ya dimatheriale; 
materials	 matsela; didiro; dire; 
maternal	mmê; 
mathematical	 ­dipalo; ­mathematikisi; 
mathematics	dipalomathaithai;  matesisi; 
matric	marematlou; materiki; 
matrimonial	­lenyalo; 
matter	boladu;  sere; 
matters	 maladu; dire; 
maturity	 - gola; bogodi; 
maximise	oketsa; 
maximum	makisimamo;  botlalogolo;  -golo; 
may	ka;  motsheganong; 
maybe	ka gongwe; 
mayor	ramotse; 
mayors	boramotse; bomeiyare; 
me	nna; 
mean	 raya; kaya;  timana; 
meaning	bokao; 
meaningful	­nang le bokao; 
meaningfully	ka bokao; 
meanings	bokao; 
means	mekgwatiriso; 
meant	 reile;  timane; kaile; 
measurable	lekanyegang; 
measure	 kelo;  boleele;  lekanya;  mothamo;  tekanyo;  boima; nako; 
measured	lekanyeditse; 
measurement	tekanyo; 
measures	 boleele; lekanyetsa;  dikelo;  lekanya;  methamo;  ditekanyo;  boima; 
measuring	lekanya; 
mechanical	tlwaelo; 
mechanism	karolothulaganyo; 
mechanisms	bomotšhini;  dikarolothulaganyo; 
media	boradikgang; 
mediation	tsenogare; thuanyo; 
medical	bongaka;  - bongaka; 
medicine	 setlhare; molemo; 
medicines	melemo;  ditlhare; 
medium	puo ya go ruta; 
medium-term	pakagare; 
meet	kopana;  rakana;  kgatlhana;  phuthega; 
meeting	 phuthego; kopano; 
meetings	 diphuthego; dikopano; 
meets	kopana;  rakana;  kgatlhana;  phuthega; 
mega	­milione; 
melting	 tlhapolosang; gakolosang; 
member	tokololo; 
member's	­leloko; 
members	ditokololo; 
membership	botokololo; 
memorable	- gopolwa; 
memorandum	memorantamo; 
memorial	sefikantswe; 
memories	 dikgakologelo; dikgopolo; 
memory	 kgakologelo; kgopolo; 
mental	 tsa kgopolo; kakanyo; 
mentally	kgopolo; 
mention	- reelela; 
menu	lenanedijo;  lenaanetlhopho; 
merchant	mogwebi; 
mere	fela; 
merely	fela; 
merger	 tshwaraganyo (ditlamo); kopanyo; 
merit	 tuelo; tshwanelo; 
merits	ditshwanelo;  dituelo; 
message	molaetsa; 
messages	melaetsa; 
messenger	morongwa; 
met	kopane;  rakane;  phuthegile;  kgatlhane; 
metal	metale;  mmetale; 
metals	 dimmetale; dimetale; 
method	tsela;  mokgwa; 
methodology	thutatsela; 
methods	mekgwa;  ditsela; 
metro	­terena; 
metropolitan	­toropokgolo; 
micro	­nnyennye; 
middle	-gare; 
midst	­go dikologa; 
might	nonofo;  boganka; 
migration	khudugo; 
milestones	diphitlhelelobotshelo; 
military	sesole;  bosole; 
milk	 lebese; maswi;  mašwi; 
million	milione;  mileone; 
millions	dimilione;  dimileone; 
mind	 mogopolo; tlhaloganyo; 
mindful	 ­gopola; gakolola ; 
minds	megopolo;  ditlhaloganyo; 
mine	moepo;  epa;  rafa; 
mineral	 minerale; menerale; 
minerals	senotsididi; 
mines	meepo;  epa;  rafa; 
minimise	 - fokotsa; fokotsa; 
minimum	bonnye;  minimamo; 
mining	 - epa; epa; 
minister	 moruti; tona; 
minister's	­tona; 
ministerial	- botonakgolo; 
ministers	 baruti; ditona; 
ministry	 boruti; lefapha; 
minor	 mmotlana;  -botlana; potlana; 
minority	 bobotlana; bonnye; 
minutes	metsotso; 
misconduct	maitsholomabe; 
misleading	­phoso; 
missing	-tlhaelang; 
mission	tiro ya borongwa; 
missions	ditiro tsa borongwa; 
mitigate	fokotsa; 
mitigation	phokotso; 
mix	tlhakanya;  tswaka; 
mixed	 tlhakantse;  ­tswakantsweng;  ­tlhakaneng; tswakanya; 
mobile	suta; 
mobilisation	tlhotlheletso; 
mobilise	tlhotlheletsa; 
mobility	tshutisego; 
model	 go dira sekao;  sebopegokakangwa; sekao; 
models	dipopegokakangwa;  go dira sekao; dikao; 
moderate	bogareng; 
modern	­sešweng; 
modernisation	ntšhwafatso; 
modified	fetotse; 
modify	fetola; 
moment	nakwana; 
moments	dinakwana; 
momentum	koketsego; 
monetary	 ­madi; ­tšhelete; 
money	tšhelete; 
moneys	madi;  ditšhelete; 
monies	madi;  ditšhelete; 
monitor	 baya leitlho; molebeledi; 
monitored	beile leitlho; 
monitoring	beile leitlho; 
monitors	 baya leitlho; balebeledi; 
month	kgwedi; 
monthly	ka kgwedi; 
months	dikgwedi; 
monument	sefikantswe; 
monuments	difikantswe; 
moral	thuto;  ngwao;  dingwao; 
more	go feta; 
moreover	mo godimo ga moo; 
morning	 mosong;  phakela; moso; 
mortality	loso; 
mortgage	peelelo; 
most	-ntsi; 
mostly	gantsi;  bontsi jwa nako; 
mother	mme; 
mothers	bomme; 
motion	motsamao;  tshitshinyo; 
motions	ditshitshinyo;  metsamao; 
motivation	thotloetso; 
motor	mmotoro; 
motto	moano;  moane; 
mountain	thaba; 
mountains	dithaba; 
mouth	 kgwelo; molomo; 
movable	sutisega; 
move	 tshuto; sutisa; 
moved	sutisa; 
movement	 tshikhinyego;  motsamao; mokgatlho; 
movements	mekgatlho; ditshikinyego;  metsamao; 
moves	ditshuto; sutisa; 
movie	baesekopo; 
moving	­sutang; 
much	­ntsi; 
multi-party	­makokomantsi; 
multilateral	­ditlhophadintsi; dinagantsi; 
multilingual	­dipuontsi;  ­ditementsi; 
multilingualism	bopuontsi; 
multimedia	tlhaeletsanophata; 
multiparty	-makokomantsi; 
multiple	katisanetswa; 
municipal	mmasepala; 
municipalities	bommasepala; 
municipality	mmasepala; 
murals	ditakokgolo; 
murder	bolaya;  polao; 
museum	musiamo; 
museums	dimusiamo; 
music	mmino; 
musicians	borammino; 
must	tshwanetse;  tshwanela; 
mutual	­tshwanang; 
mutually	ka go tshwana; 
myself	nna ka sebele; 
name	leina;  raya leina; 
named	teile leina; 
namely	e bong;  ke go re; 
names	 raya leina; maina; 
narrative	kanelo; 
narrow	 -tshesane; tshesane; 
natal	­pelegi; 
nation	setšhaba; 
national	 bosetšhaba; setšhaba; 
nationality	bosetšhaba; 
nationally	­bosetšhaba; 
nationals	setšhaba; 
nationhood	bosetšhaba; 
nations	ditšhaba; 
native	semelafa; 
natural	 lebusetsannotong;  ka tlhago; tlholego; 
nature	 tlhago; mokgwa; 
near	gaufi; 
nearest	gautshwane; 
nearly	 bokana ka; gaufi le; 
necessarily	tlhokegang; 
necessary	tlhokegang; 
need	 setlhokwa; batla; 
needed	batlile; 
needs	batla;  ditlhokwa; 
negative	 palotlase ga lefela; kganetso; 
negatively	ka kganetso; 
neglect	 go tlhokomologa;  tlogelela; tlhokomologo;  tlhokomologa; 
neglected	 tlhokomologile; tlogeletse; 
negligence	botlhaswa; 
negotiate	rerisana; 
negotiated	rerisane; 
negotiating	rerisanang; 
negotiation	therisano; 
negotiations	ditherisano; 
neighbouring	 mabapa;  ­dikologileng; ­agisaneng; 
neither	le e seng; 
net	 makopanelofaratlhatlha; letlowa; 
network	 mararang; kgokagano; 
networking	 mararang; kgokagano; 
networks	 mararang; dikgokagano; 
never	le goka; 
nevertheless	le mororo;  le fa go ntse jalo; 
new	šwa; 
newly	ka bošwa; 
news	dikgang; 
newsletter	lokwalodikgang; 
newsletters	makwalodikgang; 
newspaper	 lokwalodikgang; kuranta; 
newspapers	makwalodikgang;  dikuranta; 
newsroom	phaposikgang; 
next	-latelang; 
night	bosigo; 
nine	robongwe;  robonngwe; 
no	nnyaa; 
noble	­tlotlegang; 
nominal	 tšhelete e nnye; madi a mannye; 
nominate	tlhagisa;  ikgethela; 
nominated	tlhagisitse;  ikgethetse; 
nomination	tlhagiso; 
nominations	ditlhagiso; 
non	­seng; 
non-compliance	­seng kobamelo; 
non-governmental	­seng puso; 
non-profit	­seng ya poelo; 
non-racial	­seng lotso;  ­seng mmala; 
non-refundable	pusetso;  ­seng; 
non-sexism	­seng kgethololo ya bong; 
non-sexist	­sa kgetholole ka bong; 
non-tax	­seng lekgetho; 
none	epe; 
nor	le fa e le; 
normal	tlwaelo;  siame; 
normally	ka gale; 
norms	ditlwaelo;  meetlo; 
north	 ya leboa;  leboa; bokone; 
northern	­bokone; 
not	e seng; 
notable	­itsegeng; 
notably	ka kitso; 
note	 kwala; ntlha;  nnoto;  ledi la pampiri;  segalo;  ela tlhoko; 
noted	kwadilwe; 
notes	dintlha tsa thuto; 
nothing	sepe; 
notice	lemoga;  tshedimoso;  temogo;  kitsiso; 
notices	lemoga;  dikitsiso;  ditshedimoso;  ditemogo; 
notification	 temoso; kitsiso; 
notified	 lemositse; itsisitse; 
notify	itsise;  lemosa; 
noting	tseile tsia;  elang tlhoko; kwalang; 
notion	mogopolo; 
notwithstanding	go sa tlhokomologwe; 
novel	padi; 
now	jaanong; 
nuclear	nyutlelia; 
null	se nang boleng; 
number	 nomore; palo; 
numbers	dipalo;  dinomoro; 
numerous	ntsintsi;  -ntsintsi; 
nurse	 oka; mooki; 
nurses	 oka; baoki; 
nursing	 tiro ya booki; okang; 
nurture	 otla;  godisa; tlamela; 
nurturing	 otlang; tlamelang;  godisang; 
nutrition	kotlo; 
oath	maikano; 
object	 sedirwa; selo;  sere; 
objection	dikemokgatlhanong; 
objections	dikemokgatlhanong; 
objective	maitlhomo;  kwa ntle ga boitebo; 
objectives	maitlhomo; 
objects	 dire; dilo;  didirwa; 
obligation	pateletsego; 
obliged	 ­patelesega; ­tlamegile; 
observatory	bolepaloapi; 
observe	ela tlhoko; 
observed	etse tlhoko; 
obsolete	se se sa tlholeng se dirisiwa; 
obtain	bona;  fitlhelela; 
obtainable	bonala; 
obtained	bone;  fitlheletse; 
obtaining	bonang;  fitlhelelang; 
obvious	 itlhalosa; bonala; 
obviously	 ka go itlhalosa; ka go bonala; 
occasion	motlha; 
occasions	metlha; 
occupation	tiro;  tsenelela;  thopo; 
occupational	tshupetsokgono ya ditiro; 
occupied	 thopile; nnile; 
occupy	nna;  thopa; 
occur	diragala; 
occurred	diragetse; 
occurrence	tiragalo; 
occurring	diragalang; 
occurs	diragala; 
ocean	lewatle; 
of	ya; 
off	tloga; 
offence	tlolomolao; 
offences	ditlolomolao; 
offender	motlolamolao; 
offenders	batlolamolao; 
offer	 aba; neela; 
offered	neetse;  abile; 
offering	kabelo; 
offerings	meneelo; dikabelo; 
offers	 aba; neela; 
office	kantoro; 
office-bearers	ba ba tshwereng maemo a kantoro; 
officer	motlhankedi wa mmuso;  ofisiri; 
officers	 batlhankedi ba mmuso; baofisiri; 
offices	dikantoro; 
official	semmuso;  mokantoro; 
officially	ka molao; 
officials	batlhankedi; 
offshore	 ­lobopong; ­mo lewatleng; 
often	­gantsi; 
oil	oli; 
old	 godile;  tsofetse; bogologolo;  kgale; 
older	­golwane; 
oldest	­golo go feta; 
omission	tlogelo; 
omissions	ditlogelo; 
on	­tshubilwe; 
on-going	tswelelang; 
once	gangwe; 
once-off	­tiragalo nngwe; 
one	 ka serolana; nngwe; 
ongoing	tswelelang; 
online	 -golagantsweng; golagane; 
only	fela; 
onto	mo godimo ga; 
open	 khurumolola; bula; 
opened	butse; 
opening	phatlha;  lephago; 
opens	 khurumolola; bula; 
operate	go ara; 
operated	arile; 
operates	ara; 
operating	arang; 
operation	 kgato; tiro;  karo;  tiragatso; 
operational	­dirang; 
operations	 dikgato;  dikaro;  ditiragatso; ditiro; 
operator	modirisi; 
operators	badirisi; 
opinion	maikutlo; 
opinions	maikutlo; 
opportunities	 ditšhono; ditshiamelo; 
opportunity	tshiamelo; 
oppose	ganetsa; 
opposed	ganeditse; 
opposite	kgatlhanong; 
opposition	kganetso;  baganetsapuso; 
oppressed	 bogisitse; bogile; 
oppression	pogo; 
oppressive	­bogisang; 
optimal	­gaisang; 
optimism	tumelo ya tse di siameng; 
option	boitlhophelo; 
options	maitlhophelo; 
or	 gongwe; kgotsa; 
oral	molomo;  - bua; 
orange	namune; 
orchestra	mminotetso; 
order	 rulaganya;  romelela;  tolamo;  taelo;  tatelano; thulaganyo;  thomelelo; 
ordered	 romeletse; rulagantse; 
orders	dithulaganyo;  dithomelelo;  ditatelano;  ditaelo; 
ordinance	molawana; 
ordinarily	gale; 
ordinary	­fela; 
organ	 kwadi;  okene;  oregane; serwe; 
organisation	 mokgatlho; thulaganyo; 
organisational	­setlamo; 
organisations	dithulaganyo;  ditlamo; 
organised	rulagantse; 
organisers	barulaganyi; 
organising	thulaganyo; 
organization	setlamo; 
organizations	setlamo; 
organized	rulagantse; 
organizers	barulaganyi; 
organs	serwe sa go bua; 
orientation	kaelo; 
origin	tshimologo; 
original	tshimologo; 
originally	tshimologong; 
origins	ditshimologo; 
other	­nngwe; 
others	tse dingwe;  ba bangwe;  a mangwe; 
otherwise	fa go sa nna jalo; 
ought	tshwanetse; 
our	rona; 
ours	­rona; 
ourselves	borona; 
out	 kwa ntle; ntsha; 
outcome	poelo; 
outcomes	dipoelo; 
outdoor	mmileng;  kwa ntle; 
outgoing	­tswang mo maemong;  ­rata go tswa; 
outline	tlhagiso;  baya dintlha;  losi; 
outlined	beile dintlha; 
outlines	ditlhagiso;  baya dintlha;  dintshi; 
outlook	tebotshelo; 
output	ntshetsontle; 
outputs	dintshetsontle; 
outreach	fitlhelela; 
outside	ntle;  kwa ntle;  -ntle; 
outsourced	kopile tirelo ya kwa ntle; 
outstanding	­bonagalang;  ­saletseng kwa morago; 
outward	 ka kwa ntle; ka fa ntle; 
oval	motopo; 
over	 fa godimo; feditse; 
overall	obarolo; 
overarching	­tlhotlheletsang; 
overcome	fenya; 
overcrowding	pitlagano; 
oversee	 okama; lebelela; 
overseeing	 okameng; lebeletseng; 
oversight	 kokamo; phoso; 
overview	ntlhatebo; 
overwhelming	 botlhokwa thata; ­fekeetsang thata; 
owed	kolotile; 
owing	kolotang; 
own	 ­na le; rua; 
owned	ruile; ­nnile le; 
owner	mong; 
owners	beng; 
pace	lebelo; 
package	pakana; 
packages	dipakana; 
page	tsebe; 
pages	ditsebe; 
paid	 lefile; duetse; 
pain	botlhoko;  setlhabi; 
painful	opa; 
painting	 tako;  go taka; setshwantsho; 
paintings	 metako; ditshwantsho; 
palace	mošate; 
panel	 phanele; lekoko;  baatlhodi; 
paper	pampiri;  kuranta; 
papers	 dikuranta; dipampiri; 
par	selekano; 
paragraph	temana;  tema; 
paragraphs	 ditema; ditemana; 
parameters	diparameta; 
parent	motsadi; 
parental	botsadi; 
parents	batsadi; 
park	phaka; 
parks	diphaka; 
parliament	palamente; 
parliament's	­Palamente; 
parliamentarians	bapalamente; 
parliamentary	­palamente; 
parliaments	dipalamente; 
part	karolo; 
part-time	nakwana; 
partial	bontlhabongwe; 
partially	ka bontlhabongwe; 
participant	motsayakarolo; 
participants	motshameki; 
participate	 tsaya karolo; nna le seabe; 
participated	nnile le seabe;  tshotse karolo; 
participates	 tsaya karolo; nna le seabe; 
participating	nnang le seabe;  tsayang karolo; 
participation	botsayakarolo; 
participatory	­botsayakarolo; 
particularly	dintlha; 
particulars	dintlha; 
parties	diphathi; 
partly	ka ntlha nngwe; 
partner	molekane;  mogwebisani; 
partners	balekane;  bagwebisani; 
partnership	kgwebisano; 
partnerships	dikgwebisano; 
party	phathi; 
pass	 neeletsa; boitshupo;  - ragela;  falola;  ragela; 
passed	neeleditse; falotse;  ragetse;  - ragetse; 
passenger	mopalami; 
passengers	bapalami; 
passes	 neeletsa; boitshupo;  falola;  ragela; 
passing	 tlolanyo; pheto; 
passport	 lokwalo lwa mosepele; paseporoto; 
past	morago; 
path	tselana; 
patient	molwetse;  mmobodi; 
patients	 babobodi; balwetse; 
patriotism	mowa wa bosetšhaba; 
pattern	paterone;  sekaelo; 
patterns	dikaelo;  dipaterone; 
paved	adile mokwakwa; 
pavilion	phabilione;  loobo; 
pay	tuelo;  duela;  lefa; 
payable	­tshwanetse go duela; 
paying	duelang;  lefang; 
payment	 tefo; tuelo; 
payments	dituelo; ditefo; 
pays	duela;  lefa;  dituelo; 
peace	kagiso; 
peaceful	ka kagiso; 
peak	setlhoa; 
peer	thaka; 
penalties	dipenele; 
pension	phenšene; 
pensions	diphenšene; 
people	batho; 
people's	­batho; 
peoples	batho; 
perceived	 lemogile; bone;  tlhalogantse; 
percent	phesente; 
percentage	phesente;  bolekgolong; 
percentages	 malekgolong; diphesente; 
perception	 temogo; pono;  tlhaloganyo; 
perceptions	 ditemogo; ditlhaloganyo;  dipono; 
perform	dira;  diragatsa; 
performance	tiro;  - dira;  tiragatso; 
performances	 ditiragatso; ditiro; 
performed	dirile;  diragaditse; 
performer	modiragatsi; 
performers	badiragatsi; 
performing	 diragatsang; dirang; 
performs	dira;  diragatsa; 
perhaps	 ka gongwe; kgotsa; 
period	 lobaka; paka;  pakathuto; 
periodical	ka dipaka;  makasini; 
periods	dipaka;  metlha; 
perjury	kanokako; 
permanent	 ruri; leruri; 
permanently	ruri; 
permission	tetla; 
permit	 dumelela; tumelelo; 
permits	 ditumelelo; dumelela; 
permitted	dumeletse; 
perpetuate	direla ruri; 
person	 mmuiwa;  mmuisiwa;  mmui; motho; 
person's	­motho; 
personal	kanamana; 
personally	ka namana;  ka sebele; 
personnel	badiri; 
persons	batho;  babui; babuisiwa;  babuiwa; 
perspective	ponalo; 
perspectives	diponalo; 
pertaining	­ka ga; 
petition	thapedi;  lekwalotopo; 
petitions	 makwalotopo; dithapedi; 
petrol	 lookwane; peterolo; 
petroleum	peteroleamo; 
pharmaceutical	-khemise; 
pharmacist	rakhemisi; 
pharmacy	 khemise; melemong; 
phase	sebaka; 
phases	dipaka; 
phenomenon	ponagalo; 
philosophy	filosofi; 
phone	mogala; 
photo	senepe, foto; setshwantsho; 
photograph	setshwantsho; 
photographers	batsayaditshwantsho; 
photographic	­senepe; 
photographs	ditshwantsho; - tsayaditshwantsho; 
photos	 dinepe; ditshwantsho; difoto; 
physical	 sebopego;  popego;  senama;  bofisika; mmele; 
physically	ka mmele; 
piano	 piano; tlase; 
picture	setshwantsho; 
pictures	ditshwantsho; 
piece	lenathwana; 
pieces	 dikabetlana; manathwana; 
pillar	pinagare; 
pillars	dipinagare; 
pilot	 mofofane; mofofisi; 
pioneers	bathobolodi; 
pivotal	­botlhokwa; 
place	 baya; lefelo; 
placed	beile; 
placement	patlelofelo; 
places	mafelo;  manno; 
placing	peo; 
plain	bonolo;  lebala; 
plains	mabala; 
plaintiff	mongongoregi; 
plaintiff's	mongongoregi;  moikuedi; 
plan	 loga maano; leano;  polane;  thalo;  -polane; 
planet	 setsatsi; polanete; 
planned	 logile maano; thadile; 
planning	togamaano;  - dira maano; 
plans	 loga maano; maano;  methalo;  dipolane; 
plant	 jala;  ditshika tsa semela;  semela; tlhoma; 
plants	 dimela;  jala;  ditshika tsa semela; dipolante; tlhoma; 
plastic	polasetiki; 
plate	papetla; 
platforms	dipolateforomo; 
platinum	polatinamo; 
play	tiragatso;  motshameko; 
played	 tshamekile; motshameko; 
player	motshameki; 
players	batshameki; 
playhouse	mantlwane; 
playhouses	mantlwane; 
playing	 diragatsang; tiragatso;  tshamekang;  motshameko; 
plays	metshameko;  ditiragatso; 
plea	ipobolo; 
pleading	kopang; 
pleadings	dikopo; 
please	 kgotsofatsa; tsweetswee; 
pleased	kgotsofaditse; 
pleasure	thabo; 
pledge	ikano;  sebeelo;  itlamo; 
pledged	itlamile;  ikanne; 
plenary	­maloko otlhe a komiti; 
plight	pitlagano; 
plus	le;  tlhakanyi; 
poaching	go utswa diphologolo; 
poem	leboko; 
poet	mmoki; 
poetry	poko; 
poets	baboki; 
point	 ntlhana; supa;  leduo;  khutlo; 
pointed	supile; 
points	 dikhutlo; supa;  maduo;  dintlhana; 
police	lepodisi;  lephodisa; 
policies	 dipholisi tsa inšorense; maikemisetso;  dipholisi; 
policy	 maikemisetso;  pholisi ya inšorense; pholisi; 
politics	dipolotiki; 
pollution	 kgotlelego; kgotlelo; 
pool	letamo;  mogobe; 
poor	 - tlhoka; botlhoki; 
poorly	ka bokoa; 
popular	itsege;  tumileng; 
population	 bontsi; baagi; 
pornography	­thobalano; 
port	boemakepe; 
portal	botseno; 
portfolio	lefapha;  potefolio; 
portion	karolo;  bogare; 
portray	tshwantsha; 
portrayed	tshwantshitse; 
ports	boemakepe; 
pose	botsa; 
posed	boditse; 
position	 kemo; maemo; 
positions	 dikemo; maemo; 
positive	koketso; 
positively	ka tsela e e siameng; 
possess	 ­nna le; rua; 
possession	leruo; 
possibilities	kgonagalo;  kgonego; 
possibility	kgonego; 
possible	kgonegang; 
possibly	ka bokgoni; 
post	tiro;  posa;  poso; 
postal	­poso; 
postgraduate	 moithuti wa dithutokgolwane; dithutokgolwane morago ga dikerii; 
postponed	buseditse kwa morago; 
postponement	pusetsomorago; 
posts	 diphatlhatiro; tiro;  posa; 
pot	pitsa; 
potential	bokgoni; 
potentially	ka bokgoni; 
poverty	tlala; 
power	 maatlataolo; maatla;  maatlaikatisi; 
powerful	- le maatla; 
powers	 maatlataolo; maatla;  maatlaikatisi; 
practicable	kgonegang; 
practical	tiriso; 
practice	 tlwaelo; katiso;  bongaka; 
practices	 dikatiso; ditlwaelo;  bongaka; 
practise	 katisa; katiso;  ikatisa; 
practitioner	modirisi;  ngaka; 
practitioners	modirisi;  dingaka;  badiredi; 
praise	boka; 
prayer	 dithapelo; thapelo; 
pre-colonial	pele ga bokoloniale; 
pre-trial	pele ga tsheko; 
preamble	matseno; 
precede	etelela; 
preceded	eteletse; 
preceding	eteletseng; 
precinct	karolotoropo ya botsamayakadinao; 
precincts	dikarolotoropo tsa botsamayakadinao; 
precious	­rategang; 
precisely	ka nepo; 
preference	leakanyetsopele; 
preferential	­rategang; 
preferred	ratile; 
pregnancy	boimana;  ithwalo;  kimo; 
pregnant	 ithwele; ima;  go ima;  ithwala;  imile; 
prejudice	kgethololo;  gobelela; 
preliminary	-matseno; 
premier	tonakgolo; 
premised	­ikaegile ka tumelo e e rileng; 
premises	dikago; 
preparation	 setlhare;  iketleetso; paakanyo; 
preparations	diiketleetso; dipaakanyo; 
preparatory	-paakanyo; 
prepare	 - siamisa; baakanya; 
prepared	baakantse; 
preparing	baakanyang;  - siamisang; 
prescribe	baya; 
prescribed	-beilweng; 
prescribing	beile; 
prescription	ditaelo;  setlhare se ngaka e se laelelang molwetsi; 
prescripts	ditaelo-semmuso; 
present	jaanong;  neo;  mpho;  kabelo; 
presentation	tlhagiso;  tlhagisetso; 
presentations	ditlhagiso; ditlhagisetso; 
presented	neetse;  abile; 
presenting	neelang;  abang; 
presently	ga jaana; 
presents	 dineo;  dimpho; dikabelo; 
preservation	poloko; 
preserve	somarela; 
preserved	somaretse; 
preserving	somarelang; 
preside	tshwara marapo; 
presidency	maemo a moporesidente; 
president	poresitente;  tautona; 
president's	moporesidente; 
presidential	moporesidente; 
presidents	ditautona; diporesidente; 
presiding	tshwarang marapo; 
press	kgatiso;  tobetsa;  tereika; 
pressing	ntlhaphisego; sidilang (diaparo); 
pressure	kgatelelo; 
pressures	dikgatelelo; 
prestigious	­gaisang; 
presumed	itlhomile; 
pretty	montle; 
prevail	fenya;  fekeetsa; 
prevailing	­ka gale;  ­leruri; 
prevalence	tlhagelelo; 
prevent	 kganela; thibela; 
prevented	thibetse;  kganetse; 
preventing	 kganelang; thibelang; 
prevention	thibelo; 
previous	morago; 
previously	mo nakong e e fetileng; 
price	tlhotlhwa;  poreisi; 
prices	diporeisi; ditlhotlhwa; 
pride	 boikgogomoso; boikgantsho; 
priest	moperisita; 
primarily	ka bogolo; 
primary	poraemari; 
principal	mogokgo;  porinsipala; 
principals	diporinsipala; bagokgo; 
principle	 theo; motheo; 
principles	ditheo;  metheo; 
print	gatisa;  toitshe;  kwala ka go gatisa;  kgatiso; 
printed	 kwadile ka go gatisa; gatisitse; 
printing	kgatiso; 
prior	pele; 
priorities	ditlapele; 
prioritise	dira setlapele; 
prioritised	dirile setlapele; 
priority	setlapele; 
prison	 toronko; kgolegelo; 
prisoner	mogolegwa;  setshwarwa; 
prisoners	bagolegwa; 
prisons	dikgolegelo;  ditoronko; 
privacy	bophiri; 
private	-sephiri; 
privilege	tshwanelo; 
privileged	nna le tshwanelo; 
privileges	ditshwanelo; 
prize	tebogo; 
prizes	ditebogo; 
pro	­tshegetsang; 
proactive	diragatsang; 
probably	ka gongwe; 
probation	pakateko; 
probe	botsa;  tlhotlhomisa; 
problem	 tharaano;  leraraane; bothata; 
problems	ditharaano; mathata;  mararaane; 
procedural	­tsamaiso; 
procedure	tsamaiso; 
procedures	ditsamaiso; mekgwatsamaiso; 
proceed	 tswelela pele; tswelela; 
proceeding	tiragalo;  tswelang pele; 
proceedings	ditsamaiso; 
proceeds	dipoelo; 
process	 tirego; dira;  tsamaiso; 
processed	dirile; 
processes	 ditirego;  ditsamaiso; dira; 
processing	dirang; 
procession	mokoloko; 
proclamation	kgoeletso; 
procurement	tshenkelo; 
produce	tlhagisa;  kumo;  uma; 
produced	tlhagisitse;  ungwile; 
producer	 moumisi; setlhagisi; 
producers	ditlhagisi; 
produces	tlhagisa;  dikumo;  uma; 
producing	tlhagisang;  ungwang; 
product	 kumo;  seatiso; kungo; 
production	 tsweletso ya filimi; kumo; 
productions	tsweletso ya filimi; 
productivity	bokgoni jwa ntshokumo; 
products	 dikungo;  dikumo; dikatiso; 
profession	borutegi; 
professional	 boithutelo; moitseanape; 
professionals	 boithutelo; baitseanape; 
professions	borutegi; 
professor	moporofesara; 
profile	thalotlhakore; 
profit	poelo; 
profits	dipoelo; 
profound	teng; 
program	lenaneo;  lenane; 
programme	lenaneo;  lenane; 
programmes	mananeo;  manane; 
programming	tlhamomananeo;  thulaganyonaneo; 
programs	mananeo;  manane; 
progress	tswelelopele;  tswelopele;  tswelela pele; 
progression	tswelelopele; 
progressive	 -gatelang pele; kgatelopele; 
prohibit	thibela; 
prohibited	thibetse; 
prohibition	thibelo; 
project	 -gatelang pele; tiro;  mmalatheo;  tsweletsa; 
projected	tsweleditse; 
projection	 ntlhakhutlogo; tsweletso;  pontsho; 
projections	dipontsho; dintlhakhutlogo;  ditsweletso; 
projects	mebalatheo;  tsweletsa; ditiro; 
prominent	­botlhokwa; 
promise	 tsholofetso; solofetsa; 
promised	solofeditse; 
promises	ditsholofetso; 
promote	tsweletsa; 
promoted	tlhatlositse; tsweleditse; 
promotes	tsweleditse; tlhatlosa; 
promoting	tlhatlosang; tsweletsang; 
promotion	tlhatloso; 
promptly	ka nako; 
promulgated	itsisitse semmuso; 
promulgation	kitsiso semmuso; 
proof	bopaki; 
proper	­maleba; 
properly	ka tsela e e maleba; 
properties	 dipharologantsho; dithoto; 
property	 pharologantsho; thoto; 
proportion	karolo;  kabelo;  tekanyetso; 
proposal	tlhagiso; 
proposals	ditlhagiso; 
propose	tlhagisa; 
proposed	tlhagisitse; 
proposes	tlhagisa; 
prosecute	isa tshekong; 
prosecuted	isitse tshekong; 
prosecuting	sekisang; 
prosecution	tshekiso; 
prosecutions	ditshekiso; 
prosecutor	motšhotšhisi; 
prosecutors	batšhotšhisi; 
prospect	potiela; 
prospecting	potielang; 
prospective	­kgonagalo ya go direga; 
prospects	potiela; 
prospectus	tlhodisetsopele; 
prosperity	 tswelelo;  kokotlegelo; katlego; 
prosperous	­atlegileng; kokotlegileng; 
protect	sireletsa;  femela; 
protected	femetse; sireleditse; 
protecting	 femelang; sireletsang; 
protection	tshireletso; 
protective	-sireletsang; 
protector	mosireletsi; 
protest	ganana;  kganano; 
protests	boipelaetso;  dikganano;  diipelaetso; ganana; 
protocol	porotokolo; 
protocols	diporotokolo; ditatelokalafo; 
proud	ikgantsha; 
proudly	ka boipelo; 
prove	netefatsa; 
proved	netefaditse; 
proven	netefaditswe; 
provide	neela; 
provided	fa e le gore; 
provident	thulaganyetso ya polokomadi; 
provider	motlamedi; 
providers	batlamedi; 
provides	neela; 
providing	neelang; 
province	 porofense; porofensi; 
province's	­porofense; 
provinces	diporofense; 
provincial	­porofense; 
provision	tshiamelo;  aba; 
provisional	-nakonyana; 
provisions	 dikabo; ditshiamelo;  aba; 
proviso	peelo; 
proxy	thulaganyo ya go direlwa; 
prudent	tlhokomelo; 
prudential	­kelotlhoko; 
psychological	­saekholoji; 
public	batho;  tshekelele; 
publication	kgatiso; 
publications	dikgatiso; 
publicly	mo mpaananeng; mo phatlalatseng; 
publish	phasalatsa; 
published	phasaladitse; 
publisher	mophasalatsi; 
publishers	baphasalatsi; 
publishes	phasalatsa; 
publishing	phasalatsang; 
punishment	kotlhao; 
purchase	reka; 
purchased	rekile; 
purchases	reka; 
purport	e ikaya e le; 
purporting	ikayang e le; 
purpose	tebo;  ikemisetso; 
purposes	 ditebo; maikemisetso; 
pursuant	kobamelomolao; 
pursue	tswelela; 
pursued	tsweleditse; 
pursuing	tsweletsang; 
pursuit	tsweletso; 
push	kgorometsa; 
put	baya; 
puts	baya; 
putting	bayang; 
qualification	borutegi; 
qualifications	borutegi; 
qualified	nonofile; 
qualify	 tlhaola; kgona;  boleng;  sutlhelela; 
qualifying	 tlhaolang;  sutlhelelang; kgonang; 
qualitative	­boleng; 
qualities	boleng; 
quality	boleng; 
quantitative	­bokana kang; 
quantity	bokanakang;  bokalo; 
quarter	 kgweditharo;  kwatara; kotara; 
quarterly	ka kotara; 
quarters	bonno; 
queen	mohumagadi; 
queries	dipotso; 
quest	patlisiso; 
question	potso; 
questionnaire	dipotsopatlisiso; 
questionnaires	dipotsopatlisiso; 
questions	dipotso; 
quickly	 ka bonako; ka pele;  ka go itlhaganela;  ka bofefo; 
quinine	kwinini; 
quite	 ruri; sentle; 
quorum	khoramo; 
quotation	nopolo; 
quotations	dinopolo; 
quote	khouta; 
race	kgaisano;  lotso;  mokato;  kata; 
races	 mabelo; ditso; 
racial	-lotso; 
racism	botso; 
racist	motlhaodi; 
radical	-gotlhe; 
radio	 tlhaeletso ka radio;  seyalemowa; radio; 
raid	tlhaselo;  letsholophuruphutso; 
rail	reile; 
railway	 ralawee; seporo; 
rain	pula;  - na;  pula e a na; 
rainbow	molagodimo; 
rainfall	 go na ga pula; selekanyo sa pula; 
raise	tsholetsa;  motlhatlogo; 
raised	tsholeditse; 
raises	 metlhatlogo; tsholetsa; 
raising	tlhatlogang;  motlhatlogo;  tsholetsang; 
rand	ranta; 
range	paka;  tlhatlhamano;  tekanyo; 
ranges	 ditlhatlhamano;  ditekanyo; dipaka; 
rank	 kemofatso;  kemo; maemo; 
ranks	 dikemo; maemo; 
rape	 thula;  betelela; petelelo;  thulo; 
rapid	 lephothoselo;  phororo; bonako; 
rapidly	kakofo; 
rare	go se bonale; 
rate	 kelo;  tekanyo ya tswelelopele;  lebelo;  kgethisa;  kata; tekanyetso; 
rates	tekanyetso; 
rather	bogolo; 
ratification	tlhomamiso; 
ratified	tlhomamisitse; 
rating	kelofatso; 
ratings	dikelofatso; 
ratio	kabo; 
rationalisation	phokotso ya badiri;  kakanyo ka boitebo; 
raw	 sa butswang; -tala; 
reach	 goroga; fitlhelela;  tshwara; 
reached	 gorogile;  fitlheletse; tshwere; 
reaching	tshwereng;  fitlhelelang; 
read	buisa; 
reader	 padiso; mmuisi; 
readers	 padiso; babuisi; 
readily	ka ipaakanyetso;  ka iketleetso; 
readiness	 iketleetso; ipaakanyetso; 
reading	 palelo; puiso; 
ready	 iketleeditse; ipaakantse; 
reaffirm	tlhomamisa gape; 
real	mmatota;  mmannete; kônôkônô; 
realisation	temogo; 
realise	bona; 
realised	 lemogile; bone; 
realising	boneng;  lemogang; 
realities	ditsaboammaaruri;  ditsannete; 
reality	bommannete; -boammaaruri; 
realization	temogo; 
realize	bona;  lemoga; 
really	 ka boammaaruri; nnetefela; totatota; 
reason	 nagana; lebaka; 
reasonable	isega; 
reasonably	mo go isegang; 
reasons	mabaka; 
reburial	phitlho gape; 
recapitalisation	kabotšhelete;  palelogape; 
receipt	rasiti;  tshupatuelo; 
receipts	dirasiti;  ditshupatuelo; 
receive	amogela; 
received	amogetse; 
receives	amogela; 
receiving	amogelang; 
recent	sešweng; 
recently	ka sešweng; 
reception	kamogelo; 
recession	risešene; kgaotso; 
recipient	moamogedi; 
recipients	baamogedi; 
reclaim	busetsa; 
recognise	amogela;  lemoga; 
recognised	 lemogile; bone; 
recognises	 lemogile; bone; 
recognising	bonang;  lemogang; 
recognition	temogo; 
recognize	 lemogile; bone; 
recognized	 lemogile; bone; 
recommend	atlanegisa; 
recommendation	katlanegiso; 
recommendations	dikatlenegiso; dikatlanegiso; 
recommended	atlanegisitse; 
recommends	atlanegisa; 
reconciliation	kagisanyo; 
record	bega;  tshupo;  lenane la thoto;  - kwala; 
recorded	kwadile; 
recording	kgatiso; 
records	 ditshupo; bega;  manane a thoto;  - kwala; 
recover	- fola; 
recovered	fodile;  bonwe gape; 
recovery	pholo;  nonofa; 
recreation	tsosoloso;  boitapoloso; 
recreational	­boithabiso;  ­boitapoloso; 
recruitment	thaopo; 
rectify	 siamisa; baakanya; 
recycling	phepafatso;  tirisogape; 
red	hibidu; 
redistribution	 phatlalatsogape; kabelogape; 
redress	 siamisa;  lolamisa;  tshiamiso; baakanya;  paakanyo;  tolamiso; 
reduce	 fetola; fokotsa; 
reduced	 fokoditse; fetotse; 
reducing	 fetolang; fokotsang; 
reduction	phokotso; 
reductions	diphokotso; 
refer	 romela thusong; kaela; 
reference	tshupetso; 
references	ditshupetso; 
referral	 sesupo sa kaelothusong; lokwalo lwa thomelothusong; 
referred	 kaetswe; rometswe thusong; 
referring	romelang thusong; 
refers	 romela thusong; kaela; 
refined	-phepafaditsweng; 
reflect	supatshwano; 
reflection	 tshupatshwano;  tshupotshwano; tshwana; 
reflective	­tshupatshwano; 
reform	phetolo;  ntšhwafatso;  ntšhwafatsa; 
reforms	dintšhwafatso; diphetolo;  ntšhwafatsa; 
refund	busetsa;  pusetso; 
refurbishment	phatshimisogape; ntšhwafatso; 
refusal	kganetso; 
refuse	 matlakala; gana; 
refused	ganne; 
refuses	gana; 
regard	leba;  tsaya tsia; 
regarded	 tshotse tsia; lebile; 
regarding	malebana; 
regards	kwa ntle ga tlhotlheletso; 
regeneration	ditumediso; 
regime	puso; 
region	karolo;  kgaolo; 
regional	- kgaolo;  -kgaolo; 
regions	 dikgaolo; dikarolo; 
register	 bukakwadiso; kwadisa; 
registered	 -kwadisitsweng; rejisetarilwe; 
registering	kwadisang; 
registers	 direjisetara; kwadisa; dibukaina tsa tseno;  dibukakwadiso; 
registrar	mokwadisi; 
registration	ikwadiso; 
registries	bokwadisetso; 
registry	bokwadisetso; 
regular	 - gale;  -gale; gale; 
regularly	 ka tlhomamo; ka metlha; 
regulate	laola; 
regulated	laotse; 
regulates	laola; 
regulating	laolang; 
regulation	molawana; 
regulations	melawana; 
regulator	molaodi; 
regulators	balaodi; 
regulatory	balaodi-; 
rehabilitation	tsosoloso; 
rehearsals	diitlhokotso; 
reinforce	­molawana; 
reintegration	oketsa;  tlaleletsa; 
reiterate	lotano sešwa; 
reiterated	boelela; 
reject	 seganwa; gana; 
rejected	ganne; 
relate	amana;  tsalana; 
related	 -tsalana; amanang; 
relates	anela;  tsalana le; 
relating	-amanang;  tsalanang;  mabapi le; 
relation	kamano; 
relations	dikamano; 
relationship	 botsalano; kamano;  nyalano; 
relationships	dikamano;  botsalano; dinyalano; 
relative	 leloko; amanang;  mogaetsho;  leamanyi;  tshika; 
relatively	thata (ka papiso); 
relatives	bagaetsho;  ditshika;  maamanyi; 
release	rebola;  golola; 
released	rebotse; phatlaladitse;  golotswe; 
releases	rebola; phatlalatsa;  golotse; 
relevance	tsamaisano;  bomaleba; 
relevant	-lebaneng; 
reliable	ikanyega;  tshepega; 
relief	 go wela makgwafo; popego; 
religion	 bodumedi; tumelo; 
religions	 bodumedi; tumelo; 
religious	bodumedi; 
rely	ikaega; 
remain	-sala; 
remainder	sesala; 
remained	setse; 
remaining	-salang; 
remains	masalela; 
remand	emisediwa go sekisiwa; 
remarkable	-bonalang; 
remarks	ditshwaelo; 
remedies	melemo;  dipheko; 
remedy	 pheko; molemo; 
remember	gakologelwa; 
remembered	gakologetswe; 
remembrance	segopotso; 
remind	gakolola;  gopotsa; 
reminded	gakolotse;  gopoditse; 
reminder	tsiboso; 
reminders	ditsiboso; 
remote	kgakala;  bokgakala; 
removal	tshutiso;  tloso;  ntsho; 
remove	 sutisa;  tlosa; ntsha; 
removed	 tlositse;  sutisitse; ntshitse; 
removing	ntshang;  tlosang;  sutisang; 
remuneration	moputso; 
renaissance	tsosoloso; 
renamed	teile sešwa; 
renaming	teosešwa; 
render	tlhagisa;  tlisa;  neelana ka; 
rendered	tlhagisitse;  tlisitse; 
rendering	-tlhagisang;  tlang ka; 
renew	ntshwafatsa;  ntšhwafatsa; 
renewal	ntšhwafatso; 
renewed	ntshwafatsa; ntšhwafaditse; 
renovation	ntšhwafatso; 
renovations	dintšhwafatso; 
renowned	­tumileng;  -itsegeng; 
rent	rente;  hira;  tuelokhiro; 
rental	­rente; 
repair	baakanya;  paakanyo; 
repairs	baakanya;  dipaakanyo; 
repatriation	pusetsonageng ya tsalo; 
repeal	tlhakolo; 
repealed	phimotse; 
repeals	ditlhakolo; 
repeat	boeletsa; 
replace	emisetsa;  refosa; 
replaced	emiseditse; refositse; 
replacement	kemisetso; 
replies	 dikarabo;  araba; fetola; 
reply	 phetolo; karabo; 
report	pegelo;  pego; 
report-back	begela; 
reporting	pegelo;  pego; 
reports	pegelo;  dipego; 
reposition	peomaemong gape; 
repositioning	ipeosentle; 
repository	polokelo; setôrô ; 
represent	emela;  -emela; 
representation	kemedi;  boemedi; 
representations	boemedi;  dikemedi; 
representative	moemedi; 
representatives	baemedi; 
represented	emetse;  -emetse; 
representing	emelang;  -emelang; 
represents	emela;  -emela; 
republic	repaboliki; 
republics	direphaboleki; direpaboliki; 
request	kopo; 
requested	kopo;  kopile; 
requester	­gatelelang; 
requests	dikopo; 
require	senka; 
required	senkile; 
requirement	tlhokego; 
requirements	ditlhokego; 
requires	senka; 
requiring	senkang; 
requisite	sekopi; mokopi; 
rescue	 -pholosa; pholosa; 
research	patlisiso;  tlhotlhomisa; 
researcher	mmatlisisi; 
researchers	babatlisisi;  batlhotlhomisi; 
reservation	peeletsothekethe;  peeletsomanno; 
reserve	boloka;  motshameki yo o kwa bankeng;  rasefe; 
reserved	beeleditse (manno); 
reserves	boloka;  batshameki ba ba kwa bankeng;  dirasefe; 
residence	lefelobonno; 
resident	moagi; 
residential	bonno; 
residents	baagi; 
resides	nna kwa; 
residing	nnang kwa; 
resignation	boipofololo; 
resilience	 tebalomatlhoko;  poelomannong; ipusetsomannong; 
resistance	 tila;  kemelano;  kganelo;  twantsho; thibela; 
resolution	 setlamo; tshwetso; 
resolutions	ditshwetso;  ditlamo; 
resolve	rarabolola; 
resolved	rarabolotse; 
resolving	rarabololang; 
resounding	modumo;  ­atlegileng; 
resource	motswedi; 
resources	metswedi; 
respect	tlhonepo; 
respective	farologaneng; 
respectively	ka tatelano; 
respond	tsibogela; 
responded	tsibogetse; 
respondent	moikarabedi; 
respondents	baikarabedi; 
responding	tsibogelang; 
responds	tsibogela; 
response	karabo;  tsibogo; 
responses	 ditsibogo; dikarabo; 
responsibilities	maikarabelo; 
responsibility	 boikarabelo; maikarabelo; 
responsible	ikarabelo; 
responsive	tsibogang ka dikarabo; 
rest	boikhutso; 
restitution	puseletso ya ditshwanelo tsa lenyalo; 
restoration	ntshwafatso;  pusetsomaemong; pusetsoditshwanelo; 
restorative	­rudisang; 
restore	busetswa; 
restored	buseditswe; 
restoring	busetswang; 
restraint	 bothijo;  boikgapho; kganelo; 
restricted	lekanyeditswe;  kganetswe; 
restriction	tekanyetso; 
restrictions	dilekanyetso; 
restructuring	thulaganyetsosešwa; 
result	 searolo;  seatiso;  sephetho; karabo; 
results	dikarolo;  dikarabo; diatiso;  dipholô;  diphetho; 
retail	kgwebopotlana; 
retain	 emisa; tsaya; 
retained	tseile; emisitse; 
retention	tshegetso maemo;  tsholô; 
retire	go rola tiro; 
retired	rotse tiro; 
retirement	tholotiro; 
retrieval	pusetso; 
return	boa;  busa; 
returned	busitswe; 
returns	manane; 
reveal	 upolola; senola; 
revealed	 upolotse; senotse; 
revenue	lotseno; 
revenues	lotseno; 
reverse	tlhanolo ya tsebe; 
review	tshekatsheko;  thadiso; 
reviewed	 thadisitse; tshekatsheko;  sekasekile;  thadiso; 
reviews	ditshekatsheko;  dithadiso; 
revise	boeletsa; 
revised	boeleditse; 
revision	 poelelo; poeletso; 
revisions	dipoeletso;  dipoelelo; 
revitalisation	maatlafatso; 
revoke	fetola;  tlosa; 
revolution	 modikologo;  menolopuso; tikologo; 
revolutionary	-rukhutlhang; 
reward	 kabo;  tefo; tuelo; 
rhino	tshukudu; 
rich	 nonne; humile; 
right	siameng;  nepagala;  moja;  mojeng; 
rightful	­siametseng; 
rights	ditshwanelo; 
rise	 kokomoga; tlhatloga; 
rising	tlhatlogang;  ya godimo; 
risks	itsenyokotsing; 
river	noka; 
rivers	dinoka; 
road	tsela; 
roads	ditsela; 
robust	thata;  nonofile;  kwenne; 
rock	lentswe; 
rod	 tsamma; thobane;  thupa; 
role	seabe; 
role-players	 bannaleseabe; batsayakarolo; 
roles	seabe; 
roll	 lenaneina; koto ya lesela; 
roll-out	thankgolola; 
rolling	pitikologang; 
rollout	thankgololo; 
rolls	dirolo; 
room	kamore; 
rooms	dikamore; 
root	modi; 
rooted	batlile;  lemile; 
roots	medi; 
rose	tlhatlogile;  kokomogile; 
round	 digolagane;  -sekeletsa; kgolokwe; 
rounded	-sekeleditse; 
roundtable	tafole ya dipuisano; 
route	tsela; 
routes	ditsela; 
routine	tlwaelo; 
royal	 -bogosi; bogosi; 
royalties	dikatso; 
royalty	katso; 
rugby	rakabii; 
rule	 molawana; taolo;  mmuso;  rulara;  taolwana; 
rules	 busa;  ditaolo; ditaolwana;  melawana;  dirulara; mmuso; 
ruling	tshwetsotaolo; 
rulings	ditshwetsotaolo; 
run	siana; taboga;  itlhaganela; 
running	tsholo ya legae; 
runs	metabogo; 
rural	nageng; 
sacred	kgethegileng;  boitshepo; 
sacrifice	setlhabelo; 
sacrifices	ditlhabelo; 
sad	kutlobotlhoko; 
saddened	hutsafetse; 
sadness	maswabi; 
safe	 -bolokegileng;  bolokesegile; polokelo; 
safeguard	sireletsa; 
safeguarding	sireletsang; 
safety	 polokego; tshireletsego; 
said	rile; 
salaries	dituelo; 
salary	tuelo; 
sale	thekiso tlase; 
sales	dithekiso; 
salute	saluta; 
same	tshwanang; 
sample	 sesupo; sekao; 
samples	 disupo; dikao; 
sanction	 dumela; laola; 
sanitation	 kgeleloleswe; sanetasi;  tshireletso ya setšhaba kgatlhanong le leswe; 
sap	matute; 
saps	matute; 
satellite	 sathalaete; motsana; 
satisfaction	kgora; 
satisfactory	kgotsofatsang;  natefisang; 
satisfied	kgotsofetse;  se se itumedisang; 
satisfy	se se itumedisang; 
save	sireletsa;  boloka; 
saving	sireletsang;  bolokang; 
savings	 ditshomarelo; dipoloko; 
say	bua;  bolela; 
saying	 polelo; buang; 
says	bua;  bolela; 
scale	 lekakaba; sekale;  selekanyetso;  selekanyetsi; 
scarce	tlhokega; 
scene	tema;  felo; 
scenes	mafelo;  ditema; mafelotiragalo; 
schedule	lenaneo;  mametlelelo; 
schedules	 dimametlelelo; mananeo; 
scheme	 rera; thulaganyo; 
schemes	dithulaganyo; 
scholar	moithuti;  morutegi; 
scholars	barutegi;  bana ba sekolo; 
school	sekolo; 
schooling	tsenang sekolo; 
schools	dikolo; 
science	bonetetshi; 
sciences	bonetetshi; 
scientific	bonetetshi; 
scope	bolekanyetso; 
score	 thala; ntlha;  sekoro;  nosa;  maduo;  go nosa; 
scorecard	karata ya maduo; 
scoring	nosang; 
scourge	matlhotlhapelo; 
screen	 sekirini; tshireletso;  tlhatlhoba; 
screening	tlhatlhobo; 
script	dikwalwa;  mogatiso; 
scrutinise	sekaseka; 
scrutinize	sekaseka; 
scrutiny	tshekatsheko;  keleko; 
sculpture	 petlomaje; petlo; 
sea	lewatle; 
seal	sili;  tswala thata; 
sealed	tswadile thata; 
search	batla;  senka; 
searched	 senkile; batlile; 
season	setlha; 
seasonal	go ya ka ditlha; 
seasons	ditlha; 
seat	bonno;  setulo; 
seats	manno;  ditulo; 
second	tlatsa;  motsotswana;  -bobedi; 
secondary	-bobedi; 
secondly	­bobedi; 
secret	sephiri; 
secretariat	bokwaledi; 
secretary	 ralefapha; mokwaledi; 
secretary-general	mokwaledi-kakaretso; 
section	karolo;  karolo ya buka;  karolwana;  lephata; 
sectional	go ya ka karolo; 
sections	dikarolo;  maphata;  dikarolo tsa buka;  dikarolwana; 
sector	lephata; 
sectors	maphata; 
secure	tlhomama;  -tlhomameng; 
securities	tshireletso; 
security	tshireletso;  pabalesego; 
see	bona;  leba; 
seeing	 lebang; bonang; 
seek	batla;  senka; 
seeking	batlang;  senkang; 
seeks	batla;  senka; 
seem	 e kete; o kare;  itshema; 
seems	 e kete; o kare;  itshema; 
seen	 lebile; bone; 
segment	 ketla; karolwana; 
segregation	kgethololo; 
seize	 huparela; tshwara;  phamola; 
seized	 phamotse;  huparetse; tshwere; 
seizure	 phifalelo; ngatego; 
select	tlhopha; 
selected	tlhophile; 
selection	tlhopho; 
self	ka sebele; 
self-determination	itlhotlhomiso; 
self-sufficiency	ikgono; 
selfless	­se na bopelotshetlha; 
sell	rekisa; 
selling	thekiso; 
seminar	seminara; 
seminars	diseminara; 
send	romela; 
sending	 tshwaragane le thomelo; romelang; 
sends	romela; 
senior	golo; 
sense	temosi; 
sensitive	bosisi; 
sent	 romilwe; rometse;  romile; 
sentence	mafoko;  polelo;  atlhola;  katlholo; 
sentenced	atlhotse; 
sentences	dipolelo;  atlhola;  dikatlholo; 
sentencing	atlholang; 
separate	 -kgaogantsweng;  kgaoganeng; kgaoganya; 
separated	 kgaogantse; kgaoganeng; 
separately	 ka go kgaogana; kwa thoko; 
separation	kgaogano; 
sequestration	kamogothoto; 
series	tlhatlhamano; 
serious	tlhonamo; 
seriously	ka tlhonamo; 
servants	 malata; badiredi; 
serve	romela;  direla;  tsholela; 
served	 rometse; diretse;  tsholetse; 
serves	romela;  direla;  tsholela; 
service	tirelo; 
services	ditirelo; 
session	paka;  motlha; 
sessions	dipaka;  metlha; 
set	 serobe;  teka; thaya;  sete; 
sets	 teka;  disete; thaya;  dirobe; 
setting	ala; 
settle	 itshetlega; aga; 
settled	itshetlegile;  dutse; 
settlement	itshetlego;  bothibelelo; 
settlements	 bothibelelo; maitshetlego; 
settler	 mothibeledi; mofaladi; 
settlers	 bathibeledi; bafaladi; 
seven	supa; 
several	mmalwa; 
severe	feteletse;  e e maatla; 
sew	roka; 
sewing	 moroko; roka; 
sex	bong; 
sexual	ya bong; 
sexually	­thobalano; 
shall	tlaa; 
shape	 sebopego;  popego; bopa; 
shaped	­nang le popego; 
shapes	bopa;  dipopego;  dipopo; 
shaping	bopa; 
share	 kgaoganya; seabe;  abelana;  ananya; 
shared	 kgaogantse; abelane; 
shareholders	batsholadišere; 
shareholding	go nna le dišere; 
shares	 kgaoganya; seabe;  abelana; 
sharing	abelanang;  kgaoganyang; 
sharks	dišaka; 
sharp	motsu;  tseremo; 
shed	foforega;  itlobola;  ntlwanabobeelo; 
shedding	 itlebolo;  matlwanabobeelo; foforegang;  phoforego; 
sheet	 disenke; letlhare; 
sheets	matlhare; dillakane;  disenke; 
shelter	 motlaagana;  legae;  ntlwana; tshireletso;  setlaagana; 
sheriff	morongwa wa lekgotla; 
sheriffs	barongwa ba lekgotla; 
shifts	dišifiti; 
ship	sekepe; 
shipping	tsamaisa ka sekepe; 
ships	dikepe; 
shock	letshogo; 
shocked	 tshoga [tshogile]; letshogo; 
shocks	letshogo; 
shop	lebenkele; 
shopping	reka; 
shops	mabenkele; 
shore	losi; 
shores	dintsi; 
short	khutshwane; 
short-term	paka khutshwane; 
shortage	tlhaelo; 
shortages	ditlhaelo; 
shorter	khutshwanyane; 
shortly	mo nakong e e sa fediseng pelo; 
shot	thago; 
should	tshwanetse; 
shoulders	magetla; 
show	supetsa;  pontsho; 
showcase	bontsha; 
showcasing	bontshang; 
showed	 supeditse; bontshitse;  pontsho; 
showing	supang; 
shown	 supeditse; bontshitse;  pontsho; 
shows	dipontsho;  supetsa; 
side	 mfapha;  losi; letlhakore;  letlhakore la lesela; 
sign	 saena;  sekai; letshwao; 
signal	 tshupetso;  setsibosi; tsibosa;  tsiboso;  temosi; 
signals	 ditemosi;  ditsiboso;  ditshupetso;  ditsibosi; tsibosa; matshwaotaolo; 
signature	 mosaeno; tshaeno; 
signed	saenile; 
significance	 ponalo; botlhokwa; 
significant	­bonalang; 
significantly	mo go bonalang; 
signifies	bontsha;  supa; 
signing	saenang; 
signs	matshwao;  saena;  dikai; 
silver	selefera; 
similar	 tsamaelanang; tshwanang; 
similarly	ka go tshwana; 
simple	bonolo; 
simply	ka bonolo; 
simultaneously	ka segongwe; 
since	 fa e sale; gonne; 
sincere	pelo e phepa; 
sincerely	ka pelo e phepa; 
sing	opela; 
singer	moopedi; 
singing	opelang; 
single	nosi; 
sister	sisitara; 
sisters	bokgaitsedi; 
sit	nna;  dula; 
site	setsha; 
sites	ditsha; 
sitting	go tsena; 
situate	baya; 
situated	beilweng; 
situation	 bonno; maemo; 
situations	 bonno; maemo; 
six	thataro; 
sixth	borataro;  nngwethatarong; 
size	 saese; bogolo; 
skill	 botswerere; bokgoni;  kgono; 
skilled	botswerere; 
skills	 dikgono;  botswerere; bokgoni; 
slave	lekgoba; 
slavery	bokgoba; 
slaves	makgoba; 
slightly	go le gonnye fela; 
slip	thupana; 
slow	ka bonya; 
small	 mokoto; -nnye; 
small-scale	ka bonnye; 
smaller	­nnyane; 
so-called	bidiwang; 
soccer	kgwele ya maoto;  bolo ya maoto; 
social	boago; 
socially	ka loago; 
societal	­setšhaba; 
societies	 merafe; mekgatlho; 
society	 morafe; mokgatlho; 
socioeconomic	­loago le ikonomi; 
software	didiriswanolo; 
soil	mmu; 
sold	rekisitse; 
soldiers	masole; 
sole	kgato ya setlhako; 
solely	fela; 
solid	 -komota; komota; 
solidarity	tumelano; 
solution	tharabololo;  motswako;  tlhaoloso;  tlharololo; 
solutions	 ditlharololo; ditlhaoloso;  metswako; ditharabololo; 
some	 sengwe;  bangwe; dingwe; 
someone	mongwe; 
something	sengwe; 
sometimes	ka dinako dingwe; 
somewhat	batlile; 
son	morwa; 
song	pina; 
songs	dipina; 
soon	 ka bonako; mo nakong e e sa fediseng pelo; 
sophisticated	tsweletseng;  ­na le maitemogelo; 
sort	 tlhopa; rulaganya; 
sought	batlile; 
soul	moya; 
souls	mewa; 
sound	 -itekanetseng; modumo; 
sounds	medumo; 
source	motswedi; 
sources	metswedi; 
south	 ya borwa; borwa; 
southern	­bophirima; 
sovereign	 boipuso; kgosi; 
space	 phatlha; sebaka;  lefaufau; 
spaces	dibaka; 
spatial	­sebaka; 
speak	bua; 
speaker	mmusakgotla; 
speakers	babusakgotla; 
speaking	buang; 
speaks	bua; 
spear	lerumo; 
special	 kgethegile; -rileng; 
specialisation	- kgethegileng; 
specialised	kgethegileng; 
specialist	motseneledi; 
specially	segolo thata; 
species	 losika; lotso; 
specific	-totobetseng; 
specifically	ka totobatso; 
specification	totobatsa; 
specified	totobaditse; 
specify	totobatsa; 
specimen	 setotwana; selekwa; 
specimens	dilekwa; ditotwana; 
spectacular	bontle;  matsetseleko; 
spectrum	methalethale; 
speech	puo;  neo ya puo; 
speeches	dipuo; 
speed	lebelo; 
speedy	ka bonako; 
spend	 tuelo; dirisa; 
spent	dirisitse; 
sphere	 bolo; sediko; 
spheres	didiko;  dibolo; 
spirit	moya; 
spiritual	semoya; 
split	 arologanya; phatlola; 
spoken	buile; 
spokesperson	sebueledi; 
sponsored	etleeditse; 
sport	motshameko; 
sporting	motshameko; 
sports	motshameko; 
spotlight	lobone lwa patlo; 
spouse	mogatse; 
spouses	bomogatse; 
spread	phasalatsa;  tlala;  anamisa; 
square	 palosekwere; sekwere;  sekwera; 
stabilise	nitamisa; 
stability	tlhomamo; 
stable	setale; 
stadium	lebala;  setediamo; 
stadiums	ditediamo; 
staff	 mola wa dinnoto; badirammogo; 
stage	kgato;  serala; 
stages	dikgala; 
stakeholder	moamegi; 
stakeholders	baamegi; 
stalwarts	maphoga; 
stamp	setempe; 
stance	maikutlo; 
stand	phabileone;  matshego; 
standard	setlhopha;  kemo; 
standardised	kannweng; 
standardization	kano; 
standards	dikemo; 
stands	diphabileone; matshego; 
stanza	 tematheo; tematheto; 
star	naledi; 
stars	dinaledi; 
start	simolola; 
started	simolotse; 
starting	simololang; 
starts	simolola; 
state	 sebopego; lefatshe;  naga;  mmuso;  puso; 
state-owned	­puso; 
statement	polelo;  kanego; 
statements	dikanego; 
states	 dipuso;  mebuso;  dipopego; dinaga;  mafatshe; 
station	seteišene; 
stationery	dikwalelo;  tsa go kwalela; 
stations	diteišene; 
statistical	­dipalopalo;  ­mananepalo; 
statistician-general	radipalopalo-kakaretso; 
statistics	 mananepalo; dipalopalo; 
statue	sefikantswe; 
stature	bogolo;  seemo; 
status	kemo; 
statute	molao; 
statutes	melao; 
statutory	­molao; 
stay	nna; 
steadily	ka tlhomamo; 
steady	tlhomame; 
steal	utswa; 
steel	tshipi;  setala; 
steer	laola; 
steering	laolang; 
step	kgato; 
steps	dikgato; 
sterling	­siameng thata; 
still	bepisa; 
stimulate	phaphamisa; 
stimulating	phaphamisang; 
stipulate	kaya ka tlhomamo; 
stipulated	kaile ka tlhomamo; 
stock	 losika;  diphatlho;  diruiwa; thoto;  leruo; 
stolen	utswitse; 
stone	 setone;  ntsha thapo; thapo; 
stop	emisa;  kganela;  khutlisa; 
storage	polokelo;  bobeelo; 
store	boloka;  setoro; 
stored	bolokile; 
stories	mainane; 
storm	sefefo; 
story	 setori; kanelo; 
storytellers	baanedi; 
storytelling	polelo ka setori; 
strategies	ditogamaano; 
strategy	 mosalatogamaano; togomaano; 
stream	 moedi; moela; 
streams	 meedi; meela; 
street	mmila;  tobeletso; 
streets	mebila; diterata; 
strength	bothata; 
strengthen	tiisa; 
strengthened	tiisitse; 
strengthening	thatafatso; 
stress	kgatelelo;  tobeletsa;  tobeletso; 
strict	tlhoko; 
strides	dikgato; 
strike	ipelaetsa; 
string	 senara; mogala; 
strip	apola; 
strips	apola; mesetwana ya lesela; 
strive	leka; 
striving	lekang; 
strong	thata;  nonofile; 
stronger	nonofile go feta;  thata go feta; 
strongly	 ka thata; ka nonofo; 
structural	­kago; 
structure	 sebopego;  popego; setheo; 
structures	ditheo;  dipopego; 
struggle	 kgaratlha; kgaratlho; 
struggles	kgaratlha; dikgaratlho; 
struggling	kgaratlho;  kgaratlhang; 
student	 morutwa; moithuti; 
students	 barutwa; baithuti; 
studies	dithuto; 
studio	phaposikgasetso; 
studios	diphaposikgasetso; 
study	ithuto; 
style	 setaele; mokgwa;  lenono la mmamodula; 
sub-item	selwana; 
sub-programme	lenaneonyana; 
subject	 serutwa;  sediri; ikobela;  motlhanka; 
subjected	ikobeditse; 
subjects	 didiri;  batlhanka;  ikobela; dirutwa; 
submission	tlhagiso; 
submissions	ditlhagiso; 
submit	 ineela; romela; 
submitted	gorositswe; 
submitting	romelang;  ineelang; 
subparagraph	temananyana; 
subpoena	tagafara; 
subregulation	molawananyana; 
subscribe	kwadisa; 
subscribed	kwadisitse; 
subsection	karolwana; 
subsections	dikarolwana; 
subsequent	latelang; 
subsequently	morago; 
subsidiary	setlamopotlana; 
subsidies	 diketleetso ka madi; mehago; diketleetso; 
subsidy	ketleetso;  mhago;  ketleetso ka madi; 
subsistence	madi a lekaneng; 
substance	sere; 
substances	dire; 
substantial	thata; 
substantially	ka thata; 
substantive	leina;  tlolomolaokgolo; 
substitute	moemedi;  kemedi;  emisetsa; 
substituted	emiseditse; 
substitutes	baemedi;  dikemedi;  emisetsa; 
substituting	emisetsang; 
succeed	tlhatlhama; 
succeeded	tlhatlhame; 
success	katlego;  tswelelopele; 
successes	 ditswelelopele; katlego; 
successful	-atlega; 
successfully	ka katlego; 
succession	tlhatlhamo; 
successor	motlhatlhami; 
such	jaaka; 
suffer	bogisa;  boga; 
suffered	 bogisitse; bogile; 
suffering	tshwenyega; 
sufficient	-lekaneng; 
sufficiently	mo go lekaneng; 
sugar	sukiri; 
suggest	tlhagisa; 
suggested	tlhagisitse; 
suggestion	tlhagiso; 
suggestions	ditlhagiso; 
suggests	tlhagisa; 
suitable	tshwanetseng; 
suitably	ka tshwanelo; 
sum	palo;  tlhakano; 
summary	 khutshwafatso; tshobokanyo; 
summer	selemo; 
summit	setlhoa; 
summits	ditlhoa;  disamiti; 
summoned	filwe tagafara; 
summons	tagafara; 
sun	letsatsi; 
sung	opetse; 
superior	-gaisa; 
supervisees	batlhokomelwa; 
supervision	tlhokomelo; 
supervisory	botlhokomedi; 
supplement	 setlaleletsi; tlaleletso; 
supplementary	-tlatsa; 
supplied	tlametse; 
supplier	mothelesi; 
suppliers	bathelesi; 
supplies	ditheleso; 
supply	 tlamelo;  thoto;  theleso; tlamela; 
support	 setshegetsi;  tshegetsa; tlamela;  tlhokomelo;  khutlola; 
supported	 tlametse;  khutlotse;  tshegeditse; tlhokometse; 
supporting	tlamelang;  tshegetsang; 
supportive	­tshegetsang; 
supports	 tshegetsa; tlamela;  tlhokomelo; ditshegetsi;  khutlola; 
supposed	tshwanetse;  tlamegile; 
supreme	 ­golo; botlhokwa; 
sure	bonnete; 
surely	ka nnete; 
surface	 rethefatsa;  sefatla; boalo; 
surplus	lefetiso;  tshalelo; 
surrender	ineela; 
surrounding	tikologong; 
surveillance	tebelelo ka kelotlhoko; 
survey	tekanyetso; 
surveyor	molekanyalefatshe; 
surveyors	balekanyalefatshe; 
surveys	ditekanyetso; 
survival	phologo; 
survive	falola;  phologa;  go falola; 
surviving	 phologang; falolang; 
suspect	belaela; 
suspected	belaetse; 
suspects	belaela; 
suspend	 lekeletsa; emisa;  katlholo ka taelo ya kutlwelobotlhoko;  - emisa; 
suspended	 lekeleditse;  - emisitsweng; emisitse; 
suspension	 motswako;  ditsweleletso; kemiso;  setshegetsamaotwana; 
suspensions	 dikemiso;  ditsweleletso; ditshegetsamaotwana; metswako; 
sustain	tshegetsa; 
sustainability	tsweletso; 
sustainable	­tswelelang; 
sustained	tshegeditse; 
sustaining	tshegetsang; 
swear	ikana;  roga; 
switch	tobetsa;  konopo; 
sworn	ikanne; 
symbol	 letshwao;  sekai; sekao; 
symbolic	­dikao; 
symbolically	ka dikao; 
symbolises	kaya; 
symbolism	bokao; 
symbols	matshwao;  dikai;  dikao; 
symposium	simphosiamo; 
symptom	sesupo; 
symptoms	ditshupabolwetse; ditshupo; 
system	thulaganyo; 
systematic	-thulaganyo; 
systematically	-ka thulaganyo; 
systemic	­thulaganyo; 
systems	dithulaganyo; 
table	 lenanekatiso;  tafole; lenaneo; 
tables	mananeo; mananekatiso;  ditafole; 
tabling	tlhagiso; 
tabs	dithebe; 
tackle	 go tlama; katerole; 
tag	thekete; 
tags	dithekete; 
take	tsaya; 
taken	tseile; 
takeover	gapa ka go reka dišere; 
takes	tsaya; 
taking	tsayang; 
tale	kanelo; 
talent	mpho; 
talented	- filwe; 
talents	dimpho;  ditalente; 
tales	dikanelo; 
talk	puo;  bua; 
talking	buang; 
talks	dipuo; 
tall	-leele; 
tangible	­bonalang; 
tap	kokota;  thepe; 
tape	theipi; 
target	ntlha; 
targets	dintlha; ditotwa; 
tariff	kelotefo; 
tariffs	dikelotefo; 
task	tiro; 
tasks	ditiro; 
taught	rutile; 
tax	lekgetho; 
taxable	-kgethisegang; 
taxation	lekgetho; 
taxes	makgetho; 
taxi	thekisi; 
taxpayer	mokgethi; 
taxpayers	bakgethi; 
teach	ruta; 
teacher	morutabana; 
teachers	barutabana; 
teaching	thuto; 
team	setlhopha; 
teams	ditlhopha; 
teaser	morumodi; 
technical	-thekeniki; 
technicians	bathekeniki; 
technique	 thekeniki; mokgwa; 
techniques	mekgwa;  dithekeniki; 
technologies	dithekenoloji; 
technology	thekenoloji; 
telecommunication	neeletsanyokgakala; 
telecommunications	tlhaeletsanokgakala; 
telephone	 thelefone; mogala; 
television	 thelebišene; tlhagisotshwantsho; 
tell	 lotlega; bolela; 
telling	bolelang; 
tells	 lotlega; bolela; 
temporarily	­ka nakwana; 
temporary	-lobakanyana; 
ten	lesome; 
tend	 oka; disa; 
tender	thennere; 
tenders	dithennere; 
tension	 kgagamalo; letsapa; 
tenure	pakatiro; 
term	 lereo;  kwatara; nako; 
terminate	khutlisa; 
terminated	khutlisitse; 
termination	khutliso; 
terminology	mareo; 
terms	maemo; 
terrestrial	­lefatshe; 
territorial	­naga; 
territories	dinaga; 
territory	naga; 
terrorism	borukhutlhi; 
terrorist	motshosetsi; 
tertiary	maemo a boraro; 
test	 teko;  lekeletsa;  tlhatlhobo; leka; 
tested	 lekeleditse; lekile; 
testimony	bosupi; 
testing	 lekeletsang;  lekang; tlhatlhobo; 
tests	 diteko;  lekeletsa;  ditlhatlhobo; leka; 
text	diteng;  tema; 
than	go feta; 
thank	leboga; 
thanks	malebogo; 
that	seo;  sele; 
theater	serala;  boarelo; 
theatre	serala; ntlwanakarelo;  boarelo; 
theatres	dirala;  boarelo; matlwanakarelo; 
theft	bogodu; 
their	­bone; 
them	bone;  tsone; 
theme	thitokgang; 
themes	dithitokgang; dipinarero; 
themselves	bobona; 
then	jalo; 
theory	tiori; 
therapy	kalafo; 
there	kwa; 
thereafter	morago ga moo; 
thereby	ka gone mo; 
therefore	ka jalo; 
therein	mo teng; 
thereof	 ga yone;  ga one;  ga teng; ga sone; 
thereon	mo godimo ga; 
thereto	 mo go yone; mo go one;  mo go sone; 
thereupon	mo godimo ga; 
therewith	ka tiriso ya; 
these	tse;  tsone; 
they	bone;  tsone;  one; 
thing	selo; 
things	dilo; 
think	nagana; 
thinking	akanyang; 
third	boraro;  tharong; 
thirdly	­boraro; 
thirds	tharong; 
this	 yo;  jo;  bo; se; 
thorough	ka botlalo; 
those	 tseo; bona; 
though	le mororo;  le fa; 
thought	nagantse; 
thoughts	dikakanyo; 
thousand	kete;  sekete; 
thousands	dikete; 
threat	tshoso; 
threaten	 tshosa; tshosetsa; 
threatened	 tshositse; tshoseditse; 
threats	ditshoso; 
three	tharo; 
three-day	malatsimararo; 
three-year	dingwagatharo; 
threshold	palopotlana; 
thriving	atlegang; 
through	-phunyeletsa; 
throughout	-otlhe; 
thus	ka jalo; 
ticket	thekethe; 
tickets	dithekethe; 
tie	 lekana; tsweletso; 
tiers	dillaga; 
till	thili; 
time	nako; 
timeframes	dipaka; 
timely	ka nako; 
times	atisa; 
tirelessly	kwa ntle ga letsapa; 
title	setlhogo; 
titled	filwe setlhogo; 
titles	ditlhogo; 
to	go; 
tobacco	motsoko; 
today	gompieno; 
together	mmogo; 
toilet	 boitiketso;  tlelosete; ntlwana; 
toilets	ditlwanaboithomelo;  ditlelosete;  dintlwana; maitiketso; 
told	boleletse; 
tolerance	itshoka; 
tomorrow	ka moso; 
ton	tono; 
tonight	mo bosigong jono; 
tonnage	morwalotono; 
tons	ditono; 
too	ga mmogo le; 
took	tsere;  tshotse; 
tool	sediriswa;  sediriso; 
toolkit	sete ya didiriswa; 
tools	didiriswa;  didiriso; 
top	 moretedie;  setlhoa; bogodimo; 
topic	kgang; 
topics	dikgang; 
total	yotlhe;  palogotlhe tlhakana; 
touch	kamo; 
tough	thata; 
tour	go ja nala; 
touring	 go eta; leeto; 
tourism	bojanala; 
tourist	mojanala; 
tourists	bajanala; 
tournament	kgaisano; 
tournaments	dikgaisano; 
toward	go lebagana le; 
towards	kwa go; 
town	 teropo; toropo; 
towns	 diteropo; ditoropo; 
township	motsesetoropo; 
townships	metsesetoropo; 
toy	setshamekisabana; 
trace	 gatisa;  tshupo;  thalelela; batlisisa;  - fitlhelela; 
track	 motlhala; tsela;  seporo; 
trade	 - gweba; tiro;  bapala;  kgwebo; 
trading	- gweba; 
tradition	setso; 
traditional	 - tsa setso; -setso; 
traditionally	ka setso;  ka tlwaelo; 
traditions	ditso; 
traffic	pharakano; 
tragedy	 masetlapelo; matlhotlhapelo; 
tragic	­masetlapelo; 
train	katisa;  setimela; 
trained	katisitse; 
training	katiso; 
trajectory	tsela; 
transaction	tirisano; 
transactions	ditirisano; 
transfer	mametlelela;  sutisa;  tshutiso; 
transferred	sutisitse; 
transferring	 mametlelelang; sutisang; 
transfers	mametlelela;  sutisa;  ditshutiso; 
transform	fetola; 
transformation	phetogo; 
transformed	fetotse; 
transforming	fetola; 
transition	kgabaganyo;  phetolakhii; 
transitional	pakaphetogo; pakakgabaganyo; 
translate	ranola;  fetolela; 
translated	fetoletse;  ranoletse; 
translation	phetolelo; 
translator	mofetoledi; 
translators	bafetoledi; 
transmission	phetiso; 
transmit	 gasa; fetisa;  tshwaetsa; 
transmitted	 gasitse;  tshwaetsa; fetisitse;  fetiseditse; 
transparency	pepeneneng; 
transparent	bonatsang; 
transport	rora;  - rora; 
transportation	thotho; 
travel	- eta; 
travelled	etile; 
travelling	mosepele; 
treasure	lehumo; 
treasures	mahumo; 
treasuries	matlotlo; 
treasury	matlotlo; 
treat	tshola;  phekola; 
treated	tshotse;  phekotse; 
treaties	dikgolagano; 
treatment	 phekolo; kalafo; 
treaty	tumalano;  kagisano; 
tree	setlhare; 
trees	ditlhare; 
trend	mokgwatlwaelo; 
trends	mekgwatlwaelo; 
trial	tsheko; 
trials	ditsheko; 
tribunal	lekgotla; 
tribunals	makgotla; 
tribute	dikgafela; 
tried	lekile; 
triple	seraro; 
triumph	phenyo; 
trophy	sekgele; 
troupe	setlhopha sa badiragatsi; 
truly	 ammaaruri;  ka nnete; ruri; 
trust	 tshepa; terasete; 
trustee	motlhokomedi; 
trustees	batlhokomedi; 
trusts	tshepa;  diterasete; 
truth	nnete; 
try	leka; 
trying	 ­boima; ­tenang; 
turfs	dithefe; 
turn	 retologa;  menoga; fapoga; 
turnaround	 atlega; dikologa; 
turned	 retologile; menogile;  fapogile; 
turning	mogobolo; 
turnover	thekiso yotlhe; 
twelve	lesomepedi; 
twentieth	someamabedi; 
twenty	masomamabedi; 
twice	gabedi; 
two	pedi; 
two-day	malatsimabedi; 
two-thirds	pedi-tharong; 
type	 tlanya; mofuta; 
types	 tlanya; mefuta; 
typically	ka maitshwaro a a rileng; 
ultimate	­bofelo; 
ultimately	kwa bokhutlong; 
unable	 ­retelelwa; ­palelwa; 
unacceptable	­sa amogelweng; 
unanimous	ka tumelano; 
unauthorised	­sa letlelelweng; 
uncertainty	botlhokatlhomamo; 
unconstitutional	kgatlhanong le molaotheo; 
under	tlase; 
underdevelopment	­sa tlhokafalang; 
undergo	­diriwa; 
underlying	-theo; 
undermine	nyatsa; 
underpin	tshegetsa; 
understand	tlhaloganya; 
understanding	tlhaloganyo;  dumalana; 
understood	tlhalogantse; 
undertake	solofetsa;  amogela maikarabelo; 
undertaken	solofeditswe; 
undertaking	 tiro e o ikarabelang mo go yone; tsholofetso; 
undertook	solofeditse; 
underwater	mo tlase ga metsi; 
underway	­diragalang jaanong; 
undue	­utlwalang thata; 
unemployed	go sa dire; 
unemployment	 se nang tiro; botlhokatiro; 
unfair	­gobelelang; 
unfortunately	ka go tlhoka lesego; 
unhappy	tlhoafetse; 
unified	kopantse; 
uniform	 junifomo;  yunifomo; tshwanang; 
unify	kopanya; 
union	kopano;  setekopano; 
unions	dikopano; disetekopano; 
unique	kgethegile; 
unit	 motso; bongwe; 
unitary	­bojosi; 
unite	kopanya; 
united	-kopane; 
units	metso; 
unity	kopano; 
universal	­gotlhe; 
universe	 gotlhe; tlholego; 
universities	diyunibesithi; 
unknown	­sa itsegeng; 
unlawful	­seng semolao; 
unleash	golola; 
unless	fa e se; 
unlike	­go sa tshwane; 
unlikely	ka go sa tshwane; 
unnecessary	­go sa tlhokege; 
unprecedented	­diregang lwa ntlha; 
unqualified	­se nang borutegi; 
unreasonable	­sa utlwaleng; 
unregistered	­sa kwadisang; 
unsafe	­sa babalesegang; 
until	go fitlha;  go tsamaya; 
untold	­seng kana ka sepe; 
unusual	­sa tlwaelegang; 
unveil	bipolola; sirolola; 
unveiled	bipolotse; sirolotse; 
unveiling	tshirololo; pipololo; 
up	godimo; 
upcoming	­diregang mo nakong e e sa fediseng pelo; 
update	­sešweng;  ntšhwafatsa; 
updated	ntšhwafaditse; 
updates	dintšhwafatso; 
upgraded	kaonafaditse; 
upgrades	kaonafatsa; 
upgrading	kaonafatsang; 
uphold	 kokotletsa; tshegetsa; 
uploading	sitlhamololang tshedimosetso ya khomphiutha; 
upon	mo godimo ga; 
urban	 -toropo; setoropo; 
urge	phisego; 
urgency	bonakonako; 
urgent	makgabeadipapetla; 
urgently	ka potlako; 
us	rona; 
usage	tirisofoko; 
use	 mosola;  tiriso ya nnelete; dirisa;  tiriso ya sekere; 
used	dirisitse; 
useful	­mosola;  ­botlhokwa; 
user	modirisi; 
users	badirisi; 
uses	 mesola;  ditiriso tsa nnelete;  ditiriso tsa sekere; dirisa; 
using	dirisang; 
usually	ka gale; 
utilisation	tiriso; 
utilise	dirisa; 
utilised	dirisitse; 
vacancies	diphatlhatiro; 
vacancy	phatlhatiro; 
vacant	lolea; 
valid	­amogelesegang; 
validity	 kamogelesego; bonnete; 
valley	molapo;  mokgatsha; 
valuable	-botlhokwa;  -mosola; 
valuation	peotlhotlhwa; 
value	 mosola;  bolengpalo; boleng; 
values	mekgwa; 
variation	thefosanyo; 
varied	fetotse;  fapaane;  fetafetane; 
varies	fapaana; 
variety	mofuta; 
various	­mefutafuta;  ­methalethale; 
vary	fapaana; 
varying	fapaanang; 
vast	bogolo; 
vehicle	serori; 
vehicles	dirori; 
vendor	morekisi; 
venture	simolola; 
ventures	simolola; 
venue	lefelo; 
venues	mafelo; 
verification	netefatso; 
verify	netefatsa; 
version	mofuta; 
very	 bobe; thata;  tota; 
vessel	sekepe;  setshodi;  tshika;  tsela ya madi; 
vested	­roletswe; 
veterans	mekaloba ya ntwa; 
via	ka tiriso ya; 
viability	itshegetso; 
viable	itshegetsa;  ­kgonegang; 
vibrant	­matlhagatlhaga; 
vice	 setshwareledi; tlelempe; 
vice-chairperson	motlatsa-modulasetilo; 
victim	motswasetlhabelo; 
victims	batswasetlhabelo; 
victor	mofenyi;  motlhodi; 
victory	phenyo; 
video	 kgatisotshwantsho; bidio; 
videos	dibidio; dikgatisotshwantsho; 
view	pono; 
viewed	 pono; bone; 
viewing	pono; 
views	dipono; 
village	motse; 
villages	metse; 
violation	tlolomolao; 
violations	ditlolomolao; 
violence	tirisodikgoka;  boganka; 
violent	­tirisodikgoka;  ­phafamogo; 
virtual	setshwantshokgopolo; 
virtually	ka khomphiuta; 
virtue	 boitsheko;  nonofo; molemo; 
visible	-bonalang; 
vision	pono; 
visionary	­ponelopele; 
visit	 lekola;  eta;  jela nala; loeto;  tekolo; 
visited	 jetse nala; etetse;  lekotse;  etile; 
visiting	 lekolang; etang;  jang nala; 
visitor	moeti; 
visitors	baeti; 
visits	maeto; 
visual	pono; 
visually	­ka ponalo; 
vital	botlhokwa; 
vocational	-pilediwa; 
voice	kodu; 
voices	mantswe;  kodu; 
void	thatolola;  direla lefela;  tsupuetsa; dirolola;  logaba; 
volatility	kakgaakgego; 
volume	 -modumo; mothamo;  bolumu; 
voluntarily	 go se na patiko; ka boithaopo; 
voluntary	ka go ithaopa; 
volunteer	moithaopi; 
volunteers	baithaopi; 
vote	 bouta; tlhopho;  boutu; 
voted	boutile; 
voter	 mmouti; motlhophi; 
voters	batlhophi;  babouti; 
votes	 bouta; ditlhopho;  diboutu; 
voting	tlhopho;  go bouta; 
vulnerability	­kamego bonolo; 
vulnerable	 go ka lwala bonolo; - utlwisiwa botlhoko; 
wage	 tefo; tuelo; 
wages	ditefo; 
waiting	letile; 
walk	tsamaya; 
walks	metsamao; 
wall	 lobota; lebota; 
walls	 dipota; mabota; 
want	 go batla; keletso; 
wants	 ditlhoko; batla; 
war	ntwa; 
ward	 ntlwana ya balwetse; kgoro; 
wards	ntlwana ya balwetse; 
warm	bothitho;  -bothito; 
warmth	bothito;  bothitho; 
warning	kitsiso; 
warrant	lekwalothebolo; 
warrants	makwalothebolo; 
wars	dintwa; 
waste	 matlakala;  letsirolo; senya; 
watch	 orolosi; tshupanako; 
water	metsi;  nosetsa;  nosa; 
waters	metsi;  nosetsa;  nosa; 
wax	bonota; 
way	tsela;  mokgwa; 
ways	mekgwa;  ditsela; 
we	re;  rona; 
weakness	bokoa; 
weaknesses	makoa; 
wealth	khumo; 
weapon	sebetsa; 
weapons	dibetsa; 
weather	bosa; 
web	bobi; 
website	setsha sa inthanete; 
websites	diwebosaete; 
week	beke;  tshipi; 
week-long	beke yotlhe; 
weekend	bokhutlo jwa beke; 
weeks	 ditshipi; dibeke; 
weight	boima;  maatlakgatelelo;  ketefatsa; 
welcome	amogela; 
welcomed	amogetse; 
welcomes	amogela; 
welcoming	botsalano; 
welfare	thuso; 
well	 petse; sediba; 
well-being	boitekanelo; 
well-known	­itsegeng; 
wellbeing	boitekanelo; 
went	tsamaile; 
west	bophirima;  ya bophirima; 
western	­botlhaba; 
wetland	moraga; 
wetlands	meraga; 
what	eng; 
what's	ke eng; 
whatever	eng kapa eng; 
whatsoever	le fa e le eng; 
when	fa; 
whenever	e tle e re; 
where	kae; 
whereas	le mororo;  le fa; 
whereby	e ka; 
whereupon	mo godimo ga; 
wherever	le fa e ka nna kae; 
whether	e ka nna; 
which	efe;  sefe;  bafe; 
whichever	efe kana efe; 
while	fa; 
whilst	fa; 
whip	kgole;  seme; 
whips	 dime; dikgole; 
white	mosweu;  tshweu; 
whites	basweu; 
who	mang; 
whole	gotlhe; 
wholesale	thekisokgoboko; 
wholly	gotlhe;  ka gotlhe; 
whom	 yo mo; ba ba; 
whose	 yo tsa ga;  yo ba ga; yo sa ga; 
why	goreng; 
wide	bulegileng;  sephara; 
widely	ka kanamo; 
wider	bulegileng-nyana; sepharanyana; 
widespread	anameng; 
wife	mosadi; 
wild	sekwera; 
wildlife	diphologolo tsa naga;  sekwera; 
will	 wili; tlaa; 
willing	ikemiseditseng; 
willingness	maikemisetso; 
win	fenya; 
wind	phefo; 
winding-up	 wetsang; fetsang; 
window	fensetere; 
wine	beine; 
winner	mogaisi; 
winners	bagaisi; 
winning	 fenyang; gapang; 
winter	mariga; 
wisdom	botlhale; 
wish	 keletso; eletsa; 
wishes	dikeletso; 
wishing	eletsang; 
with	ka, mmogo le; 
withdraw	gogela morago; 
withdrawal	ikgogelomorago; 
withdrawn	gogetse morago; 
within	mo teng; 
without	kwa ntle ga; 
witness	paki;  mankge; 
witnesses	dipaki;  mosupi [basupi];  mankge; 
woman	mosadi; 
women	basadi; 
women's	 ­bomme; ­basadi; 
won	fentse; 
wonderful	­kgatlhisang; 
wood	sekgwa;  dikota;  logong; 
word	lefoko; 
words	mafoko; 
work	dira;  tiro ya bothakga;  tiro; 
worked	dirile; 
worker	modiri; 
workers	badiri; 
working	dirang; 
workplace	tirong; 
works	 ditiro tsa bothakga; dira;  ditiro; 
workshop	bodirelo; 
workshops	madirelo; 
workspace	sebakatiro; 
world	lefatshe; 
world's	­lefatshe; 
world-class	maemo a lefatshe; 
worlds	mafatshe; 
worldwide	-lefatshe ka bophara; 
worrying	tshwenyang; 
worse	etegetseng; 
worst	nna maswe le go feta; 
worth	tshwanelo;  tlhotlhwa; 
worthy	tshwanetswe; 
would	ka; 
wound	ntho;  ntsha ntho; 
wounds	dintho; 
write	kwala; 
writer	mokwadi; 
writers	bakwadi; 
writers'	­bakwadi; 
writing	 go kwala; mokwalo; 
writings	mekwalo; 
written	kwadile; 
wrong	 fosagetse; phoso; 
wrote	kwadile; 
xenophobia	letlhoo la baditšhaba; 
xenophobic	letlhoo la baditšhaba; 
year	ngwaga; 
year's	­ngwaga; 
year-on-year	ngwaga ka ngwaga; 
years	dingwaga; 
yes	ee; 
yesterday	maabane; 
yet	­ise; 
yield	kuna; 
yields	dikuna; 
you	wena; 
young	ngwana;  -e nnye; 
younger	monnye;  -e nnye; 
your	­gago; 
youth	 mošwa; bašwa; 
zero	lefela; 
zone	kgaolo; 
zones	dikgaolo; 
zoo	 serapa sa diphologolo; serapa; 
